id,indegree,outdegree,degree,internal_degree,community_id,community_type,external_degree,pct_internal,pct_external,is_hub,is_bridge
-Dead-Eye-Duncan-,8,18,26,32,0,Strong community,6,1.2307692307692308,0.23076923076923078,False,True
10ebbor10,25,10,35,40,0,Strong community,5,1.1428571428571428,0.14285714285714285,False,False
3superfrank,19,9,28,31,0,Strong community,3,1.1071428571428572,0.10714285714285714,False,False
Angel1571,21,9,30,30,0,Strong community,0,1.0,0.0,False,False
ChronoVT,23,14,37,32,0,Strong community,5,0.8648648648648649,0.13513513513513514,False,False
DeltaBot,361,375,736,736,0,Strong community,0,1.0,0.0,True,False
Destinyciello,158,113,271,279,0,Strong community,8,1.029520295202952,0.02952029520295203,True,False
Evening-Skirt731,15,7,22,23,0,Strong community,1,1.0454545454545454,0.045454545454545456,False,False
LucidMetal,57,36,93,105,0,Strong community,12,1.1290322580645162,0.12903225806451613,True,False
Nofanta,19,4,23,26,0,Strong community,3,1.1304347826086956,0.13043478260869565,False,False
Temporary-Stay-8436,13,13,26,21,0,Strong community,5,0.8076923076923077,0.19230769230769232,False,False
The_Confirminator,15,8,23,25,0,Strong community,2,1.0869565217391304,0.08695652173913043,False,False
Thumatingra,46,19,65,81,0,Strong community,16,1.2461538461538462,0.24615384615384617,False,True
UnicornForeverK,15,8,23,25,0,Strong community,2,1.0869565217391304,0.08695652173913043,False,False
ZizzianYouthMinister,29,12,41,56,0,Strong community,15,1.3658536585365855,0.36585365853658536,False,True
aoc666,13,10,23,23,0,Strong community,0,1.0,0.0,False,False
gingerbreademperor,16,4,20,21,0,Strong community,1,1.05,0.05,False,False
tidalbeing,16,5,21,23,0,Strong community,2,1.0952380952380953,0.09523809523809523,False,False
0nlyhalfjewish,1,5,6,3,4,Strong community,3,0.5,0.5,False,True
SinCityCane,8,27,35,36,0,Strong community,1,1.0285714285714285,0.02857142857142857,False,False
jakeofheart,30,27,57,37,0,Strong community,20,0.6491228070175439,0.3508771929824561,False,True
mikeber55,14,4,18,8,2,Strong community,10,0.4444444444444444,0.5555555555555556,False,True
100pOmnipotence,19,59,78,88,0,Strong community,10,1.1282051282051282,0.1282051282051282,True,False
Ambroisie_Cy,11,6,17,21,0,Strong community,4,1.2352941176470589,0.23529411764705882,False,True
Bluehen55,16,7,23,14,0,Strong community,9,0.6086956521739131,0.391304347826087,False,True
Bootmacher,14,5,19,13,0,Strong community,6,0.6842105263157895,0.3157894736842105,False,True
Bottlecapzombi,22,22,44,39,0,Strong community,5,0.8863636363636364,0.11363636363636363,False,False
Careless_Bat_9226,13,10,23,21,0,Strong community,2,0.9130434782608695,0.08695652173913043,False,False
Catsdrinkingbeer,17,11,28,28,0,Strong community,0,1.0,0.0,False,False
Dry_Bumblebee1111,115,71,186,224,0,Strong community,38,1.2043010752688172,0.20430107526881722,False,False
EmptyDrawer2023,34,15,49,44,0,Strong community,5,0.8979591836734694,0.10204081632653061,False,False
FetusDrive,26,25,51,51,0,Strong community,0,1.0,0.0,False,False
Flashy_Win_4596,14,9,23,22,0,Strong community,1,0.9565217391304348,0.043478260869565216,False,False
Funny_Parfait6222,5,5,10,9,0,Strong community,1,0.9,0.1,False,False
GentleKijuSpeaks,18,9,27,23,0,Strong community,4,0.8518518518518519,0.14814814814814814,False,False
GiveMeBackMySoup,26,17,43,41,0,Strong community,2,0.9534883720930233,0.046511627906976744,False,False
Goggio,27,27,54,65,0,Strong community,11,1.2037037037037037,0.2037037037037037,False,False
GreatResetBet,24,14,38,41,0,Strong community,3,1.0789473684210527,0.07894736842105263,False,False
GrouchyGrinch1,4,2,6,7,0,Strong community,1,1.1666666666666667,0.16666666666666666,False,False
Happy-Definition-656,6,2,8,9,0,Strong community,1,1.125,0.125,False,False
Hypekyuu,111,76,187,181,0,Strong community,6,0.9679144385026738,0.03208556149732621,True,False
Key-Willingness-2223,24,18,42,42,0,Strong community,0,1.0,0.0,False,False
Kohvazein,5,5,10,10,0,Strong community,0,1.0,0.0,False,False
LaMadreDelCantante,10,7,17,10,3,Strong community,7,0.5882352941176471,0.4117647058823529,False,True
LordBecmiThaco,33,15,48,45,0,Strong community,3,0.9375,0.0625,False,False
Lylieth,68,43,111,139,0,Strong community,28,1.2522522522522523,0.25225225225225223,False,True
MagnanimosDesolation,35,20,55,49,0,Strong community,6,0.8909090909090909,0.10909090909090909,False,False
Marithamenace,9,3,12,11,0,Strong community,1,0.9166666666666666,0.08333333333333333,False,False
Ndlburner,21,15,36,35,0,Strong community,1,0.9722222222222222,0.027777777777777776,False,False
Nerdsamwich,8,6,14,15,0,Strong community,1,1.0714285714285714,0.07142857142857142,False,False
Oishiio42,14,8,22,25,0,Strong community,3,1.1363636363636365,0.13636363636363635,False,False
Ok-Bug-5271,15,6,21,22,0,Strong community,1,1.0476190476190477,0.047619047619047616,False,False
OverpricedGoods,16,27,43,45,0,Strong community,2,1.0465116279069768,0.046511627906976744,False,False
PhasmaUrbomach,19,18,37,36,0,Strong community,1,0.972972972972973,0.02702702702702703,False,False
PrevekrMK2,21,9,30,26,0,Strong community,4,0.8666666666666667,0.13333333333333333,False,False
ProDavid_,107,89,196,236,0,Strong community,40,1.2040816326530612,0.20408163265306123,False,False
Profound_Thots,11,21,32,40,0,Strong community,8,1.25,0.25,False,True
Ready-Recognition519,13,9,22,22,0,Strong community,0,1.0,0.0,False,False
Redditor274929,13,10,23,24,0,Strong community,1,1.0434782608695652,0.043478260869565216,False,False
RideNo4759,10,7,17,18,0,Strong community,1,1.0588235294117647,0.058823529411764705,False,False
RottedHuman,16,8,24,24,0,Strong community,0,1.0,0.0,False,False
RulesBeDamned,54,10,64,75,0,Strong community,11,1.171875,0.171875,True,False
SoftwareAny4990,19,13,32,32,0,Strong community,0,1.0,0.0,False,False
Stereo_Jungle_Child,38,8,46,54,0,Strong community,8,1.173913043478261,0.17391304347826086,False,False
The_Amazing_Emu,13,12,25,21,0,Strong community,4,0.84,0.16,False,False
TinyFlamingo2147,9,5,14,15,0,Strong community,1,1.0714285714285714,0.07142857142857142,False,False
Top-Bootylover,5,6,11,9,0,Strong community,2,0.8181818181818182,0.18181818181818182,False,False
Verdeckter,12,7,19,2,24,Noisy community,17,0.10526315789473684,0.8947368421052632,False,False
bettercaust,40,29,69,72,0,Strong community,3,1.0434782608695652,0.043478260869565216,True,False
dula_peep_says,15,7,22,18,0,Strong community,4,0.8181818181818182,0.18181818181818182,False,False
dvolland,30,22,52,49,0,Strong community,3,0.9423076923076923,0.057692307692307696,False,False
ecafyelims,9,5,14,12,0,Strong community,2,0.8571428571428571,0.14285714285714285,False,False
elysian-fields-,23,14,37,38,0,Strong community,1,1.027027027027027,0.02702702702702703,False,False
emohelelwye,24,10,34,41,0,Strong community,7,1.2058823529411764,0.20588235294117646,False,False
hacksoncode,32,20,52,55,0,Strong community,3,1.0576923076923077,0.057692307692307696,False,False
iamintheforest,57,25,82,100,0,Strong community,18,1.2195121951219512,0.21951219512195122,False,True
kimariesingsMD,32,20,52,57,0,Strong community,5,1.0961538461538463,0.09615384615384616,False,False
lordtrickster,27,14,41,39,0,Strong community,2,0.9512195121951219,0.04878048780487805,False,False
muyamable,27,11,38,45,0,Strong community,7,1.1842105263157894,0.18421052631578946,False,False
throwaway75643219,14,7,21,22,0,Strong community,1,1.0476190476190477,0.047619047619047616,False,False
weedywet,20,5,25,31,0,Strong community,6,1.24,0.24,False,True
11289,3,14,17,16,3,Strong community,1,0.9411764705882353,0.058823529411764705,False,False
Asleep_Region,14,3,17,17,3,Strong community,0,1.0,0.0,False,False
Careless-Ability-748,33,6,39,25,1,Strong community,14,0.6410256410256411,0.358974358974359,False,True
FairyCompetent,24,8,32,32,3,Strong community,0,1.0,0.0,True,False
False_Appointment_24,31,11,42,43,0,Strong community,1,1.0238095238095237,0.023809523809523808,False,False
LdiJ46,16,2,18,19,3,Strong community,1,1.0555555555555556,0.05555555555555555,False,False
Lucky_Volume3819,42,24,66,77,3,Strong community,11,1.1666666666666667,0.16666666666666666,True,False
NeverRarelySometimes,13,6,19,21,3,Strong community,2,1.105263157894737,0.10526315789473684,False,False
Ok_Maintenance7716,12,3,15,13,3,Strong community,2,0.8666666666666667,0.13333333333333333,False,False
am_Nein,14,7,21,20,3,Strong community,1,0.9523809523809523,0.047619047619047616,False,False
annang,15,8,23,24,3,Strong community,1,1.0434782608695652,0.043478260869565216,False,False
ocnozix,5,0,5,5,3,Strong community,0,1.0,0.0,False,False
redditstinkttotal,8,2,10,13,3,Strong community,3,1.3,0.3,False,True
sisterfunkhaus,14,7,21,21,3,Strong community,0,1.0,0.0,False,False
stroppo,18,7,25,22,1,Strong community,3,0.88,0.12,False,False
11grim,7,16,23,26,0,Strong community,3,1.1304347826086956,0.13043478260869565,False,False
5510,21,16,37,35,0,Strong community,2,0.9459459459459459,0.05405405405405406,False,False
Awkward-Estate-9787,27,23,50,52,0,Strong community,2,1.04,0.04,False,False
Cacafuego,21,8,29,32,0,Strong community,3,1.103448275862069,0.10344827586206896,False,False
Full-Professional246,63,47,110,119,0,Strong community,9,1.0818181818181818,0.08181818181818182,True,False
HazyAttorney,78,45,123,136,0,Strong community,13,1.1056910569105691,0.10569105691056911,True,False
Healthy_Shine_8587,34,94,128,137,0,Strong community,9,1.0703125,0.0703125,True,False
Pale_Zebra8082,31,22,53,56,0,Strong community,3,1.0566037735849056,0.05660377358490566,False,False
Physical_Stop851,33,24,57,66,0,Strong community,9,1.1578947368421053,0.15789473684210525,True,False
RealisticTadpole1926,12,4,16,15,0,Strong community,1,0.9375,0.0625,False,False
Teddy_The_Bear_,28,13,41,44,0,Strong community,3,1.0731707317073171,0.07317073170731707,False,False
TheSauceeBoss,31,17,48,51,0,Strong community,3,1.0625,0.0625,False,False
fossil_freak68,20,14,34,36,0,Strong community,2,1.0588235294117647,0.058823529411764705,False,False
jatjqtjat,85,31,116,135,0,Strong community,19,1.1637931034482758,0.16379310344827586,True,False
phoenix823,36,11,47,49,0,Strong community,2,1.0425531914893618,0.0425531914893617,False,False
tnic73,17,5,22,26,0,Strong community,4,1.1818181818181819,0.18181818181818182,False,False
12bEngie,6,15,21,23,0,Strong community,2,1.0952380952380953,0.09523809523809523,False,False
FarConstruction4877,35,16,51,57,0,Strong community,6,1.1176470588235294,0.11764705882352941,False,False
GermanPayroll,30,19,49,56,0,Strong community,7,1.1428571428571428,0.14285714285714285,False,False
LEMO2000,7,4,11,12,0,Strong community,1,1.0909090909090908,0.09090909090909091,False,False
NaturalCarob5611,80,40,120,136,0,Strong community,16,1.1333333333333333,0.13333333333333333,True,False
RiverCityWoodwork,42,13,55,63,0,Strong community,8,1.1454545454545455,0.14545454545454545,True,False
Shadow_666_,48,27,75,75,0,Strong community,0,1.0,0.0,True,False
darthmcdarthface,15,7,22,23,0,Strong community,1,1.0454545454545454,0.045454545454545456,False,False
lifeisabowlofbs,40,16,56,65,0,Strong community,9,1.1607142857142858,0.16071428571428573,True,False
212312383,99,173,272,269,0,Strong community,3,0.9889705882352942,0.011029411764705883,True,False
Able_Enthusiasm2729,12,12,24,24,0,Strong community,0,1.0,0.0,False,False
AccountWasFound,6,6,12,1,56,Noisy community,11,0.08333333333333333,0.9166666666666666,False,False
Actual_Confusion7140,12,9,21,20,0,Strong community,1,0.9523809523809523,0.047619047619047616,False,False
Alternative_Pin_7551,17,26,43,40,0,Strong community,3,0.9302325581395349,0.06976744186046512,False,False
Amoral_Abe,26,9,35,13,2,Strong community,22,0.37142857142857144,0.6285714285714286,False,True
AutistAstronaut,14,8,22,21,0,Strong community,1,0.9545454545454546,0.045454545454545456,False,False
Beneficial-Diet-9897,28,16,44,46,0,Strong community,2,1.0454545454545454,0.045454545454545456,False,False
Bodoblock,28,16,44,23,2,Strong community,21,0.5227272727272727,0.4772727272727273,False,True
CartographerKey4618,72,40,112,117,0,Strong community,5,1.0446428571428572,0.044642857142857144,True,False
ClockOfTheLongNow,206,184,390,291,2,Strong community,99,0.7461538461538462,0.25384615384615383,False,True
CurdKin,38,145,183,195,0,Strong community,12,1.0655737704918034,0.06557377049180328,True,False
DataCassette,19,9,28,28,0,Strong community,0,1.0,0.0,False,False
DonnPT,14,22,36,44,0,Strong community,8,1.2222222222222223,0.2222222222222222,False,True
DrNogoodNewman,22,18,40,44,0,Strong community,4,1.1,0.1,False,False
Dull_Conversation669,29,12,41,28,2,Strong community,13,0.6829268292682927,0.3170731707317073,False,True
Emotinonal_jiggolo,19,13,32,21,0,Strong community,11,0.65625,0.34375,False,True
EopNellaRagde,10,7,17,19,0,Strong community,2,1.1176470588235294,0.11764705882352941,False,False
Eric848448,23,12,35,28,2,Strong community,7,0.8,0.2,False,False
Factory-town,66,74,140,139,2,Strong community,1,0.9928571428571429,0.007142857142857143,True,False
Fantastic_Yam_3971,17,28,45,45,0,Strong community,0,1.0,0.0,False,False
FearTheAmish,13,9,22,22,0,Strong community,0,1.0,0.0,False,False
FenisDembo82,5,52,57,59,2,Strong community,2,1.0350877192982457,0.03508771929824561,False,False
FunOptimal7980,11,3,14,3,25,Noisy community,11,0.21428571428571427,0.7857142857142857,False,False
GabaReceptors,4,3,7,8,0,Strong community,1,1.1428571428571428,0.14285714285714285,False,False
Gurrgurrburr,17,14,31,34,0,Strong community,3,1.096774193548387,0.0967741935483871,False,False
HaikaiNoRenga,13,11,24,22,0,Strong community,2,0.9166666666666666,0.08333333333333333,False,False
Happy-Viper,8,6,14,12,0,Strong community,2,0.8571428571428571,0.14285714285714285,False,False
HardlyDecent,31,21,52,50,2,Strong community,2,0.9615384615384616,0.038461538461538464,False,False
Hellioning,68,26,94,120,0,Strong community,26,1.2765957446808511,0.2765957446808511,False,True
HexspaReloaded,17,16,33,42,0,Strong community,9,1.2727272727272727,0.2727272727272727,False,True
HolyToast,48,37,85,89,0,Strong community,4,1.0470588235294118,0.047058823529411764,True,False
I405CA,94,49,143,139,2,Strong community,4,0.972027972027972,0.027972027972027972,True,False
InNominePasta,13,6,19,17,2,Strong community,2,0.8947368421052632,0.10526315789473684,False,False
Inner_Butterfly1991,35,18,53,49,0,Strong community,4,0.9245283018867925,0.07547169811320754,False,False
JustAdlz,14,10,24,24,0,Strong community,0,1.0,0.0,False,False
Known_Ad871,12,5,17,17,0,Strong community,0,1.0,0.0,False,False
KokonutMonkey,31,5,36,46,0,Strong community,10,1.2777777777777777,0.2777777777777778,False,True
Krytan,39,18,57,62,0,Strong community,5,1.087719298245614,0.08771929824561403,True,False
L11mbm,21,6,27,27,0,Strong community,0,1.0,0.0,False,False
Logogram_alt,9,26,35,41,0,Strong community,6,1.1714285714285715,0.17142857142857143,False,False
Madrigall,18,8,26,6,16,Noisy community,20,0.23076923076923078,0.7692307692307693,False,False
MaineHippo83,68,48,116,56,2,Strong community,60,0.4827586206896552,0.5172413793103449,False,True
MeasurementCreepy926,50,52,102,96,0,Strong community,6,0.9411764705882353,0.058823529411764705,True,False
MorganWick,30,26,56,35,2,Strong community,21,0.625,0.375,False,True
Most_Finger,21,21,42,41,0,Strong community,1,0.9761904761904762,0.023809523809523808,False,False
MrGraeme,43,33,76,79,0,Strong community,3,1.0394736842105263,0.039473684210526314,True,False
Murky-Magician9475,32,25,57,63,0,Strong community,6,1.105263157894737,0.10526315789473684,True,False
Mvpbeserker,9,6,15,16,0,Strong community,1,1.0666666666666667,0.06666666666666667,False,False
MysteryBagIdeals,22,14,36,40,0,Strong community,4,1.1111111111111112,0.1111111111111111,False,False
Mztmarie93,23,26,49,48,2,Strong community,1,0.9795918367346939,0.02040816326530612,False,False
Next_Dragonfruit_415,11,7,18,21,0,Strong community,3,1.1666666666666667,0.16666666666666666,False,False
NotMyBestMistake,39,18,57,52,0,Strong community,5,0.9122807017543859,0.08771929824561403,False,False
Nrdman,141,89,230,264,0,Strong community,34,1.1478260869565218,0.14782608695652175,True,False
Obatala_,10,8,18,18,0,Strong community,0,1.0,0.0,False,False
Ornery-Ticket834,32,21,53,39,2,Strong community,14,0.7358490566037735,0.2641509433962264,False,True
Personal-Ad-6557,11,6,17,18,0,Strong community,1,1.0588235294117647,0.058823529411764705,False,False
Phage0070,34,19,53,70,0,Strong community,17,1.320754716981132,0.32075471698113206,False,True
Potential_Wish4943,46,22,68,69,0,Strong community,1,1.0147058823529411,0.014705882352941176,True,False
Pure_Seat1711,13,2,15,17,0,Strong community,2,1.1333333333333333,0.13333333333333333,False,False
Rabbid0Luigi,29,16,45,52,0,Strong community,7,1.1555555555555554,0.15555555555555556,False,False
Randy_Watson,6,3,9,7,2,Strong community,2,0.7777777777777778,0.2222222222222222,False,False
Reasonable-Fee1945,60,79,139,96,2,Strong community,43,0.6906474820143885,0.30935251798561153,False,True
Redditributor,21,13,34,30,0,Strong community,4,0.8823529411764706,0.11764705882352941,False,False
Roadshell,57,23,80,100,0,Strong community,20,1.25,0.25,False,True
Sageblue32,20,29,49,47,2,Strong community,2,0.9591836734693877,0.04081632653061224,False,False
SantaClausDid911,21,10,31,23,0,Strong community,8,0.7419354838709677,0.25806451612903225,False,True
Senior-Friend-6414,8,6,14,14,0,Strong community,0,1.0,0.0,False,False
Smokey-McPoticuss,11,8,19,19,0,Strong community,0,1.0,0.0,False,False
SpaceCowboy34,17,8,25,29,0,Strong community,4,1.16,0.16,False,False
SpendAccomplished819,15,7,22,20,0,Strong community,2,0.9090909090909091,0.09090909090909091,False,False
Splenda,20,15,35,34,2,Strong community,1,0.9714285714285714,0.02857142857142857,False,False
StevenGrimmas,28,21,49,54,0,Strong community,5,1.1020408163265305,0.10204081632653061,False,False
StinkusMinkus2001,9,8,17,16,0,Strong community,1,0.9411764705882353,0.058823529411764705,False,False
StopblamingTeachers,21,7,28,29,0,Strong community,1,1.0357142857142858,0.03571428571428571,False,False
Successful_Cat_4860,34,5,39,36,0,Strong community,3,0.9230769230769231,0.07692307692307693,False,False
SuckMyBike,35,25,60,62,0,Strong community,2,1.0333333333333334,0.03333333333333333,True,False
Super_Mario_Luigi,25,11,36,38,0,Strong community,2,1.0555555555555556,0.05555555555555555,False,False
TheWhistleThistle,44,22,66,69,0,Strong community,3,1.0454545454545454,0.045454545454545456,True,False
TheYoinkiSploinki,13,9,22,24,0,Strong community,2,1.0909090909090908,0.09090909090909091,False,False
ThisOneForMee,24,14,38,34,0,Strong community,4,0.8947368421052632,0.10526315789473684,False,False
Toverhead,37,18,55,58,0,Strong community,3,1.0545454545454545,0.05454545454545454,False,False
Trylena,9,10,19,20,0,Strong community,1,1.0526315789473684,0.05263157894736842,False,False
Uhhyt231,73,43,116,56,1,Strong community,60,0.4827586206896552,0.5172413793103449,False,True
VortexMagus,12,8,20,19,0,Strong community,1,0.95,0.05,False,False
WinDoeLickr,36,20,56,60,0,Strong community,4,1.0714285714285714,0.07142857142857142,False,False
XenoRyet,75,39,114,138,0,Strong community,24,1.2105263157894737,0.21052631578947367,False,False
YetAnotherGuy2,12,7,19,10,2,Strong community,9,0.5263157894736842,0.47368421052631576,False,True
Z7-852,85,50,135,154,0,Strong community,19,1.1407407407407408,0.14074074074074075,True,False
ZoomZoomDiva,47,29,76,78,0,Strong community,2,1.0263157894736843,0.02631578947368421,True,False
addictedtolife78,20,23,43,48,0,Strong community,5,1.1162790697674418,0.11627906976744186,False,False
amrodd,14,13,27,28,0,Strong community,1,1.037037037037037,0.037037037037037035,False,False
anewleaf1234,81,44,125,132,0,Strong community,7,1.056,0.056,True,False
bifewova234,11,2,13,13,0,Strong community,0,1.0,0.0,False,False
billpalto,34,8,42,44,2,Strong community,2,1.0476190476190477,0.047619047619047616,False,False
curiouslyjake,34,15,49,60,0,Strong community,11,1.2244897959183674,0.22448979591836735,False,True
das_war_ein_Befehl,29,18,47,44,2,Strong community,3,0.9361702127659575,0.06382978723404255,False,False
davidml1023,17,10,27,29,0,Strong community,2,1.0740740740740742,0.07407407407407407,False,False
fascistp0tato,35,78,113,125,0,Strong community,12,1.1061946902654867,0.10619469026548672,True,False
going_my_way0102,26,32,58,58,0,Strong community,0,1.0,0.0,False,False
h4ckerkn0wnas4chan,13,2,15,21,0,Strong community,6,1.4,0.4,False,True
heidismiles,27,16,43,42,0,Strong community,1,0.9767441860465116,0.023255813953488372,False,False
intothewoods76,27,16,43,42,0,Strong community,1,0.9767441860465116,0.023255813953488372,False,False
iosefster,29,15,44,46,0,Strong community,2,1.0454545454545454,0.045454545454545456,False,False
link3945,11,5,16,13,2,Strong community,3,0.8125,0.1875,False,False
loverofmasterbation,5,3,8,7,0,Strong community,1,0.875,0.125,False,False
luigiamarcella,26,10,36,32,0,Strong community,4,0.8888888888888888,0.1111111111111111,False,False
medical_bancruptcy,18,19,37,37,0,Strong community,0,1.0,0.0,False,False
megacide84,7,6,13,17,0,Strong community,4,1.3076923076923077,0.3076923076923077,False,True
melissaphobia,12,7,19,23,0,Strong community,4,1.2105263157894737,0.21052631578947367,False,False
ninja-gecko,42,26,68,70,0,Strong community,2,1.0294117647058822,0.029411764705882353,True,False
nowthatswhat,9,5,14,17,0,Strong community,3,1.2142857142857142,0.21428571428571427,False,False
pomod,14,9,23,20,2,Strong community,3,0.8695652173913043,0.13043478260869565,False,False
poprostumort,41,27,68,78,0,Strong community,10,1.1470588235294117,0.14705882352941177,True,False
premiumPLUM,43,24,67,83,0,Strong community,16,1.2388059701492538,0.23880597014925373,False,True
ralph-j,29,11,40,50,0,Strong community,10,1.25,0.25,False,True
raynorelyp,9,31,40,44,0,Strong community,4,1.1,0.1,False,False
sardine_succotash,47,34,81,62,0,Strong community,19,0.7654320987654321,0.2345679012345679,False,True
satyvakta,85,36,121,127,0,Strong community,6,1.0495867768595042,0.049586776859504134,True,False
shhhOURlilsecret,4,2,6,6,0,Strong community,0,1.0,0.0,False,False
shouldco,41,31,72,73,0,Strong community,1,1.0138888888888888,0.013888888888888888,True,False
sneezywolf2,20,18,38,45,0,Strong community,7,1.1842105263157894,0.18421052631578946,False,False
speedingpullet,13,12,25,24,2,Strong community,1,0.96,0.04,False,False
speedyjohn,34,21,55,57,0,Strong community,2,1.0363636363636364,0.03636363636363636,False,False
stubble3417,10,10,20,18,2,Strong community,2,0.9,0.1,False,False
the_1st_inductionist,76,26,102,118,0,Strong community,16,1.1568627450980393,0.1568627450980392,True,False
whoami9427,17,6,23,23,0,Strong community,0,1.0,0.0,False,False
withlove_07,5,2,7,9,0,Strong community,2,1.2857142857142858,0.2857142857142857,False,False
yesrushgenesis2112,8,5,13,16,0,Strong community,3,1.2307692307692308,0.23076923076923078,False,True
zxxQQz,15,8,23,25,0,Strong community,2,1.0869565217391304,0.08695652173913043,False,False
3OAM,8,15,23,28,0,Strong community,5,1.2173913043478262,0.21739130434782608,False,False
00Oo0o0OooO0,15,6,21,25,0,Strong community,4,1.1904761904761905,0.19047619047619047,False,False
Appropriate_Owl_91,6,6,12,12,0,Strong community,0,1.0,0.0,False,False
Dave_A480,18,5,23,21,0,Strong community,2,0.9130434782608695,0.08695652173913043,False,False
Electronic_Mango1,8,9,17,7,2,Strong community,10,0.4117647058823529,0.5882352941176471,False,True
Giblette101,123,94,217,221,0,Strong community,4,1.0184331797235022,0.018433179723502304,True,False
Kaleb_Bunt,27,1,28,36,0,Strong community,8,1.2857142857142858,0.2857142857142857,False,True
Ok_Border419,70,155,225,245,0,Strong community,20,1.0888888888888888,0.08888888888888889,True,False
Xralius,10,4,14,16,0,Strong community,2,1.1428571428571428,0.14285714285714285,False,False
onethomashall,11,7,18,21,0,Strong community,3,1.1666666666666667,0.16666666666666666,False,False
ontologram,20,7,27,33,0,Strong community,6,1.2222222222222223,0.2222222222222222,False,True
stewmander,13,7,20,21,0,Strong community,1,1.05,0.05,False,False
4-5Million,8,10,18,25,0,Strong community,7,1.3888888888888888,0.3888888888888889,False,True
BarleyWineIsTheBest,34,32,66,73,0,Strong community,7,1.106060606060606,0.10606060606060606,True,False
Kakamile,98,64,162,175,0,Strong community,13,1.0802469135802468,0.08024691358024691,True,False
PM_ME_YOUR_NICE_EYES,68,43,111,124,0,Strong community,13,1.117117117117117,0.11711711711711711,True,False
YardageSardage,32,22,54,62,0,Strong community,8,1.1481481481481481,0.14814814814814814,True,False
arrgobon32,33,13,46,50,0,Strong community,4,1.0869565217391304,0.08695652173913043,False,False
programmerOfYeet,10,7,17,21,0,Strong community,4,1.2352941176470589,0.23529411764705882,False,True
45607,18,28,46,62,0,Strong community,16,1.3478260869565217,0.34782608695652173,False,True
AdAppropriate2295,38,35,73,72,0,Strong community,1,0.9863013698630136,0.0136986301369863,True,False
CocoSavege,52,36,88,90,0,Strong community,2,1.0227272727272727,0.022727272727272728,True,False
Falernum,60,35,95,113,0,Strong community,18,1.1894736842105262,0.18947368421052632,True,False
Far_Commission2655,26,23,49,44,0,Strong community,5,0.8979591836734694,0.10204081632653061,False,False
FerdinandTheGiant,35,27,62,67,0,Strong community,5,1.0806451612903225,0.08064516129032258,True,False
Glory2Hypnotoad,39,21,60,69,0,Strong community,9,1.15,0.15,True,False
JJExecutioner,11,7,18,20,0,Strong community,2,1.1111111111111112,0.1111111111111111,False,False
KaiBahamut,31,21,52,52,0,Strong community,0,1.0,0.0,False,False
Leylolurking,7,6,13,14,0,Strong community,1,1.0769230769230769,0.07692307692307693,False,False
Morthra,142,98,240,245,0,Strong community,5,1.0208333333333333,0.020833333333333332,True,False
Nemeszlekmeg,45,37,82,89,0,Strong community,7,1.0853658536585367,0.08536585365853659,True,False
NewCountry13,13,9,22,23,0,Strong community,1,1.0454545454545454,0.045454545454545456,False,False
Oborozuki1917,20,25,45,47,0,Strong community,2,1.0444444444444445,0.044444444444444446,False,False
RevolutionaryGur4419,27,24,51,40,0,Strong community,11,0.7843137254901961,0.21568627450980393,False,False
SupervisorSCADA,31,20,51,58,0,Strong community,7,1.1372549019607843,0.13725490196078433,False,False
TurbulentArcher1253,51,45,96,100,0,Strong community,4,1.0416666666666667,0.041666666666666664,True,False
Z-e-n-o,3,2,5,7,0,Strong community,2,1.4,0.4,False,False
ZozMercurious,8,7,15,17,0,Strong community,2,1.1333333333333333,0.13333333333333333,False,False
_Royalty_,19,7,26,25,0,Strong community,1,0.9615384615384616,0.038461538461538464,False,False
alfredo094,9,12,21,22,0,Strong community,1,1.0476190476190477,0.047619047619047616,False,False
comeon456,20,10,30,33,0,Strong community,3,1.1,0.1,False,False
eri_is_a_throwaway,15,5,20,19,0,Strong community,1,0.95,0.05,False,False
flairsupply,57,18,75,87,0,Strong community,12,1.16,0.16,True,False
spacebar30,26,16,42,45,0,Strong community,3,1.0714285714285714,0.07142857142857142,False,False
stockinheritance,69,43,112,121,0,Strong community,9,1.0803571428571428,0.08035714285714286,True,False
timmytissue,12,8,20,19,0,Strong community,1,0.95,0.05,False,False
urnever2old2change,15,13,28,20,0,Strong community,8,0.7142857142857143,0.2857142857142857,False,True
4Throw2My0Ass6Away9,7,11,18,6,4,Strong community,12,0.3333333333333333,0.6666666666666666,False,True
--o,10,8,18,13,1,Strong community,5,0.7222222222222222,0.2777777777777778,False,True
Ayjayz,18,10,28,22,0,Strong community,6,0.7857142857142857,0.21428571428571427,False,False
MS-07B-3,11,6,17,3,7,Weak community,14,0.17647058823529413,0.8235294117647058,False,True
NullIsUndefined,16,7,23,19,1,Strong community,4,0.8260869565217391,0.17391304347826086,False,False
Only-Finish-3497,21,12,33,33,1,Strong community,0,1.0,0.0,True,False
Pearberr,3,1,4,4,4,Strong community,0,1.0,0.0,False,False
Rainbwned,89,44,133,115,0,Strong community,18,0.8646616541353384,0.13533834586466165,True,False
Shotgun_Rynoplasty,15,7,22,16,1,Strong community,6,0.7272727272727273,0.2727272727272727,False,True
sir_mrej,8,2,10,7,4,Strong community,3,0.7,0.3,False,True
thatoneguy54,7,4,11,3,10,Weak community,8,0.2727272727272727,0.7272727272727273,False,True
xienwolf,9,4,13,13,4,Strong community,0,1.0,0.0,False,False
4rsenal4lyfe,3,4,7,6,1,Strong community,1,0.8571428571428571,0.14285714285714285,False,False
Cloud_N0ne,6,6,12,12,1,Strong community,0,1.0,0.0,False,False
Mountain-Fox-2123,13,5,18,20,1,Strong community,2,1.1111111111111112,0.1111111111111111,False,False
luniversellearagne,54,20,74,75,1,Strong community,1,1.0135135135135136,0.013513513513513514,True,False
4ss4ssinscr33d,5,9,14,16,1,Strong community,2,1.1428571428571428,0.14285714285714285,False,False
Bracioli-Felipe,7,4,11,11,1,Strong community,0,1.0,0.0,False,False
FlyLikeAnEarworm,12,30,42,36,1,Strong community,6,0.8571428571428571,0.14285714285714285,True,False
Greenhawk444,7,5,12,12,1,Strong community,0,1.0,0.0,False,False
Naos210,9,12,21,21,1,Strong community,0,1.0,0.0,False,False
New_Perception_7838,57,34,91,94,1,Strong community,3,1.032967032967033,0.03296703296703297,True,False
TheMissingPremise,41,78,119,136,0,Strong community,17,1.1428571428571428,0.14285714285714285,True,False
mattronimus007,20,34,54,55,1,Strong community,1,1.0185185185185186,0.018518518518518517,True,False
system-Contr0l111,13,10,23,18,1,Strong community,5,0.782608695652174,0.21739130434782608,False,False
taez555,11,3,14,8,2,Strong community,6,0.5714285714285714,0.42857142857142855,False,True
8NaanJeremy,25,25,50,57,0,Strong community,7,1.14,0.14,False,False
47ca05e6209a317a8fb3,26,7,33,40,0,Strong community,7,1.2121212121212122,0.21212121212121213,False,False
Adventurous_Art4009,5,1,6,6,0,Strong community,0,1.0,0.0,False,False
Fabulous-Suspect-72,10,5,15,16,0,Strong community,1,1.0666666666666667,0.06666666666666667,False,False
Ok-Round-1473,15,10,25,28,0,Strong community,3,1.12,0.12,False,False
SourceTheFlow,7,7,14,17,0,Strong community,3,1.2142857142857142,0.21428571428571427,False,False
gabagoolcel,13,9,22,24,0,Strong community,2,1.0909090909090908,0.09090909090909091,False,False
heroyoudontdeserve,27,17,44,44,0,Strong community,0,1.0,0.0,False,False
katilkoala101,15,5,20,20,0,Strong community,0,1.0,0.0,False,False
misanthpope,8,3,11,11,0,Strong community,0,1.0,0.0,False,False
sh00l33,31,12,43,44,0,Strong community,1,1.0232558139534884,0.023255813953488372,False,False
yyzjertl,78,47,125,146,0,Strong community,21,1.168,0.168,True,False
96suluman,15,18,33,17,2,Strong community,16,0.5151515151515151,0.48484848484848486,False,True
DancingWithAWhiteHat,26,16,42,38,0,Strong community,4,0.9047619047619048,0.09523809523809523,False,False
Liad3008,8,3,11,11,0,Strong community,0,1.0,0.0,False,False
NoWin3930,24,23,47,46,0,Strong community,1,0.9787234042553191,0.02127659574468085,False,False
Ok_Cup_5454,6,5,11,10,2,Strong community,1,0.9090909090909091,0.09090909090909091,False,False
OpeningChipmunk1700,15,13,28,18,2,Strong community,10,0.6428571428571429,0.35714285714285715,False,True
ScrupulousArmadillo,26,14,40,42,0,Strong community,2,1.05,0.05,False,False
asafg8,13,6,19,20,0,Strong community,1,1.0526315789473684,0.05263157894736842,False,False
baes__theorem,27,12,39,38,0,Strong community,1,0.9743589743589743,0.02564102564102564,False,False
squirlnutz,18,48,66,48,1,Strong community,18,0.7272727272727273,0.2727272727272727,False,True
trullaDE,21,7,28,31,0,Strong community,3,1.1071428571428572,0.10714285714285714,False,False
AbleReflection459,3,60,63,52,1,Strong community,11,0.8253968253968254,0.1746031746031746,False,False
Anakin-vs-Sand,12,1,13,13,1,Strong community,0,1.0,0.0,False,False
BlundeRuss,8,26,34,36,1,Strong community,2,1.0588235294117647,0.058823529411764705,False,False
Discussion-is-good,11,8,19,15,1,Strong community,4,0.7894736842105263,0.21052631578947367,False,False
Grammar-Unit-28,7,4,11,13,1,Strong community,2,1.1818181818181819,0.18181818181818182,False,False
HelpDaren,7,5,12,12,1,Strong community,0,1.0,0.0,False,False
HeroBrine0907,20,10,30,27,0,Strong community,3,0.9,0.1,False,False
Huge_Wing51,20,13,33,7,26,Noisy community,26,0.21212121212121213,0.7878787878787878,False,False
Intelligent_Pop1173,18,8,26,29,1,Strong community,3,1.1153846153846154,0.11538461538461539,False,False
JlUKOMOPbE,11,7,18,5,6,Weak community,13,0.2777777777777778,0.7222222222222222,False,True
Jolly_Ad2446,2,22,24,24,1,Strong community,0,1.0,0.0,False,False
LopsidedGrapefruit11,11,2,13,12,1,Strong community,1,0.9230769230769231,0.07692307692307693,False,False
Migraine_Megan,5,1,6,6,1,Strong community,0,1.0,0.0,False,False
NSA_van_3,43,27,70,65,1,Strong community,5,0.9285714285714286,0.07142857142857142,True,False
No_Baseball5846,10,4,14,8,1,Strong community,6,0.5714285714285714,0.42857142857142855,False,True
Noodlefanboi,10,4,14,13,1,Strong community,1,0.9285714285714286,0.07142857142857142,False,False
NotAFloorTank,35,8,43,44,1,Strong community,1,1.0232558139534884,0.023255813953488372,True,False
Notachance326426,20,13,33,25,0,Strong community,8,0.7575757575757576,0.24242424242424243,False,True
Ok-Juice-6857,3,3,6,6,1,Strong community,0,1.0,0.0,False,False
PasicT,6,1,7,6,1,Strong community,1,0.8571428571428571,0.14285714285714285,False,False
Psychological-Dig-29,6,6,12,13,1,Strong community,1,1.0833333333333333,0.08333333333333333,False,False
RDOCallToArms,11,3,14,14,1,Strong community,0,1.0,0.0,False,False
ReceptionLivid,10,5,15,16,1,Strong community,1,1.0666666666666667,0.06666666666666667,False,False
RedshirtBlueshirt97,5,29,34,41,1,Strong community,7,1.2058823529411764,0.20588235294117646,False,False
SamBind121,11,10,21,16,1,Strong community,5,0.7619047619047619,0.23809523809523808,False,True
SirVoltington,8,6,14,10,0,Strong community,4,0.7142857142857143,0.2857142857142857,False,True
SlipperWheels,21,12,33,34,0,Strong community,1,1.0303030303030303,0.030303030303030304,False,False
Sloppykrab,25,18,43,16,1,Strong community,27,0.37209302325581395,0.627906976744186,False,True
Smasher31232,8,45,53,47,1,Strong community,6,0.8867924528301887,0.11320754716981132,False,False
SomewhereAggressive8,6,5,11,9,1,Strong community,2,0.8181818181818182,0.18181818181818182,False,False
Steeltoelion,4,2,6,8,1,Strong community,2,1.3333333333333333,0.3333333333333333,False,False
THElaytox,11,3,14,11,1,Strong community,3,0.7857142857142857,0.21428571428571427,False,False
TheArchitect515,18,8,26,27,1,Strong community,1,1.0384615384615385,0.038461538461538464,False,False
Unhaply_FlowerXII,23,15,38,32,0,Strong community,6,0.8421052631578947,0.15789473684210525,False,False
Wild-Spare4672,7,2,9,4,15,Noisy community,5,0.4444444444444444,0.5555555555555556,False,False
Wonderful_Sorbet_546,3,2,5,2,57,Noisy community,3,0.4,0.6,False,False
Xayne813,5,3,8,8,1,Strong community,0,1.0,0.0,False,False
aespaste,23,61,84,71,0,Strong community,13,0.8452380952380952,0.15476190476190477,True,False
banana_in_the_dark,6,11,17,7,3,Strong community,10,0.4117647058823529,0.5882352941176471,False,True
bluerog,8,11,19,23,1,Strong community,4,1.2105263157894737,0.21052631578947367,False,False
bostonbananarama,10,4,14,12,1,Strong community,2,0.8571428571428571,0.14285714285714285,False,False
ekydfejj,12,8,20,19,1,Strong community,1,0.95,0.05,False,False
empericisttilldeath,7,2,9,6,1,Strong community,3,0.6666666666666666,0.3333333333333333,False,True
homiegeet,8,3,11,9,1,Strong community,2,0.8181818181818182,0.18181818181818182,False,False
idonthaveanaccountA,12,3,15,15,1,Strong community,0,1.0,0.0,False,False
itsonmyprofile,7,5,12,11,1,Strong community,1,0.9166666666666666,0.08333333333333333,False,False
jgamez76,21,11,32,30,1,Strong community,2,0.9375,0.0625,False,False
juanzy,36,32,68,67,1,Strong community,1,0.9852941176470589,0.014705882352941176,True,False
loggerhead632,24,7,31,34,1,Strong community,3,1.096774193548387,0.0967741935483871,False,False
luxsatanas,11,6,17,16,1,Strong community,1,0.9411764705882353,0.058823529411764705,False,False
maiastella,7,12,19,16,1,Strong community,3,0.8421052631578947,0.15789473684210525,False,False
mrsauceysauce,6,4,10,12,1,Strong community,2,1.2,0.2,False,False
proffesionalproblem,9,5,14,16,1,Strong community,2,1.1428571428571428,0.14285714285714285,False,False
rewt127,19,10,29,20,0,Strong community,9,0.6896551724137931,0.3103448275862069,False,True
rogan1990,12,3,15,16,1,Strong community,1,1.0666666666666667,0.06666666666666667,False,False
rollercostarican,9,7,16,17,1,Strong community,1,1.0625,0.0625,False,False
sarcasticorange,23,15,38,22,1,Strong community,16,0.5789473684210527,0.42105263157894735,False,True
w1n5t0nM1k3y,10,2,12,8,1,Strong community,4,0.6666666666666666,0.3333333333333333,False,True
wiiguyy,13,1,14,15,1,Strong community,1,1.0714285714285714,0.07142857142857142,False,False
Absolium,11,31,42,40,3,Strong community,2,0.9523809523809523,0.047619047619047616,True,False
AurynSharay,7,2,9,8,3,Strong community,1,0.8888888888888888,0.1111111111111111,False,False
Constant_Host_3212,15,5,20,19,3,Strong community,1,0.95,0.05,False,False
DarthRedYoga,17,7,24,25,3,Strong community,1,1.0416666666666667,0.041666666666666664,False,False
DefinitelyNotAliens,18,10,28,19,3,Strong community,9,0.6785714285714286,0.32142857142857145,False,True
Healthy_Brain5354,7,4,11,5,17,Noisy community,6,0.45454545454545453,0.5454545454545454,False,False
Important_Pattern_85,13,10,23,14,0,Strong community,9,0.6086956521739131,0.391304347826087,False,True
Key-Pickle5609,9,4,13,6,1,Strong community,7,0.46153846153846156,0.5384615384615384,False,True
Lurkyloo1987,5,4,9,8,3,Strong community,1,0.8888888888888888,0.1111111111111111,False,False
Moni_CSM,4,4,8,3,17,Noisy community,5,0.375,0.625,False,False
NandoDeColonoscopy,7,6,13,12,3,Strong community,1,0.9230769230769231,0.07692307692307693,False,False
Ok-Knowledge9154,14,7,21,20,3,Strong community,1,0.9523809523809523,0.047619047619047616,False,False
Osiris0734,5,9,14,15,3,Strong community,1,1.0714285714285714,0.07142857142857142,False,False
RickRussellTX,34,19,53,40,0,Strong community,13,0.7547169811320755,0.24528301886792453,False,True
SheWhoIsNot,6,3,9,11,3,Strong community,2,1.2222222222222223,0.2222222222222222,False,False
South_Industry_1953,11,6,17,21,3,Strong community,4,1.2352941176470589,0.23529411764705882,False,True
Taisiecat,12,3,15,16,3,Strong community,1,1.0666666666666667,0.06666666666666667,False,False
ThePurplestMeerkat,15,12,27,22,3,Strong community,5,0.8148148148148148,0.18518518518518517,False,False
Travelgrrl,7,3,10,9,3,Strong community,1,0.9,0.1,False,False
Trevena_Ice,9,3,12,15,3,Strong community,3,1.25,0.25,False,True
darthoffa,3,2,5,4,17,Noisy community,1,0.8,0.2,False,False
ded517,8,4,12,13,3,Strong community,1,1.0833333333333333,0.08333333333333333,False,False
epicmooz,2,4,6,5,3,Strong community,1,0.8333333333333334,0.16666666666666666,False,False
jahubb062,10,12,22,20,3,Strong community,2,0.9090909090909091,0.09090909090909091,False,False
jamintime,14,3,17,13,3,Strong community,4,0.7647058823529411,0.23529411764705882,False,True
k23_k23,48,5,53,56,3,Strong community,3,1.0566037735849056,0.05660377358490566,False,False
makethatnoise,2,2,4,6,3,Strong community,2,1.5,0.5,False,False
notyourmartyr,11,8,19,7,8,Weak community,12,0.3684210526315789,0.631578947368421,False,True
readergirl35,19,8,27,28,3,Strong community,1,1.037037037037037,0.037037037037037035,False,False
rubylee_28,18,8,26,19,0,Strong community,7,0.7307692307692307,0.2692307692307692,False,True
AchillesFirstStand,6,8,14,17,1,Strong community,3,1.2142857142857142,0.21428571428571427,False,False
Cart700,5,5,10,9,1,Strong community,1,0.9,0.1,False,False
Dazz316,33,22,55,55,1,Strong community,0,1.0,0.0,True,False
Frost-Folk,14,8,22,12,1,Strong community,10,0.5454545454545454,0.45454545454545453,False,True
MysteriousConflict38,13,3,16,16,1,Strong community,0,1.0,0.0,False,False
RightHabit,12,5,17,17,1,Strong community,0,1.0,0.0,False,False
Swirlyflurry,33,5,38,22,3,Strong community,16,0.5789473684210527,0.42105263157894735,False,True
Active_Host6485,8,10,18,25,0,Strong community,7,1.3888888888888888,0.3888888888888889,False,True
GenTwour,10,5,15,20,0,Strong community,5,1.3333333333333333,0.3333333333333333,False,True
Relevant_Actuary2205,66,32,98,110,0,Strong community,12,1.1224489795918366,0.12244897959183673,True,False
Siukslinis_acc,19,12,31,32,0,Strong community,1,1.032258064516129,0.03225806451612903,False,False
Tangentkoala,11,6,17,18,0,Strong community,1,1.0588235294117647,0.058823529411764705,False,False
TheVioletBarry,55,30,85,95,0,Strong community,10,1.1176470588235294,0.11764705882352941,True,False
cheddyvedder,4,3,7,9,0,Strong community,2,1.2857142857142858,0.2857142857142857,False,False
Actual_Parsnip4707,17,17,34,44,0,Strong community,10,1.2941176470588236,0.29411764705882354,False,True
Arthesia,30,10,40,49,0,Strong community,9,1.225,0.225,False,True
CauseAdventurous5623,27,20,47,50,0,Strong community,3,1.0638297872340425,0.06382978723404255,False,False
Constellation-88,33,21,54,56,0,Strong community,2,1.037037037037037,0.037037037037037035,False,False
Im_Orange_Joe,7,4,11,7,1,Strong community,4,0.6363636363636364,0.36363636363636365,False,True
RegularEquipment3341,20,11,31,35,0,Strong community,4,1.1290322580645162,0.12903225806451613,False,False
Top_Neat2780,11,7,18,20,0,Strong community,2,1.1111111111111112,0.1111111111111111,False,False
cantantantelope,23,18,41,44,0,Strong community,3,1.0731707317073171,0.07317073170731707,False,False
robdingo36,8,6,14,17,0,Strong community,3,1.2142857142857142,0.21428571428571427,False,False
sapphireminds,10,9,19,21,0,Strong community,2,1.105263157894737,0.10526315789473684,False,False
ActuatorOutside5256,11,25,36,45,0,Strong community,9,1.25,0.25,False,True
ChihuahuaNoob,23,16,39,40,0,Strong community,1,1.0256410256410255,0.02564102564102564,False,False
DerekVanGorder,6,5,11,14,0,Strong community,3,1.2727272727272727,0.2727272727272727,False,True
Elegant-Variety-7482,10,13,23,28,0,Strong community,5,1.2173913043478262,0.21739130434782608,False,False
Inner_Condition8955,8,5,13,14,0,Strong community,1,1.0769230769230769,0.07692307692307693,False,False
Karmaze,18,11,29,31,0,Strong community,2,1.0689655172413792,0.06896551724137931,False,False
Lanavis13,22,15,37,36,0,Strong community,1,0.972972972972973,0.02702702702702703,False,False
Ok-Emu-2881,4,4,8,8,0,Strong community,0,1.0,0.0,False,False
Putrefied_Goblin,11,12,23,23,0,Strong community,0,1.0,0.0,False,False
Sirhc978,21,11,32,39,0,Strong community,7,1.21875,0.21875,False,False
Vesurel,19,11,30,37,0,Strong community,7,1.2333333333333334,0.23333333333333334,False,True
eyetwitch_24_7,20,7,27,33,0,Strong community,6,1.2222222222222223,0.2222222222222222,False,True
formandovega,30,21,51,50,0,Strong community,1,0.9803921568627451,0.0196078431372549,False,False
grandoctopus64,7,4,11,13,0,Strong community,2,1.1818181818181819,0.18181818181818182,False,False
majesticSkyZombie,150,137,287,143,1,Strong community,144,0.49825783972125437,0.5017421602787456,False,True
squidgy617,3,2,5,6,0,Strong community,1,1.2,0.2,False,False
AdImmediate9569,15,18,33,42,0,Strong community,9,1.2727272727272727,0.2727272727272727,False,True
Alternative_Oil7733,34,24,58,60,0,Strong community,2,1.0344827586206897,0.034482758620689655,False,False
Both-Structure-6786,20,3,23,31,0,Strong community,8,1.3478260869565217,0.34782608695652173,False,True
DarroonDoven,12,9,21,22,0,Strong community,1,1.0476190476190477,0.047619047619047616,False,False
E-Reptile,15,8,23,29,0,Strong community,6,1.2608695652173914,0.2608695652173913,False,True
Goodlake,10,3,13,16,0,Strong community,3,1.2307692307692308,0.23076923076923078,False,True
HadeanBlands,130,91,221,227,0,Strong community,6,1.0271493212669682,0.027149321266968326,True,False
Jew_of_house_Levi,32,12,44,52,0,Strong community,8,1.1818181818181819,0.18181818181818182,False,False
Klutzy_Routine_9823,9,5,14,16,0,Strong community,2,1.1428571428571428,0.14285714285714285,False,False
RedOceanofthewest,57,35,92,93,0,Strong community,1,1.0108695652173914,0.010869565217391304,True,False
americafuckyea,12,9,21,23,0,Strong community,2,1.0952380952380953,0.09523809523809523,False,False
viaJormungandr,12,6,18,22,0,Strong community,4,1.2222222222222223,0.2222222222222222,False,True
AdamantForeskin,6,24,30,34,0,Strong community,4,1.1333333333333333,0.13333333333333333,False,False
68_hi,19,12,31,30,0,Strong community,1,0.967741935483871,0.03225806451612903,False,False
Affectionate-War7655,42,19,61,66,0,Strong community,5,1.0819672131147542,0.08196721311475409,True,False
Finch20,27,14,41,50,0,Strong community,9,1.2195121951219512,0.21951219512195122,False,True
Gexm13,13,6,19,19,0,Strong community,0,1.0,0.0,False,False
ScreenTricky4257,30,17,47,39,0,Strong community,8,0.8297872340425532,0.1702127659574468,False,False
SiPhoenix,30,25,55,52,0,Strong community,3,0.9454545454545454,0.05454545454545454,False,False
aardvark_gnat,38,37,75,81,0,Strong community,6,1.08,0.08,True,False
badlyagingmillenial,19,7,26,26,0,Strong community,0,1.0,0.0,False,False
darkplonzo,18,9,27,28,0,Strong community,1,1.037037037037037,0.037037037037037035,False,False
hermitix,9,4,13,12,0,Strong community,1,0.9230769230769231,0.07692307692307693,False,False
pavilionaire2022,16,9,25,26,0,Strong community,1,1.04,0.04,False,False
sokuyari99,6,6,12,10,0,Strong community,2,0.8333333333333334,0.16666666666666666,False,False
thegarymarshall,12,5,17,12,0,Strong community,5,0.7058823529411765,0.29411764705882354,False,True
yosisoy,8,5,13,15,0,Strong community,2,1.1538461538461537,0.15384615384615385,False,False
Additional-Leg-1539,10,16,26,30,0,Strong community,4,1.1538461538461537,0.15384615384615385,False,False
CaptCynicalPants,130,65,195,208,0,Strong community,13,1.0666666666666667,0.06666666666666667,True,False
Evening_Spot_5151,22,12,34,39,0,Strong community,5,1.1470588235294117,0.14705882352941177,False,False
Letters_to_Dionysus,58,20,78,86,0,Strong community,8,1.1025641025641026,0.10256410256410256,True,False
NeoLeonn3,12,8,20,23,0,Strong community,3,1.15,0.15,False,False
Putrid-Storage-9827,7,5,12,14,0,Strong community,2,1.1666666666666667,0.16666666666666666,False,False
Puzzleheaded-Bat-511,20,12,32,36,0,Strong community,4,1.125,0.125,False,False
VanHelsingBerserk,13,9,22,9,1,Strong community,13,0.4090909090909091,0.5909090909090909,False,True
alpicola,13,8,21,22,0,Strong community,1,1.0476190476190477,0.047619047619047616,False,False
yeahmanbombclaut,11,8,19,19,0,Strong community,0,1.0,0.0,False,False
Adorable_Standard_25,12,46,58,61,2,Strong community,3,1.0517241379310345,0.05172413793103448,True,False
Aazadan,16,12,28,24,2,Strong community,4,0.8571428571428571,0.14285714285714285,False,False
Ashmedai,43,37,80,76,2,Strong community,4,0.95,0.05,True,False
Balanced_Outlook,40,38,78,66,2,Strong community,12,0.8461538461538461,0.15384615384615385,True,False
Banes_Addiction,21,9,30,29,2,Strong community,1,0.9666666666666667,0.03333333333333333,False,False
BluesSuedeClues,99,193,292,317,2,Strong community,25,1.0856164383561644,0.08561643835616438,True,False
CelestialFury,12,9,21,21,2,Strong community,0,1.0,0.0,False,False
Cluefuljewel,14,8,22,20,2,Strong community,2,0.9090909090909091,0.09090909090909091,False,False
Dr_CleanBones,24,23,47,42,2,Strong community,5,0.8936170212765957,0.10638297872340426,False,False
Far_Realm_Sage,15,3,18,18,2,Strong community,0,1.0,0.0,False,False
Frank_JWilson,32,19,51,24,2,Strong community,27,0.47058823529411764,0.5294117647058824,False,True
Funklestein,34,20,54,54,2,Strong community,0,1.0,0.0,False,False
HowDoIEvenEnglish,8,10,18,14,2,Strong community,4,0.7777777777777778,0.2222222222222222,False,True
Kevin-W,20,20,40,39,2,Strong community,1,0.975,0.025,False,False
Leather-Map-8138,23,12,35,37,2,Strong community,2,1.0571428571428572,0.05714285714285714,False,False
Mist_Rising,33,39,72,63,2,Strong community,9,0.875,0.125,True,False
Mrgoodtrips64,21,17,38,38,2,Strong community,0,1.0,0.0,False,False
Nothing_Better_3_Do,57,34,91,92,2,Strong community,1,1.010989010989011,0.01098901098901099,True,False
Petrichordates,49,37,86,86,2,Strong community,0,1.0,0.0,True,False
RCA2CE,67,39,106,104,2,Strong community,2,0.9811320754716981,0.018867924528301886,True,False
TaxLawKingGA,14,6,20,20,2,Strong community,0,1.0,0.0,False,False
TheNavigatrix,12,21,33,32,2,Strong community,1,0.9696969696969697,0.030303030303030304,False,False
Xanto97,12,7,19,17,2,Strong community,2,0.8947368421052632,0.10526315789473684,False,False
Xytak,21,12,33,25,2,Strong community,8,0.7575757575757576,0.24242424242424243,False,True
Zagden,30,17,47,47,2,Strong community,0,1.0,0.0,False,False
anti-torque,30,29,59,56,2,Strong community,3,0.9491525423728814,0.05084745762711865,True,False
baxterstate,61,33,94,86,2,Strong community,8,0.9148936170212766,0.0851063829787234,True,False
bl1y,101,121,222,215,2,Strong community,7,0.9684684684684685,0.03153153153153153,True,False
countrykev,16,11,27,24,2,Strong community,3,0.8888888888888888,0.1111111111111111,False,False
daretoeatapeach,7,8,15,13,2,Strong community,2,0.8666666666666667,0.13333333333333333,False,False
eh_steve_420,19,30,49,49,2,Strong community,0,1.0,0.0,False,False
ewokninja123,11,8,19,18,2,Strong community,1,0.9473684210526315,0.05263157894736842,False,False
frisbeejesus,30,14,44,28,2,Strong community,16,0.6363636363636364,0.36363636363636365,False,True
just_helping,48,58,106,104,2,Strong community,2,0.9811320754716981,0.018867924528301886,True,False
kingjoey52a,47,14,61,41,2,Strong community,20,0.6721311475409836,0.32786885245901637,False,True
kinkgirlwriter,22,18,40,41,2,Strong community,1,1.025,0.025,False,False
mrjcall,39,24,63,62,2,Strong community,1,0.9841269841269841,0.015873015873015872,True,False
slayer_of_idiots,38,17,55,50,2,Strong community,5,0.9090909090909091,0.09090909090909091,False,False
sunshine_is_hot,35,21,56,38,2,Strong community,18,0.6785714285714286,0.32142857142857145,False,True
zaoldyeck,72,57,129,94,2,Strong community,35,0.7286821705426356,0.2713178294573643,False,True
Advanced-Light317,3,19,22,17,3,Strong community,5,0.7727272727272727,0.22727272727272727,False,True
BlaineTog,13,6,19,20,3,Strong community,1,1.0526315789473684,0.05263157894736842,False,False
Entorien_Scriber,6,1,7,6,3,Strong community,1,0.8571428571428571,0.14285714285714285,False,False
Kaurifish,11,7,18,1,27,Noisy community,17,0.05555555555555555,0.9444444444444444,False,False
LavishnessGeneral,5,2,7,5,3,Strong community,2,0.7142857142857143,0.2857142857142857,False,False
MennionSaysSo,18,10,28,23,0,Strong community,5,0.8214285714285714,0.17857142857142858,False,False
Moose-Live,20,9,29,29,3,Strong community,0,1.0,0.0,False,False
No-Assignment5538,29,14,43,41,3,Strong community,2,0.9534883720930233,0.046511627906976744,True,False
No_Scarcity8249,12,4,16,8,3,Strong community,8,0.5,0.5,False,True
On_my_last_spoon,14,7,21,11,1,Strong community,10,0.5238095238095238,0.47619047619047616,False,True
PomegranateZanzibar,12,5,17,18,3,Strong community,1,1.0588235294117647,0.058823529411764705,False,False
RealIsopodHours3,3,4,7,6,3,Strong community,1,0.8571428571428571,0.14285714285714285,False,False
SQ_Madriel,15,5,20,24,3,Strong community,4,1.2,0.2,False,False
maybebaebea,23,15,38,39,1,Strong community,1,1.0263157894736843,0.02631578947368421,True,False
oop_norf,26,14,40,39,3,Strong community,1,0.975,0.025,True,False
spid3rham90,19,9,28,29,3,Strong community,1,1.0357142857142858,0.03571428571428571,False,False
unsafeideas,16,12,28,28,3,Strong community,0,1.0,0.0,False,False
zouss,7,5,12,10,0,Strong community,2,0.8333333333333334,0.16666666666666666,False,False
Adventurous_Newt_668,3,7,10,17,3,Strong community,7,1.7,0.7,False,True
Individual_Ad_9213,16,3,19,25,3,Strong community,6,1.3157894736842106,0.3157894736842105,False,True
zealot_ratio,13,2,15,18,3,Strong community,3,1.2,0.2,False,False
Adymestic,3,8,11,13,1,Strong community,2,1.1818181818181819,0.18181818181818182,False,False
BuddhaFacepalmed,14,15,29,26,1,Strong community,3,0.896551724137931,0.10344827586206896,False,False
Disorderly_Fashion,21,22,43,38,1,Strong community,5,0.8837209302325582,0.11627906976744186,True,False
Emcee_nobody,8,5,13,16,1,Strong community,3,1.2307692307692308,0.23076923076923078,False,True
HebiSnakeHebi,11,10,21,20,1,Strong community,1,0.9523809523809523,0.047619047619047616,False,False
New_General3939,27,10,37,30,0,Strong community,7,0.8108108108108109,0.1891891891891892,False,False
ZealousidealHeron4,9,9,18,20,1,Strong community,2,1.1111111111111112,0.1111111111111111,False,False
papayabush,6,7,13,17,1,Strong community,4,1.3076923076923077,0.3076923076923077,False,True
Aeshtrixx,2,2,4,6,3,Strong community,2,1.5,0.5,False,False
ScarletNotThatOne,60,17,77,87,3,Strong community,10,1.12987012987013,0.12987012987012986,True,False
Afraid-Information88,0,5,5,3,5,Strong community,2,0.6,0.4,False,False
Beautiful-Produce-92,8,6,14,12,5,Strong community,2,0.8571428571428571,0.14285714285714285,False,False
LilpirahnaX,7,0,7,8,5,Strong community,1,1.1428571428571428,0.14285714285714285,False,False
shestootight4you,29,10,39,31,5,Strong community,8,0.7948717948717948,0.20512820512820512,False,False
wozattacks,8,6,14,3,18,Noisy community,11,0.21428571428571427,0.7857142857142857,False,False
AfricanAmericanTsar,28,106,134,153,0,Strong community,19,1.1417910447761195,0.1417910447761194,True,False
707theGOAT,4,3,7,7,0,Strong community,0,1.0,0.0,False,False
ARandomCanadian1984,5,4,9,1,47,Noisy community,8,0.1111111111111111,0.8888888888888888,False,False
Aezora,16,7,23,29,0,Strong community,6,1.2608695652173914,0.2608695652173913,False,True
Anonymous_1q,34,21,55,57,0,Strong community,2,1.0363636363636364,0.03636363636363636,False,False
AnxiousChaosUnicorn,16,15,31,27,0,Strong community,4,0.8709677419354839,0.12903225806451613,False,False
BrownCongee,17,10,27,25,0,Strong community,2,0.9259259259259259,0.07407407407407407,False,False
Bunbatbop,14,7,21,20,0,Strong community,1,0.9523809523809523,0.047619047619047616,False,False
BurnedUp11,20,10,30,31,0,Strong community,1,1.0333333333333334,0.03333333333333333,False,False
CadenVanV,19,12,31,32,0,Strong community,1,1.032258064516129,0.03225806451612903,False,False
Crash927,31,22,53,57,0,Strong community,4,1.0754716981132075,0.07547169811320754,False,False
Cyllindra,12,6,18,23,0,Strong community,5,1.2777777777777777,0.2777777777777778,False,True
Darkmayday,10,6,16,17,0,Strong community,1,1.0625,0.0625,False,False
Doub13D,76,48,124,136,0,Strong community,12,1.096774193548387,0.0967741935483871,True,False
Exact-Inspector-6884,10,6,16,19,0,Strong community,3,1.1875,0.1875,False,False
Final-Prize2834,12,14,26,25,0,Strong community,1,0.9615384615384616,0.038461538461538464,False,False
FineDingo3542,8,5,13,11,0,Strong community,2,0.8461538461538461,0.15384615384615385,False,False
First-Lengthiness-16,8,4,12,8,0,Strong community,4,0.6666666666666666,0.3333333333333333,False,True
GorgeousGal314,28,30,58,27,1,Strong community,31,0.46551724137931033,0.5344827586206896,False,True
Homey-Airport-Int,12,7,19,3,35,Noisy community,16,0.15789473684210525,0.8421052631578947,False,False
IleGrandePagliaccio,32,21,53,35,0,Strong community,18,0.660377358490566,0.33962264150943394,False,True
ImJustSaying34,12,8,20,18,0,Strong community,2,0.9,0.1,False,False
JawtisticShark,31,16,47,49,0,Strong community,2,1.0425531914893618,0.0425531914893617,False,False
Justame13,20,16,36,26,0,Strong community,10,0.7222222222222222,0.2777777777777778,False,True
Kangaroo_shampoo4U,3,4,7,3,47,Noisy community,4,0.42857142857142855,0.5714285714285714,False,False
Km15u,39,23,62,59,0,Strong community,3,0.9516129032258065,0.04838709677419355,False,False
Kotoperek,34,28,62,75,0,Strong community,13,1.2096774193548387,0.20967741935483872,False,False
LettuceFuture8840,51,45,96,51,2,Strong community,45,0.53125,0.46875,False,True
Mairon12,28,15,43,43,0,Strong community,0,1.0,0.0,False,False
N7Longhorn,4,1,5,5,0,Strong community,0,1.0,0.0,False,False
NessaSamantha,21,10,31,32,0,Strong community,1,1.032258064516129,0.03225806451612903,False,False
Only-Butterscotch785,12,10,22,23,0,Strong community,1,1.0454545454545454,0.045454545454545456,False,False
PeoplePerson_57,30,20,50,47,0,Strong community,3,0.94,0.06,False,False
Puzzleheaded_Quit925,17,6,23,27,0,Strong community,4,1.173913043478261,0.17391304347826086,False,False
ReOsIr10,23,11,34,40,0,Strong community,6,1.1764705882352942,0.17647058823529413,False,False
RealJohnBobJoe,13,5,18,22,0,Strong community,4,1.2222222222222223,0.2222222222222222,False,True
Rhundan,49,41,90,104,0,Strong community,14,1.1555555555555554,0.15555555555555556,True,False
SilverWear5467,13,6,19,17,0,Strong community,2,0.8947368421052632,0.10526315789473684,False,False
Speerite,5,8,13,12,0,Strong community,1,0.9230769230769231,0.07692307692307693,False,False
StarChild413,49,62,111,94,0,Strong community,17,0.8468468468468469,0.15315315315315314,True,False
StartledMilk,20,14,34,32,0,Strong community,2,0.9411764705882353,0.058823529411764705,False,False
Sudden-Committee298,6,3,9,10,0,Strong community,1,1.1111111111111112,0.1111111111111111,False,False
SurviveDaddy,20,3,23,16,0,Strong community,7,0.6956521739130435,0.30434782608695654,False,True
TacticalCocoaBunny,8,2,10,11,0,Strong community,1,1.1,0.1,False,False
TemperatureThese7909,64,12,76,88,0,Strong community,12,1.1578947368421053,0.15789473684210525,True,False
Thoth_the_5th_of_Tho,44,27,71,78,0,Strong community,7,1.0985915492957747,0.09859154929577464,True,False
TurtleTurtleFTW,8,2,10,11,0,Strong community,1,1.1,0.1,False,False
Weak-Cat8743,34,5,39,45,0,Strong community,6,1.1538461538461537,0.15384615384615385,False,False
WindyWindona,12,8,20,24,0,Strong community,4,1.2,0.2,False,False
YouJustNeurotic,72,42,114,125,0,Strong community,11,1.0964912280701755,0.09649122807017543,True,False
angeldemon5,28,20,48,48,0,Strong community,0,1.0,0.0,False,False
angry_cabbie,21,11,32,31,0,Strong community,1,0.96875,0.03125,False,False
apri08101989,16,7,23,18,0,Strong community,5,0.782608695652174,0.21739130434782608,False,False
badass_panda,29,17,46,47,0,Strong community,1,1.0217391304347827,0.021739130434782608,False,False
colt707,31,18,49,45,0,Strong community,4,0.9183673469387755,0.08163265306122448,False,False
flanneur,6,4,10,5,11,Weak community,5,0.5,0.5,False,True
joepierson123,24,8,32,32,0,Strong community,0,1.0,0.0,False,False
lobonmc,32,13,45,48,0,Strong community,3,1.0666666666666667,0.06666666666666667,False,False
poorestprince,23,8,31,39,0,Strong community,8,1.2580645161290323,0.25806451612903225,False,True
rightful_vagabond,49,33,82,94,0,Strong community,12,1.146341463414634,0.14634146341463414,True,False
saintsithney,16,11,27,23,0,Strong community,4,0.8518518518518519,0.14814814814814814,False,False
scorpiomover,34,16,50,51,0,Strong community,1,1.02,0.02,False,False
themcos,57,34,91,106,0,Strong community,15,1.164835164835165,0.16483516483516483,True,False
tigerzzzaoe,28,19,47,56,0,Strong community,9,1.1914893617021276,0.19148936170212766,False,False
timeless1991,35,14,49,44,0,Strong community,5,0.8979591836734694,0.10204081632653061,False,False
veggiesama,12,5,17,22,0,Strong community,5,1.2941176470588236,0.29411764705882354,False,True
AgUnityDD,8,47,55,55,0,Strong community,0,1.0,0.0,False,False
10thAmdAbsolutist,41,40,81,78,0,Strong community,3,0.9629629629629629,0.037037037037037035,True,False
AleristheSeeker,21,12,33,41,0,Strong community,8,1.2424242424242424,0.24242424242424243,False,True
Aslamtum,9,3,12,14,1,Strong community,2,1.1666666666666667,0.16666666666666666,False,False
BrooklynSmash,17,8,25,24,0,Strong community,1,0.96,0.04,False,False
ConversationAbject99,8,3,11,10,0,Strong community,1,0.9090909090909091,0.09090909090909091,False,False
Dare_Ask_67,14,24,38,49,0,Strong community,11,1.2894736842105263,0.2894736842105263,False,True
DigglerD,17,12,29,27,0,Strong community,2,0.9310344827586207,0.06896551724137931,False,False
Eat--The--Rich--,26,11,37,34,0,Strong community,3,0.918918918918919,0.08108108108108109,False,False
Falsequivalence,7,3,10,9,0,Strong community,1,0.9,0.1,False,False
Flashy-Pizza-229,6,4,10,10,0,Strong community,0,1.0,0.0,False,False
Flor1daman08,40,40,80,38,2,Strong community,42,0.475,0.525,False,True
Kerostasis,66,41,107,114,0,Strong community,7,1.0654205607476634,0.06542056074766354,True,False
MaxwellKillMill,6,3,9,7,0,Strong community,2,0.7777777777777778,0.2222222222222222,False,False
Middle_Ad8183,15,14,29,19,0,Strong community,10,0.6551724137931034,0.3448275862068966,False,True
Ok_Artichoke_2928,8,3,11,13,0,Strong community,2,1.1818181818181819,0.18181818181818182,False,False
P4ULUS,23,7,30,31,0,Strong community,1,1.0333333333333334,0.03333333333333333,False,False
Qubit_Or_Not_To_Bit_,26,16,42,40,0,Strong community,2,0.9523809523809523,0.047619047619047616,False,False
RegressToTheMean,24,11,35,18,2,Strong community,17,0.5142857142857142,0.4857142857142857,False,True
Rusty-Shackleford000,22,16,38,37,0,Strong community,1,0.9736842105263158,0.02631578947368421,False,False
ScalesOfAnubis19,34,25,59,58,0,Strong community,1,0.9830508474576272,0.01694915254237288,False,False
Severe-Illustrator87,5,1,6,6,0,Strong community,0,1.0,0.0,False,False
Significant-Owl-2980,12,8,20,16,0,Strong community,4,0.8,0.2,False,False
SmartYouth9886,21,11,32,37,0,Strong community,5,1.15625,0.15625,False,False
Socialimbad1991,26,24,50,48,0,Strong community,2,0.96,0.04,False,False
Suspicious-Word-7589,12,9,21,21,0,Strong community,0,1.0,0.0,False,False
Utterlybored,20,8,28,24,2,Strong community,4,0.8571428571428571,0.14285714285714285,False,False
crashfrog05,22,11,33,32,0,Strong community,1,0.9696969696969697,0.030303030303030304,False,False
dirtysyncs,4,2,6,6,0,Strong community,0,1.0,0.0,False,False
dukeimre,23,15,38,39,0,Strong community,1,1.0263157894736843,0.02631578947368421,False,False
elCharderino,9,17,26,22,0,Strong community,4,0.8461538461538461,0.15384615384615385,False,False
mapadofu,13,4,17,19,0,Strong community,2,1.1176470588235294,0.11764705882352941,False,False
ryan_770,7,8,15,9,2,Strong community,6,0.6,0.4,False,True
Aggravating_Area6242,12,84,96,100,0,Strong community,4,1.0416666666666667,0.041666666666666664,True,False
-C4-,5,4,9,9,0,Strong community,0,1.0,0.0,False,False
33ITM420,31,7,38,46,0,Strong community,8,1.2105263157894737,0.21052631578947367,False,False
90daysismytherapy,7,6,13,14,0,Strong community,1,1.0769230769230769,0.07692307692307693,False,False
A_SNAPPIN_Turla,9,4,13,12,0,Strong community,1,0.9230769230769231,0.07692307692307693,False,False
According_Smell_6421,5,3,8,9,0,Strong community,1,1.125,0.125,False,False
Affectionate-Web3630,4,4,8,8,0,Strong community,0,1.0,0.0,False,False
BitcoinMD,25,7,32,34,0,Strong community,2,1.0625,0.0625,False,False
CgradeCheese,3,4,7,8,0,Strong community,1,1.1428571428571428,0.14285714285714285,False,False
Cheeseisgood1981,4,3,7,6,0,Strong community,1,0.8571428571428571,0.14285714285714285,False,False
DaveChild,18,17,35,35,0,Strong community,0,1.0,0.0,False,False
DonkeyDoug28,19,12,31,30,0,Strong community,1,0.967741935483871,0.03225806451612903,False,False
Electronic-Chest7630,4,2,6,6,0,Strong community,0,1.0,0.0,False,False
ExtremeAd7729,8,4,12,11,0,Strong community,1,0.9166666666666666,0.08333333333333333,False,False
Forsaken-House8685,62,22,84,90,0,Strong community,6,1.0714285714285714,0.07142857142857142,True,False
Freedom_Crim,10,6,16,16,0,Strong community,0,1.0,0.0,False,False
GamemasterJeff,7,5,12,12,0,Strong community,0,1.0,0.0,False,False
Gatonom,39,28,67,63,0,Strong community,4,0.9402985074626866,0.05970149253731343,True,False
Greedy-Win-4880,9,8,17,1,10,Weak community,16,0.058823529411764705,0.9411764705882353,False,True
Gurpila9987,19,12,31,13,2,Strong community,18,0.41935483870967744,0.5806451612903226,False,True
Horselady234,21,16,37,38,0,Strong community,1,1.027027027027027,0.02702702702702703,False,False
IslandSoft6212,19,10,29,31,0,Strong community,2,1.0689655172413792,0.06896551724137931,False,False
JohnLockeNJ,6,3,9,10,0,Strong community,1,1.1111111111111112,0.1111111111111111,False,False
JosephJohnPEEPS,28,11,39,38,0,Strong community,1,0.9743589743589743,0.02564102564102564,False,False
Jumpy_Childhood7548,16,2,18,18,0,Strong community,0,1.0,0.0,False,False
JustAGuyFromGermany,9,3,12,16,0,Strong community,4,1.3333333333333333,0.3333333333333333,False,True
KeySpecialist9139,11,4,15,14,0,Strong community,1,0.9333333333333333,0.06666666666666667,False,False
LivingGhost371,21,5,26,25,0,Strong community,1,0.9615384615384616,0.038461538461538464,False,False
Lumpy-Butterscotch50,57,35,92,97,0,Strong community,5,1.0543478260869565,0.05434782608695652,True,False
MissMenace101,14,24,38,22,2,Strong community,16,0.5789473684210527,0.42105263157894735,False,True
NoVacancyHI,19,9,28,19,0,Strong community,9,0.6785714285714286,0.32142857142857145,False,True
No_Material7583,17,9,26,27,0,Strong community,1,1.0384615384615385,0.038461538461538464,False,False
PassionV0id,12,9,21,22,0,Strong community,1,1.0476190476190477,0.047619047619047616,False,False
PineBNorth85,19,9,28,28,0,Strong community,0,1.0,0.0,False,False
ProbablyANoobYo,11,9,20,22,0,Strong community,2,1.1,0.1,False,False
Rufus_TBarleysheath,16,15,31,29,0,Strong community,2,0.9354838709677419,0.06451612903225806,False,False
SWnerd92,15,10,25,23,0,Strong community,2,0.92,0.08,False,False
SpecialistBet4656,13,17,30,31,0,Strong community,1,1.0333333333333334,0.03333333333333333,False,False
UnavailableBrain404,11,5,16,15,0,Strong community,1,0.9375,0.0625,False,False
Vegtam1297,81,53,134,149,0,Strong community,15,1.1119402985074627,0.11194029850746269,True,False
VisiblePiercedNipple,8,3,11,4,16,Noisy community,7,0.36363636363636365,0.6363636363636364,False,False
WangSupreme78,12,5,17,19,0,Strong community,2,1.1176470588235294,0.11764705882352941,False,False
Wattabadmon,19,20,39,36,0,Strong community,3,0.9230769230769231,0.07692307692307693,False,False
Wolf_Protagonist,8,7,15,16,0,Strong community,1,1.0666666666666667,0.06666666666666667,False,False
Working-Exam5620,5,4,9,9,0,Strong community,0,1.0,0.0,False,False
YogurtclosetOwn4786,13,5,18,11,2,Strong community,7,0.6111111111111112,0.3888888888888889,False,True
abacuz4,37,26,63,53,0,Strong community,10,0.8412698412698413,0.15873015873015872,False,False
betterworldbuilder,23,20,43,43,0,Strong community,0,1.0,0.0,False,False
cctoot56,8,8,16,16,0,Strong community,0,1.0,0.0,False,False
chemguy216,11,9,20,21,0,Strong community,1,1.05,0.05,False,False
climbstuff32,21,7,28,29,0,Strong community,1,1.0357142857142858,0.03571428571428571,False,False
comment_i_had_to,19,5,24,23,0,Strong community,1,0.9583333333333334,0.041666666666666664,False,False
cuteman,12,10,22,21,0,Strong community,1,0.9545454545454546,0.045454545454545456,False,False
decrpt,30,26,56,57,0,Strong community,1,1.0178571428571428,0.017857142857142856,False,False
diamondmx,13,12,25,24,0,Strong community,1,0.96,0.04,False,False
discourse_friendly,78,56,134,111,2,Strong community,23,0.8283582089552238,0.17164179104477612,True,False
dontgiveahamyamclam,8,7,15,16,0,Strong community,1,1.0666666666666667,0.06666666666666667,False,False
eggynack,78,48,126,142,0,Strong community,16,1.126984126984127,0.12698412698412698,True,False
jeffwhaley06,28,25,53,50,0,Strong community,3,0.9433962264150944,0.05660377358490566,False,False
nauticalsandwich,40,24,64,64,0,Strong community,0,1.0,0.0,True,False
neotericnewt,21,15,36,34,0,Strong community,2,0.9444444444444444,0.05555555555555555,False,False
oremfrien,24,21,45,46,0,Strong community,1,1.0222222222222221,0.022222222222222223,False,False
rndljfry,17,13,30,23,0,Strong community,7,0.7666666666666667,0.23333333333333334,False,True
theroha,24,13,37,28,0,Strong community,9,0.7567567567567568,0.24324324324324326,False,True
thinsoldier,25,12,37,39,0,Strong community,2,1.054054054054054,0.05405405405405406,False,False
vf-guy,9,3,12,14,0,Strong community,2,1.1666666666666667,0.16666666666666666,False,False
xinorez1,11,11,22,21,0,Strong community,1,0.9545454545454546,0.045454545454545456,False,False
Agitated-Ad6744,2,6,8,11,2,Strong community,3,1.375,0.375,False,True
Hapankaali,20,13,33,34,2,Strong community,1,1.0303030303030303,0.030303030303030304,False,False
RKU69,25,24,49,46,2,Strong community,3,0.9387755102040817,0.061224489795918366,False,False
Agitated-Annual-3527,4,26,30,33,1,Strong community,3,1.1,0.1,False,False
Craig1974,4,3,7,9,1,Strong community,2,1.2857142857142858,0.2857142857142857,False,False
Creampied__Cadaver,10,2,12,14,1,Strong community,2,1.1666666666666667,0.16666666666666666,False,False
DiarrheaJoe1984,5,2,7,10,1,Strong community,3,1.4285714285714286,0.42857142857142855,False,True
InfidelZombie,24,14,38,19,1,Strong community,19,0.5,0.5,False,True
MinivanPops,15,9,24,21,1,Strong community,3,0.875,0.125,False,False
MrRoryBreaker_98,9,4,13,11,1,Strong community,2,0.8461538461538461,0.15384615384615385,False,False
Nojopar,18,16,34,30,0,Strong community,4,0.8823529411764706,0.11764705882352941,False,False
Ok_Ruin4016,20,12,32,17,1,Strong community,15,0.53125,0.46875,False,True
OldBanjoFrog,25,7,32,29,1,Strong community,3,0.90625,0.09375,False,False
Prestigious_Fella_21,3,5,8,9,1,Strong community,1,1.125,0.125,False,False
Single_Temporary8762,4,8,12,9,1,Strong community,3,0.75,0.25,False,True
SlartibartfastMcGee,7,3,10,10,1,Strong community,0,1.0,0.0,False,False
WindBehindTheStars,16,9,25,28,1,Strong community,3,1.12,0.12,False,False
fasterthanfood,14,11,25,19,1,Strong community,6,0.76,0.24,False,True
ltsmash1200,26,10,36,31,1,Strong community,5,0.8611111111111112,0.1388888888888889,False,False
mrsunshine1,9,4,13,14,1,Strong community,1,1.0769230769230769,0.07692307692307693,False,False
notadruggie31,29,25,54,57,1,Strong community,3,1.0555555555555556,0.05555555555555555,True,False
pinniped90,25,10,35,39,1,Strong community,4,1.1142857142857143,0.11428571428571428,True,False
stringbeagle,22,7,29,6,19,Noisy community,23,0.20689655172413793,0.7931034482758621,False,False
Agouramemnon,4,18,22,21,1,Strong community,1,0.9545454545454546,0.045454545454545456,False,False
AnotherUN91,11,5,16,15,1,Strong community,1,0.9375,0.0625,False,False
Bruce-7892,24,25,49,48,1,Strong community,1,0.9795918367346939,0.02040816326530612,True,False
Coolthat6,14,47,61,57,0,Strong community,4,0.9344262295081968,0.06557377049180328,False,False
CrossXFir3,16,10,26,24,1,Strong community,2,0.9230769230769231,0.07692307692307693,False,False
DRamos11,12,6,18,19,1,Strong community,1,1.0555555555555556,0.05555555555555555,False,False
Opposite-Hat-4747,13,6,19,19,0,Strong community,0,1.0,0.0,False,False
TheGrumpyBear04,33,12,45,49,1,Strong community,4,1.0888888888888888,0.08888888888888889,True,False
TheUnderCrab,15,10,25,24,0,Strong community,1,0.96,0.04,False,False
Thin_Vermicelli_1875,16,8,24,18,1,Strong community,6,0.75,0.25,False,True
UnofficialMipha,10,5,15,12,1,Strong community,3,0.8,0.2,False,False
Weary-Technician5861,17,16,33,24,0,Strong community,9,0.7272727272727273,0.2727272727272727,False,True
Xeadriel,6,1,7,7,1,Strong community,0,1.0,0.0,False,False
donuttrackme,19,14,33,37,1,Strong community,4,1.121212121212121,0.12121212121212122,True,False
Agreeable_Car5114,11,17,28,18,1,Strong community,10,0.6428571428571429,0.35714285714285715,False,True
Baron-Von-Mothman,5,2,7,8,1,Strong community,1,1.1428571428571428,0.14285714285714285,False,False
FlameStaag,38,8,46,47,1,Strong community,1,1.0217391304347827,0.021739130434782608,True,False
JidderS2,9,5,14,13,1,Strong community,1,0.9285714285714286,0.07142857142857142,False,False
Lower-Insect-3984,7,36,43,43,1,Strong community,0,1.0,0.0,False,False
OutisRising,6,3,9,11,1,Strong community,2,1.2222222222222223,0.2222222222222222,False,False
RazgrizInfinity,3,2,5,6,1,Strong community,1,1.2,0.2,False,False
Redacted_dact,12,1,13,14,1,Strong community,1,1.0769230769230769,0.07692307692307693,False,False
Valkrhae,8,5,13,9,3,Strong community,4,0.6923076923076923,0.3076923076923077,False,True
nykirnsu,10,10,20,14,1,Strong community,6,0.7,0.3,False,True
sonicpieman,4,2,6,7,1,Strong community,1,1.1666666666666667,0.16666666666666666,False,False
thelingeringlead,12,11,23,15,0,Strong community,8,0.6521739130434783,0.34782608695652173,False,True
AintASaintLouis,10,20,30,39,0,Strong community,9,1.3,0.3,False,True
Cultist_O,15,12,27,28,0,Strong community,1,1.037037037037037,0.037037037037037035,False,False
Demi4TheDrama,6,27,33,31,0,Strong community,2,0.9393939393939394,0.06060606060606061,False,False
EdenSire0,12,5,17,17,0,Strong community,0,1.0,0.0,False,False
NeoConzz,5,45,50,54,0,Strong community,4,1.08,0.08,False,False
PaxNova,29,15,44,45,0,Strong community,1,1.0227272727272727,0.022727272727272728,False,False
PepperJack0526,7,4,11,12,0,Strong community,1,1.0909090909090908,0.09090909090909091,False,False
dejamintwo,23,45,68,73,0,Strong community,5,1.0735294117647058,0.07352941176470588,True,False
delimeats_9678,16,13,29,28,0,Strong community,1,0.9655172413793104,0.034482758620689655,False,False
le_fez,19,6,25,26,0,Strong community,1,1.04,0.04,False,False
AlexJRod,1,60,61,42,1,Strong community,19,0.6885245901639344,0.3114754098360656,False,True
7h4tguy,19,6,25,22,1,Strong community,3,0.88,0.12,False,False
ANewBeginningNow,19,2,21,12,2,Strong community,9,0.5714285714285714,0.42857142857142855,False,True
BartholomewVonTurds,12,9,21,19,1,Strong community,2,0.9047619047619048,0.09523809523809523,False,False
Bex1218,7,3,10,10,1,Strong community,0,1.0,0.0,False,False
BillyJayJersey505,10,3,13,11,1,Strong community,2,0.8461538461538461,0.15384615384615385,False,False
Cold-Fox9854,5,1,6,6,1,Strong community,0,1.0,0.0,False,False
Comprehensive-Menu44,9,5,14,12,1,Strong community,2,0.8571428571428571,0.14285714285714285,False,False
Decent_Flow140,8,6,14,10,1,Strong community,4,0.7142857142857143,0.2857142857142857,False,True
DizzyAstronaut9410,9,3,12,10,0,Strong community,2,0.8333333333333334,0.16666666666666666,False,False
DogsOnMyCouches,11,4,15,3,27,Noisy community,12,0.2,0.8,False,False
DrCrazyFishMan1,5,3,8,5,28,Noisy community,3,0.625,0.375,False,False
Exciting_Stock2202,9,4,13,8,0,Strong community,5,0.6153846153846154,0.38461538461538464,False,True
Fast-Penta,4,1,5,1,36,Noisy community,4,0.2,0.8,False,False
FrequentAirline1554,10,22,32,27,1,Strong community,5,0.84375,0.15625,False,False
GalaXion24,33,17,50,47,0,Strong community,3,0.94,0.06,False,False
GreyerGrey,20,17,37,5,37,Noisy community,32,0.13513513513513514,0.8648648648648649,False,False
Guardian-Boy,4,3,7,2,28,Noisy community,5,0.2857142857142857,0.7142857142857143,False,False
Gullible_Papaya5505,13,5,18,20,1,Strong community,2,1.1111111111111112,0.1111111111111111,False,False
KendroNumba4,12,6,18,12,1,Strong community,6,0.6666666666666666,0.3333333333333333,False,True
MT_Ancap75,9,5,14,15,1,Strong community,1,1.0714285714285714,0.07142857142857142,False,False
Many-Cartographer278,7,1,8,8,1,Strong community,0,1.0,0.0,False,False
Mortwight,1,2,3,5,1,Strong community,2,1.6666666666666667,0.6666666666666666,False,False
NefariousnessBig9037,12,5,17,16,1,Strong community,1,0.9411764705882353,0.058823529411764705,False,False
Nice_Put4300,7,4,11,11,1,Strong community,0,1.0,0.0,False,False
No-Stretch-9230,7,3,10,11,1,Strong community,1,1.1,0.1,False,False
Ok_Possession_6457,21,5,26,27,1,Strong community,1,1.0384615384615385,0.038461538461538464,False,False
PaleBoomer,3,2,5,6,1,Strong community,1,1.2,0.2,False,False
PomPomMom93,11,6,17,16,1,Strong community,1,0.9411764705882353,0.058823529411764705,False,False
Racing_Fox,6,4,10,10,1,Strong community,0,1.0,0.0,False,False
Redwings1927,7,3,10,2,17,Noisy community,8,0.2,0.8,False,False
RepulsiveCockroach7,3,1,4,2,48,Noisy community,2,0.5,0.5,False,False
ScoobyDone,9,4,13,13,1,Strong community,0,1.0,0.0,False,False
Stinky_Toes12,5,1,6,6,1,Strong community,0,1.0,0.0,False,False
Temporary-Comfort307,6,5,11,9,1,Strong community,2,0.8181818181818182,0.18181818181818182,False,False
TheBitchenRav,21,21,42,45,0,Strong community,3,1.0714285714285714,0.07142857142857142,False,False
Yota8883,6,3,9,8,1,Strong community,1,0.8888888888888888,0.1111111111111111,False,False
Yuck_Few,16,8,24,23,1,Strong community,1,0.9583333333333334,0.041666666666666664,False,False
Zestyclose-Coyote906,4,2,6,6,1,Strong community,0,1.0,0.0,False,False
broken_soul696,6,4,10,11,1,Strong community,1,1.1,0.1,False,False
glasgowgeg,3,2,5,6,1,Strong community,1,1.2,0.2,False,False
hansislegend,5,3,8,8,6,Weak community,0,1.0,0.0,False,False
jackfaire,21,14,35,29,1,Strong community,6,0.8285714285714286,0.17142857142857143,False,False
jstnpotthoff,10,6,16,14,1,Strong community,2,0.875,0.125,False,False
laylarei_1,5,3,8,9,1,Strong community,1,1.125,0.125,False,False
numbersthen0987431,51,30,81,49,0,Strong community,32,0.6049382716049383,0.3950617283950617,False,True
rolyfuckingdiscopoly,17,7,24,8,1,Strong community,16,0.3333333333333333,0.6666666666666666,False,True
thingstopraise,5,1,6,1,37,Noisy community,5,0.16666666666666666,0.8333333333333334,False,False
tvieno,14,1,15,16,1,Strong community,1,1.0666666666666667,0.06666666666666667,False,False
vorzilla79,19,17,36,32,1,Strong community,4,0.8888888888888888,0.1111111111111111,False,False
AlexZedKawa02,74,259,333,390,0,Strong community,57,1.1711711711711712,0.17117117117117117,True,False
Abaris_Of_Hyperborea,4,3,7,7,0,Strong community,0,1.0,0.0,False,False
Abracadelphon,14,8,22,23,0,Strong community,1,1.0454545454545454,0.045454545454545456,False,False
Aggravating_Lab_1432,29,11,40,38,0,Strong community,2,0.95,0.05,False,False
Aggressive-Story3671,45,28,73,73,0,Strong community,0,1.0,0.0,True,False
Alesus2-0,31,9,40,53,0,Strong community,13,1.325,0.325,False,True
Allenobriann,9,5,14,14,0,Strong community,0,1.0,0.0,False,False
AmbitiousCattle3879,8,5,13,4,29,Noisy community,9,0.3076923076923077,0.6923076923076923,False,False
Appropriate_Cut_3536,5,9,14,12,0,Strong community,2,0.8571428571428571,0.14285714285714285,False,False
Appropriate_Fly_6711,12,1,13,12,0,Strong community,1,0.9230769230769231,0.07692307692307693,False,False
Available_Year_575,9,6,15,16,0,Strong community,1,1.0666666666666667,0.06666666666666667,False,False
AzMoonbeamer,12,4,16,18,0,Strong community,2,1.125,0.125,False,False
Bananaseverywh4r,18,10,28,29,0,Strong community,1,1.0357142857142858,0.03571428571428571,False,False
Bastiat_sea,35,15,50,47,0,Strong community,3,0.94,0.06,False,False
BillionaireBuster93,51,45,96,94,0,Strong community,2,0.9791666666666666,0.020833333333333332,True,False
BlueStarSpecial,10,3,13,12,0,Strong community,1,0.9230769230769231,0.07692307692307693,False,False
Bud_Buffalo,12,5,17,10,3,Strong community,7,0.5882352941176471,0.4117647058823529,False,True
Calaveras-Metal,26,9,35,36,0,Strong community,1,1.0285714285714285,0.02857142857142857,False,False
Cerael,5,3,8,8,0,Strong community,0,1.0,0.0,False,False
Character_Resort72,27,15,42,40,0,Strong community,2,0.9523809523809523,0.047619047619047616,False,False
Cheshire_Khajiit,25,10,35,22,0,Strong community,13,0.6285714285714286,0.37142857142857144,False,True
CleverJames3,8,5,13,13,0,Strong community,0,1.0,0.0,False,False
Competitive_Jello531,31,11,42,46,0,Strong community,4,1.0952380952380953,0.09523809523809523,False,False
Counterboudd,13,5,18,16,0,Strong community,2,0.8888888888888888,0.1111111111111111,False,False
CrazyCoKids,12,43,55,48,0,Strong community,7,0.8727272727272727,0.12727272727272726,False,False
CreativeCraver,7,3,10,10,0,Strong community,0,1.0,0.0,False,False
Credible333,11,5,16,15,0,Strong community,1,0.9375,0.0625,False,False
DBDude,56,35,91,61,0,Strong community,30,0.6703296703296703,0.32967032967032966,False,True
DJ_HouseShoes,23,3,26,16,1,Strong community,10,0.6153846153846154,0.38461538461538464,False,True
Dependent-Mode-3119,22,17,39,39,0,Strong community,0,1.0,0.0,False,False
Destroyer_2_2,28,19,47,49,0,Strong community,2,1.0425531914893618,0.0425531914893617,False,False
Doc_ET,26,13,39,41,0,Strong community,2,1.0512820512820513,0.05128205128205128,False,False
DrawPitiful6103,15,5,20,25,0,Strong community,5,1.25,0.25,False,True
Dregride,15,13,28,21,0,Strong community,7,0.75,0.25,False,True
DuhChappers,5,8,13,12,0,Strong community,1,0.9230769230769231,0.07692307692307693,False,False
Dunadan734,16,7,23,24,0,Strong community,1,1.0434782608695652,0.043478260869565216,False,False
ElOsoPeresozo,14,10,24,24,0,Strong community,0,1.0,0.0,False,False
ElephantLife8552,4,7,11,4,20,Noisy community,7,0.36363636363636365,0.6363636363636364,False,False
ElysiX,28,16,44,47,0,Strong community,3,1.0681818181818181,0.06818181818181818,False,False
Expert-Diver7144,43,35,78,81,0,Strong community,3,1.0384615384615385,0.038461538461538464,True,False
FairDinkumMate,8,84,92,83,0,Strong community,9,0.9021739130434783,0.09782608695652174,False,False
Finklesfudge,26,12,38,37,0,Strong community,1,0.9736842105263158,0.02631578947368421,False,False
Fit-Order-9468,41,27,68,76,0,Strong community,8,1.1176470588235294,0.11764705882352941,True,False
FlanneryODostoevsky,42,81,123,127,0,Strong community,4,1.032520325203252,0.032520325203252036,True,False
FluffyB12,30,38,68,72,0,Strong community,4,1.0588235294117647,0.058823529411764705,True,False
Former_Function529,43,20,63,66,0,Strong community,3,1.0476190476190477,0.047619047619047616,True,False
Foxhound97_,17,9,26,29,0,Strong community,3,1.1153846153846154,0.11538461538461539,False,False
French_Breakfast_200,4,3,7,6,1,Strong community,1,0.8571428571428571,0.14285714285714285,False,False
FrontAd9873,7,7,14,9,1,Strong community,5,0.6428571428571429,0.35714285714285715,False,True
Funny-Attempt3260,11,4,15,12,0,Strong community,3,0.8,0.2,False,False
Galious,13,7,20,23,0,Strong community,3,1.15,0.15,False,False
GasPsychological5997,10,4,14,15,0,Strong community,1,1.0714285714285714,0.07142857142857142,False,False
Grand-Expression-783,25,3,28,37,0,Strong community,9,1.3214285714285714,0.32142857142857145,False,True
Green__lightning,58,19,77,84,0,Strong community,7,1.0909090909090908,0.09090909090909091,True,False
HogCrankrr,5,3,8,8,0,Strong community,0,1.0,0.0,False,False
HoldFastO2,23,20,43,33,0,Strong community,10,0.7674418604651163,0.23255813953488372,False,True
Hothera,18,12,30,35,0,Strong community,5,1.1666666666666667,0.16666666666666666,False,False
Ill-Description3096,43,25,68,32,2,Strong community,36,0.47058823529411764,0.5294117647058824,False,True
Illustrious_Comb5993,20,5,25,28,0,Strong community,3,1.12,0.12,False,False
Impossible-anarchy,29,15,44,52,0,Strong community,8,1.1818181818181819,0.18181818181818182,False,False
Impressive-Reading15,17,13,30,28,0,Strong community,2,0.9333333333333333,0.06666666666666667,False,False
IndependenceIcy9626,18,12,30,28,0,Strong community,2,0.9333333333333333,0.06666666666666667,False,False
Ionrememberaskn,21,10,31,33,0,Strong community,2,1.064516129032258,0.06451612903225806,False,False
JDMultralight,18,10,28,28,0,Strong community,0,1.0,0.0,False,False
Johnnadawearsglasses,29,7,36,37,0,Strong community,1,1.0277777777777777,0.027777777777777776,False,False
Josvan135,65,20,85,91,0,Strong community,6,1.0705882352941176,0.07058823529411765,True,False
KJongsDongUnYourFace,11,6,17,16,0,Strong community,1,0.9411764705882353,0.058823529411764705,False,False
KindaQuite,8,5,13,12,0,Strong community,1,0.9230769230769231,0.07692307692307693,False,False
Knave7575,15,3,18,19,0,Strong community,1,1.0555555555555556,0.05555555555555555,False,False
Known_Safety_7145,8,5,13,15,0,Strong community,2,1.1538461538461537,0.15384615384615385,False,False
LanaDelHeeey,29,17,46,37,0,Strong community,9,0.8043478260869565,0.1956521739130435,False,False
Loki1001,16,10,26,26,0,Strong community,0,1.0,0.0,False,False
LordJesterTheFree,9,7,16,13,0,Strong community,3,0.8125,0.1875,False,False
Low-Company-6450,9,6,15,16,0,Strong community,1,1.0666666666666667,0.06666666666666667,False,False
LowHelicopter7180,20,32,52,57,0,Strong community,5,1.0961538461538463,0.09615384615384616,False,False
ManufacturerSea7907,15,12,27,24,0,Strong community,3,0.8888888888888888,0.1111111111111111,False,False
Mental-Cupcake9750,16,4,20,20,0,Strong community,0,1.0,0.0,False,False
Miriam_A_Higgins,8,15,23,25,0,Strong community,2,1.0869565217391304,0.08695652173913043,False,False
Mrs_Crii,43,24,67,63,0,Strong community,4,0.9402985074626866,0.05970149253731343,True,False
NOLA-Bronco,14,7,21,23,0,Strong community,2,1.0952380952380953,0.09523809523809523,False,False
Natural-Arugula,28,12,40,42,0,Strong community,2,1.05,0.05,False,False
NewRefrigerator7461,12,5,17,17,0,Strong community,0,1.0,0.0,False,False
No_Radio5740,19,8,27,29,0,Strong community,2,1.0740740740740742,0.07407407407407407,False,False
Noob_Al3rt,41,29,70,66,0,Strong community,4,0.9428571428571428,0.05714285714285714,True,False
OrizaRayne,5,3,8,11,0,Strong community,3,1.375,0.375,False,True
Parzival_1775,27,30,57,64,0,Strong community,7,1.1228070175438596,0.12280701754385964,True,False
Plastic-Abroc67a8282,27,27,54,68,0,Strong community,14,1.2592592592592593,0.25925925925925924,False,True
PlasticMechanic3869,15,12,27,25,0,Strong community,2,0.9259259259259259,0.07407407407407407,False,False
Polyodontus,37,34,71,49,2,Strong community,22,0.6901408450704225,0.30985915492957744,False,True
Popular_Kangaroo5446,9,6,15,16,0,Strong community,1,1.0666666666666667,0.06666666666666667,False,False
PreviousCurrentThing,44,34,78,60,0,Strong community,18,0.7692307692307693,0.23076923076923078,False,True
Puzzleheaded_Ant3378,6,2,8,2,4,Strong community,6,0.25,0.75,False,True
Quankers,13,6,19,16,0,Strong community,3,0.8421052631578947,0.15789473684210525,False,False
RadioSlayer,7,7,14,16,0,Strong community,2,1.1428571428571428,0.14285714285714285,False,False
Rhomya,9,7,16,11,0,Strong community,5,0.6875,0.3125,False,True
Salanmander,9,5,14,18,0,Strong community,4,1.2857142857142858,0.2857142857142857,False,True
Smart-Status2608,14,11,25,24,0,Strong community,1,0.96,0.04,False,False
Solondthewookiee,25,16,41,40,0,Strong community,1,0.975609756097561,0.024390243902439025,False,False
StandardLocal3929,12,7,19,22,0,Strong community,3,1.1578947368421053,0.15789473684210525,False,False
SuccessValuable6924,7,5,12,12,0,Strong community,0,1.0,0.0,False,False
Sulfamide,7,9,16,15,0,Strong community,1,0.9375,0.0625,False,False
TetraThiaFulvalene,8,9,17,15,0,Strong community,2,0.8823529411764706,0.11764705882352941,False,False
TheMan5991,17,9,26,25,0,Strong community,1,0.9615384615384616,0.038461538461538464,False,False
ThirteenOnline,18,8,26,31,0,Strong community,5,1.1923076923076923,0.19230769230769232,False,False
TipResident4373,9,5,14,15,0,Strong community,1,1.0714285714285714,0.07142857142857142,False,False
TopDownRiskBased,4,4,8,2,58,Noisy community,6,0.25,0.75,False,False
TraditionalSpirit636,12,18,30,30,0,Strong community,0,1.0,0.0,False,False
TrumpetDuster,20,29,49,60,0,Strong community,11,1.2244897959183674,0.22448979591836735,False,True
Tweez07,15,5,20,21,0,Strong community,1,1.05,0.05,False,False
UselessprojectsRUS,18,13,31,31,0,Strong community,0,1.0,0.0,False,False
What_the_8,27,12,39,43,0,Strong community,4,1.1025641025641026,0.10256410256410256,False,False
X-calibreX,9,5,14,15,0,Strong community,1,1.0714285714285714,0.07142857142857142,False,False
Xer0day,9,5,14,14,0,Strong community,0,1.0,0.0,False,False
Yesyesnaaooo,8,3,11,11,0,Strong community,0,1.0,0.0,False,False
ZorgZeFrenchGuy,23,12,35,35,0,Strong community,0,1.0,0.0,False,False
_ParadigmShift,13,12,25,28,0,Strong community,3,1.12,0.12,False,False
annabananaberry,14,12,26,26,0,Strong community,0,1.0,0.0,False,False
aqulushly,4,2,6,8,0,Strong community,2,1.3333333333333333,0.3333333333333333,False,False
bgaesop,18,17,35,36,0,Strong community,1,1.0285714285714285,0.02857142857142857,False,False
bluepillarmy,78,279,357,377,0,Strong community,20,1.0560224089635855,0.056022408963585436,True,False
cat_of_danzig,28,21,49,40,0,Strong community,9,0.8163265306122449,0.1836734693877551,False,False
dave-t-2002,13,7,20,21,0,Strong community,1,1.05,0.05,False,False
dr_eh,11,3,14,14,0,Strong community,0,1.0,0.0,False,False
eggs-benedryl,12,8,20,24,0,Strong community,4,1.2,0.2,False,False
everydaywinner2,33,19,52,54,0,Strong community,2,1.0384615384615385,0.038461538461538464,False,False
ffxivthrowaway03,18,16,34,34,0,Strong community,0,1.0,0.0,False,False
funglegunk,13,10,23,24,0,Strong community,1,1.0434782608695652,0.043478260869565216,False,False
glopthrowawayaccount,24,19,43,45,0,Strong community,2,1.0465116279069768,0.046511627906976744,False,False
hi_imjoey,12,6,18,20,0,Strong community,2,1.1111111111111112,0.1111111111111111,False,False
hillswalker87,26,18,44,43,0,Strong community,1,0.9772727272727273,0.022727272727272728,False,False
horshack_test,20,12,32,38,0,Strong community,6,1.1875,0.1875,False,False
ihatepasswords1234,22,17,39,41,0,Strong community,2,1.0512820512820513,0.05128205128205128,False,False
irespectwomenlol,17,3,20,21,0,Strong community,1,1.05,0.05,False,False
jadnich,21,12,33,22,0,Strong community,11,0.6666666666666666,0.3333333333333333,False,True
kangorooz99,30,26,56,52,0,Strong community,4,0.9285714285714286,0.07142857142857142,False,False
lakotajames,9,6,15,12,0,Strong community,3,0.8,0.2,False,False
lotharingian-lemur,9,7,16,15,0,Strong community,1,0.9375,0.0625,False,False
mishaxz,50,28,78,77,0,Strong community,1,0.9871794871794872,0.01282051282051282,True,False
ncolaros,18,10,28,27,0,Strong community,1,0.9642857142857143,0.03571428571428571,False,False
nefarious_planet,9,7,16,8,3,Strong community,8,0.5,0.5,False,True
olidus,17,14,31,31,0,Strong community,0,1.0,0.0,False,False
omrixs,12,9,21,26,0,Strong community,5,1.2380952380952381,0.23809523809523808,False,True
other_view12,19,7,26,23,0,Strong community,3,0.8846153846153846,0.11538461538461539,False,False
pumpkinspeedwagon86,25,42,67,79,0,Strong community,12,1.1791044776119404,0.1791044776119403,True,False
reddituserperson1122,38,37,75,66,0,Strong community,9,0.88,0.12,True,False
rhiao,29,53,82,94,0,Strong community,12,1.146341463414634,0.14634146341463414,True,False
skate1243,15,7,22,12,1,Strong community,10,0.5454545454545454,0.45454545454545453,False,True
southernfirm,5,2,7,6,0,Strong community,1,0.8571428571428571,0.14285714285714285,False,False
theAltRightCornholio,21,13,34,20,2,Strong community,14,0.5882352941176471,0.4117647058823529,False,True
thefrozenflame21,33,10,43,43,0,Strong community,0,1.0,0.0,False,False
toodledootootootoo,6,6,12,12,0,Strong community,0,1.0,0.0,False,False
traanquil,10,3,13,15,0,Strong community,2,1.1538461538461537,0.15384615384615385,False,False
urquhartloch,40,16,56,59,0,Strong community,3,1.0535714285714286,0.05357142857142857,False,False
way2lazy2care,25,14,39,23,0,Strong community,16,0.5897435897435898,0.41025641025641024,False,True
xboxhaxorz,33,11,44,43,0,Strong community,1,0.9772727272727273,0.022727272727272728,False,False
xraysteve185,6,4,10,4,20,Noisy community,6,0.4,0.6,False,False
ygmc8413,15,13,28,28,0,Strong community,0,1.0,0.0,False,False
youwillbechallenged,30,15,45,37,0,Strong community,8,0.8222222222222222,0.17777777777777778,False,False
zstock003,9,7,16,17,0,Strong community,1,1.0625,0.0625,False,False
Alex_Danko,15,144,159,155,0,Strong community,4,0.9748427672955975,0.025157232704402517,True,False
---AI---,8,6,14,12,0,Strong community,2,0.8571428571428571,0.14285714285714285,False,False
Acceptable-Remove792,8,3,11,10,0,Strong community,1,0.9090909090909091,0.09090909090909091,False,False
AdministrativeSet419,10,1,11,9,0,Strong community,2,0.8181818181818182,0.18181818181818182,False,False
Antique-Ad-9081,18,12,30,28,0,Strong community,2,0.9333333333333333,0.06666666666666667,False,False
Apathetic_Villainess,3,3,6,7,0,Strong community,1,1.1666666666666667,0.16666666666666666,False,False
Apprehensive_Run238,5,3,8,4,49,Noisy community,4,0.5,0.5,False,False
Apprehensive_Set_105,9,4,13,13,0,Strong community,0,1.0,0.0,False,False
ArguteTrickster,7,6,13,11,0,Strong community,2,0.8461538461538461,0.15384615384615385,False,False
Automatic_Tackle_406,19,17,36,33,0,Strong community,3,0.9166666666666666,0.08333333333333333,False,False
Background-Major-567,6,5,11,11,0,Strong community,0,1.0,0.0,False,False
BaguetteFetish,14,87,101,97,0,Strong community,4,0.9603960396039604,0.039603960396039604,True,False
Biffs_bunny,16,12,28,26,0,Strong community,2,0.9285714285714286,0.07142857142857142,False,False
BigMax,22,9,31,28,0,Strong community,3,0.9032258064516129,0.0967741935483871,False,False
Bilabong127,13,6,19,4,30,Noisy community,15,0.21052631578947367,0.7894736842105263,False,False
Brilliant_Trade_9162,9,6,15,16,0,Strong community,1,1.0666666666666667,0.06666666666666667,False,False
Charlie4s,8,4,12,11,0,Strong community,1,0.9166666666666666,0.08333333333333333,False,False
Commercial-Print-,16,8,24,24,0,Strong community,0,1.0,0.0,False,False
ConstitutionalGato,15,10,25,22,0,Strong community,3,0.88,0.12,False,False
ConsultJimMoriarty,27,22,49,49,0,Strong community,0,1.0,0.0,False,False
DaddyRocka,13,12,25,23,0,Strong community,2,0.92,0.08,False,False
FaithfulPichu,4,5,9,11,0,Strong community,2,1.2222222222222223,0.2222222222222222,False,False
Fichek,10,7,17,17,0,Strong community,0,1.0,0.0,False,False
Foyles_War,7,9,16,16,0,Strong community,0,1.0,0.0,False,False
HellfireXP,10,7,17,16,0,Strong community,1,0.9411764705882353,0.058823529411764705,False,False
IDVDI,20,11,31,31,0,Strong community,0,1.0,0.0,False,False
Ieam_Scribbles,8,7,15,16,0,Strong community,1,1.0666666666666667,0.06666666666666667,False,False
InfamousDeer,23,12,35,36,0,Strong community,1,1.0285714285714285,0.02857142857142857,False,False
Infinite_Collar_7610,5,2,7,2,49,Noisy community,5,0.2857142857142857,0.7142857142857143,False,False
JoffreeBaratheon,19,5,24,19,1,Strong community,5,0.7916666666666666,0.20833333333333334,False,False
Kaiisim,27,6,33,36,0,Strong community,3,1.0909090909090908,0.09090909090909091,False,False
Key_Cheetah7982,34,34,68,57,0,Strong community,11,0.8382352941176471,0.16176470588235295,False,False
Kikikididi,6,5,11,9,0,Strong community,2,0.8181818181818182,0.18181818181818182,False,False
Kirstemis,5,2,7,7,0,Strong community,0,1.0,0.0,False,False
LivingLikeACat33,22,16,38,36,0,Strong community,2,0.9473684210526315,0.05263157894736842,False,False
Majestic_Horse_1678,13,4,17,16,0,Strong community,1,0.9411764705882353,0.058823529411764705,False,False
ManufacturerVivid164,39,24,63,67,0,Strong community,4,1.0634920634920635,0.06349206349206349,True,False
Maximumoverdrive76,14,12,26,23,0,Strong community,3,0.8846153846153846,0.11538461538461539,False,False
MeanderingDuck,19,15,34,31,0,Strong community,3,0.9117647058823529,0.08823529411764706,False,False
MeanestGoose,19,5,24,28,0,Strong community,4,1.1666666666666667,0.16666666666666666,False,False
Melodic_Contract8155,6,21,27,32,0,Strong community,5,1.1851851851851851,0.18518518518518517,False,False
MrPoopMonster,10,8,18,17,0,Strong community,1,0.9444444444444444,0.05555555555555555,False,False
Myrvoid,12,6,18,16,0,Strong community,2,0.8888888888888888,0.1111111111111111,False,False
Na7vy,8,15,23,31,0,Strong community,8,1.3478260869565217,0.34782608695652173,False,True
NefariousnessMost660,8,7,15,13,0,Strong community,2,0.8666666666666667,0.13333333333333333,False,False
Nsfwacct1872564,8,8,16,16,0,Strong community,0,1.0,0.0,False,False
Pac_Eddy,6,4,10,1,5,Strong community,9,0.1,0.9,False,True
PassionGlobal,9,5,14,13,0,Strong community,1,0.9285714285714286,0.07142857142857142,False,False
Philstar_nz,20,8,28,28,0,Strong community,0,1.0,0.0,False,False
Plenty_Advance7513,10,9,19,18,0,Strong community,1,0.9473684210526315,0.05263157894736842,False,False
Puzzleheaded_Mix4160,8,6,14,2,49,Noisy community,12,0.14285714285714285,0.8571428571428571,False,False
Rawlott1620,9,8,17,17,0,Strong community,0,1.0,0.0,False,False
Rivercitybruin,33,9,42,30,2,Strong community,12,0.7142857142857143,0.2857142857142857,False,True
Rollingforest757,7,7,14,14,0,Strong community,0,1.0,0.0,False,False
RubyMae4,8,9,17,17,0,Strong community,0,1.0,0.0,False,False
ScoutsHonorHoops,7,1,8,6,2,Strong community,2,0.75,0.25,False,False
SheWhoLovesSilence,15,47,62,72,0,Strong community,10,1.1612903225806452,0.16129032258064516,True,False
Technical-Revenue-48,11,6,17,18,0,Strong community,1,1.0588235294117647,0.058823529411764705,False,False
ToSAhri,22,10,32,37,0,Strong community,5,1.15625,0.15625,False,False
Unitaco90,8,3,11,12,0,Strong community,1,1.0909090909090908,0.09090909090909091,False,False
WakeoftheStorm,19,6,25,25,0,Strong community,0,1.0,0.0,False,False
WarbleDarble,53,50,103,71,2,Strong community,32,0.6893203883495146,0.3106796116504854,False,True
Waste-Menu-1910,15,4,19,17,0,Strong community,2,0.8947368421052632,0.10526315789473684,False,False
alelp,14,9,23,24,0,Strong community,1,1.0434782608695652,0.043478260869565216,False,False
allbusiness512,7,3,10,10,0,Strong community,0,1.0,0.0,False,False
assistantprofessor,12,4,16,14,0,Strong community,2,0.875,0.125,False,False
aythekay,9,6,15,15,0,Strong community,0,1.0,0.0,False,False
bizarre_coincidence,7,4,11,10,0,Strong community,1,0.9090909090909091,0.09090909090909091,False,False
cindad83,25,33,58,56,0,Strong community,2,0.9655172413793104,0.034482758620689655,False,False
cstar1996,34,29,63,58,0,Strong community,5,0.9206349206349206,0.07936507936507936,False,False
dbandroid,9,5,14,14,0,Strong community,0,1.0,0.0,False,False
energirl,25,21,46,46,0,Strong community,0,1.0,0.0,False,False
eternally_insomnia,23,11,34,28,0,Strong community,6,0.8235294117647058,0.17647058823529413,False,False
ferdaw95,9,4,13,11,0,Strong community,2,0.8461538461538461,0.15384615384615385,False,False
freezeemup,4,1,5,5,0,Strong community,0,1.0,0.0,False,False
jimmyxtang,4,3,7,7,0,Strong community,0,1.0,0.0,False,False
jinjuwaka,12,13,25,22,0,Strong community,3,0.88,0.12,False,False
joittine,33,21,54,55,0,Strong community,1,1.0185185185185186,0.018518518518518517,False,False
jrssister,10,4,14,15,0,Strong community,1,1.0714285714285714,0.07142857142857142,False,False
knightbane007,16,11,27,28,0,Strong community,1,1.037037037037037,0.037037037037037035,False,False
koolaid-girl-40,29,6,35,36,0,Strong community,1,1.0285714285714285,0.02857142857142857,False,False
lee1026,50,33,83,79,0,Strong community,4,0.9518072289156626,0.04819277108433735,True,False
mallardramp,12,8,20,21,0,Strong community,1,1.05,0.05,False,False
marcelsmudda,6,2,8,7,0,Strong community,1,0.875,0.125,False,False
myfirstnamesdanger,12,8,20,13,0,Strong community,7,0.65,0.35,False,True
myrd13,4,5,9,9,0,Strong community,0,1.0,0.0,False,False
natelion445,9,7,16,19,0,Strong community,3,1.1875,0.1875,False,False
punta_del_diablo,7,3,10,10,0,Strong community,0,1.0,0.0,False,False
real-bebsi,7,7,14,11,0,Strong community,3,0.7857142857142857,0.21428571428571427,False,False
rnason,25,15,40,34,0,Strong community,6,0.85,0.15,False,False
serene_brutality,19,2,21,18,0,Strong community,3,0.8571428571428571,0.14285714285714285,False,False
silverionmox,41,45,86,75,0,Strong community,11,0.872093023255814,0.12790697674418605,True,False
spiteful-vengeance,17,13,30,25,0,Strong community,5,0.8333333333333334,0.16666666666666666,False,False
stoneimp,17,9,26,17,0,Strong community,9,0.6538461538461539,0.34615384615384615,False,True
teenageIbibioboy,7,4,11,11,0,Strong community,0,1.0,0.0,False,False
the_brightest_prize,26,12,38,37,0,Strong community,1,0.9736842105263158,0.02631578947368421,False,False
vote4bort,39,17,56,59,0,Strong community,3,1.0535714285714286,0.05357142857142857,False,False
AlexandrTheTolerable,23,49,72,85,2,Strong community,13,1.1805555555555556,0.18055555555555555,True,False
Alive_Shoulder3573,17,15,32,30,2,Strong community,2,0.9375,0.0625,False,False
Ana_Na_Moose,17,11,28,29,2,Strong community,1,1.0357142857142858,0.03571428571428571,False,False
AnotherHumanObserver,16,4,20,21,2,Strong community,1,1.05,0.05,False,False
BRAINSPLATTER16,4,4,8,8,2,Strong community,0,1.0,0.0,False,False
Delta-9-,21,17,38,37,2,Strong community,1,0.9736842105263158,0.02631578947368421,False,False
DisabledToaster1,12,2,14,13,2,Strong community,1,0.9285714285714286,0.07142857142857142,False,False
Edgar_Brown,9,4,13,11,2,Strong community,2,0.8461538461538461,0.15384615384615385,False,False
Fargason,14,15,29,29,2,Strong community,0,1.0,0.0,False,False
FrozenSeas,12,6,18,16,2,Strong community,2,0.8888888888888888,0.1111111111111111,False,False
Hyndis,17,16,33,35,2,Strong community,2,1.0606060606060606,0.06060606060606061,False,False
IniNew,20,15,35,33,2,Strong community,2,0.9428571428571428,0.05714285714285714,False,False
Interrophish,39,51,90,85,2,Strong community,5,0.9444444444444444,0.05555555555555555,True,False
IntrepidAd2478,19,12,31,33,2,Strong community,2,1.064516129032258,0.06451612903225806,False,False
Jen0BIous,6,3,9,10,2,Strong community,1,1.1111111111111112,0.1111111111111111,False,False
ManBearScientist,33,24,57,58,2,Strong community,1,1.0175438596491229,0.017543859649122806,True,False
Moccus,35,36,71,61,2,Strong community,10,0.8591549295774648,0.14084507042253522,True,False
Objective_Aside1858,134,301,435,311,2,Strong community,124,0.7149425287356321,0.2850574712643678,False,True
Sarmq,5,5,10,8,2,Strong community,2,0.8,0.2,False,False
StanDaMan1,9,6,15,16,2,Strong community,1,1.0666666666666667,0.06666666666666667,False,False
Storyteller-Hero,17,5,22,21,2,Strong community,1,0.9545454545454546,0.045454545454545456,False,False
TheMikeyMac13,29,17,46,46,2,Strong community,0,1.0,0.0,False,False
UnfoldedHeart,49,39,88,85,2,Strong community,3,0.9659090909090909,0.03409090909090909,True,False
WhiteWolf3117,11,6,17,15,2,Strong community,2,0.8823529411764706,0.11764705882352941,False,False
XXXCincinnatusXXX,10,6,16,17,2,Strong community,1,1.0625,0.0625,False,False
clios_daughter,4,5,9,2,31,Noisy community,7,0.2222222222222222,0.7777777777777778,False,False
mskmagic,11,7,18,19,2,Strong community,1,1.0555555555555556,0.05555555555555555,False,False
neosituation_unknown,9,0,9,9,2,Strong community,0,1.0,0.0,False,False
phoenix1984,11,5,16,14,2,Strong community,2,0.875,0.125,False,False
punninglinguist,20,8,28,20,2,Strong community,8,0.7142857142857143,0.2857142857142857,False,True
serious_sarcasm,7,11,18,20,2,Strong community,2,1.1111111111111112,0.1111111111111111,False,False
skyfishgoo,15,5,20,20,2,Strong community,0,1.0,0.0,False,False
sllewgh,36,25,61,36,2,Strong community,25,0.5901639344262295,0.4098360655737705,False,True
sunfishtommy,15,13,28,28,2,Strong community,0,1.0,0.0,False,False
theyfellforthedecoy,24,19,43,45,2,Strong community,2,1.0465116279069768,0.046511627906976744,False,False
wheres_my_hat,8,5,13,12,2,Strong community,1,0.9230769230769231,0.07692307692307693,False,False
zayelion,18,5,23,17,2,Strong community,6,0.7391304347826086,0.2608695652173913,False,True
AlpineSuccess-Edu,20,120,140,131,0,Strong community,9,0.9357142857142857,0.06428571428571428,True,False
AdHopeful3801,29,9,38,43,0,Strong community,5,1.131578947368421,0.13157894736842105,False,False
Apprehensive-Let3348,30,14,44,43,0,Strong community,1,0.9772727272727273,0.022727272727272728,False,False
BigDaddyDumperSquad,9,5,14,12,0,Strong community,2,0.8571428571428571,0.14285714285714285,False,False
Browler_321,10,7,17,19,0,Strong community,2,1.1176470588235294,0.11764705882352941,False,False
Chocolat3City,9,38,47,53,0,Strong community,6,1.127659574468085,0.1276595744680851,False,False
Clever-username-7234,12,5,17,19,0,Strong community,2,1.1176470588235294,0.11764705882352941,False,False
CosmicLovepats,17,6,23,27,0,Strong community,4,1.173913043478261,0.17391304347826086,False,False
DTF_Truck,7,4,11,3,4,Strong community,8,0.2727272727272727,0.7272727272727273,False,True
DrRealName,14,4,18,19,0,Strong community,1,1.0555555555555556,0.05555555555555555,False,False
DuetWithMe99,13,15,28,35,0,Strong community,7,1.25,0.25,False,True
DungeonJailer,19,10,29,33,0,Strong community,4,1.1379310344827587,0.13793103448275862,False,False
FnakeFnack,10,6,16,18,0,Strong community,2,1.125,0.125,False,False
FockerXC,10,6,16,15,0,Strong community,1,0.9375,0.0625,False,False
Front-Finish187,13,9,22,17,0,Strong community,5,0.7727272727272727,0.22727272727272727,False,True
HombreDeMoleculos,6,5,11,9,0,Strong community,2,0.8181818181818182,0.18181818181818182,False,False
Jake0024,38,21,59,39,0,Strong community,20,0.6610169491525424,0.3389830508474576,False,True
KlausVonChiliPowder,15,6,21,20,0,Strong community,1,0.9523809523809523,0.047619047619047616,False,False
Korimito,12,7,19,21,0,Strong community,2,1.105263157894737,0.10526315789473684,False,False
LIONS_old_logo,6,5,11,13,0,Strong community,2,1.1818181818181819,0.18181818181818182,False,False
Leon_Thomas,12,6,18,17,0,Strong community,1,0.9444444444444444,0.05555555555555555,False,False
Lethkhar,22,12,34,32,0,Strong community,2,0.9411764705882353,0.058823529411764705,False,False
LowNoise9831,14,8,22,20,0,Strong community,2,0.9090909090909091,0.09090909090909091,False,False
NittanyOrange,10,4,14,14,0,Strong community,0,1.0,0.0,False,False
Odd-Fly-1265,6,6,12,11,0,Strong community,1,0.9166666666666666,0.08333333333333333,False,False
Ok_Cap9557,14,6,20,21,0,Strong community,1,1.05,0.05,False,False
Ok_Soft_4575,10,6,16,18,0,Strong community,2,1.125,0.125,False,False
Papaofmonsters,16,6,22,23,0,Strong community,1,1.0454545454545454,0.045454545454545456,False,False
Ramguy2014,16,9,25,24,0,Strong community,1,0.96,0.04,False,False
Randomousity,21,20,41,40,0,Strong community,1,0.975609756097561,0.024390243902439025,False,False
ReturnPresent9306,29,18,47,46,0,Strong community,1,0.9787234042553191,0.02127659574468085,False,False
Santa5511,6,3,9,9,0,Strong community,0,1.0,0.0,False,False
Secret-Put-4525,20,5,25,23,0,Strong community,2,0.92,0.08,False,False
SirWillae,17,2,19,25,0,Strong community,6,1.3157894736842106,0.3157894736842105,False,True
Sky-Trash,18,16,34,36,0,Strong community,2,1.0588235294117647,0.058823529411764705,False,False
Spaniardman40,25,8,33,33,0,Strong community,0,1.0,0.0,False,False
Sufficient_Show_7795,9,12,21,21,0,Strong community,0,1.0,0.0,False,False
Supercollider9001,14,8,22,20,0,Strong community,2,0.9090909090909091,0.09090909090909091,False,False
Talik1978,19,9,28,30,0,Strong community,2,1.0714285714285714,0.07142857142857142,False,False
Team503,24,25,49,45,0,Strong community,4,0.9183673469387755,0.08163265306122448,False,False
Tengoatuzui,11,7,18,15,0,Strong community,3,0.8333333333333334,0.16666666666666666,False,False
TheDrakkar12,23,80,103,105,0,Strong community,2,1.0194174757281553,0.019417475728155338,True,False
Total_Literature_809,20,12,32,25,0,Strong community,7,0.78125,0.21875,False,False
Trauma_Hawks,14,8,22,20,0,Strong community,2,0.9090909090909091,0.09090909090909091,False,False
Unexpected_Gristle,9,8,17,15,0,Strong community,2,0.8823529411764706,0.11764705882352941,False,False
Warchief_Ripnugget,20,16,36,35,0,Strong community,1,0.9722222222222222,0.027777777777777776,False,False
YogurtclosetFair5742,14,6,20,14,1,Strong community,6,0.7,0.3,False,True
a_null_set,9,6,15,10,1,Strong community,5,0.6666666666666666,0.3333333333333333,False,True
aurora-s,14,10,24,5,7,Weak community,19,0.20833333333333334,0.7916666666666666,False,True
blyzo,26,18,44,38,0,Strong community,6,0.8636363636363636,0.13636363636363635,False,False
cbf1232,13,11,24,23,0,Strong community,1,0.9583333333333334,0.041666666666666664,False,False
cloudsofdoom,5,6,11,9,0,Strong community,2,0.8181818181818182,0.18181818181818182,False,False
epelle9,7,6,13,8,4,Strong community,5,0.6153846153846154,0.38461538461538464,False,True
evilcherry1114,24,21,45,45,0,Strong community,0,1.0,0.0,False,False
fizzbish,9,8,17,15,0,Strong community,2,0.8823529411764706,0.11764705882352941,False,False
idontknowhow2reddit,24,6,30,30,0,Strong community,0,1.0,0.0,False,False
ladylucifer22,14,6,20,19,0,Strong community,1,0.95,0.05,False,False
moboticus,16,10,26,25,0,Strong community,1,0.9615384615384616,0.038461538461538464,False,False
qchisq,14,5,19,1,25,Noisy community,18,0.05263157894736842,0.9473684210526315,False,False
suitupyo,14,5,19,18,2,Strong community,1,0.9473684210526315,0.05263157894736842,False,False
uberprodude,11,3,14,10,0,Strong community,4,0.7142857142857143,0.2857142857142857,False,True
unordinarilyboring,17,7,24,25,0,Strong community,1,1.0416666666666667,0.041666666666666664,False,False
whyrestwhenicandream,5,3,8,8,0,Strong community,0,1.0,0.0,False,False
wulfgar_beornegar,12,14,26,25,2,Strong community,1,0.9615384615384616,0.038461538461538464,False,False
Jakyland,38,12,50,56,0,Strong community,6,1.12,0.12,False,False
Utapau301,21,14,35,31,0,Strong community,4,0.8857142857142857,0.11428571428571428,False,False
YeOldButchery,23,5,28,29,0,Strong community,1,1.0357142857142858,0.03571428571428571,False,False
ginger_and_egg,22,16,38,30,0,Strong community,8,0.7894736842105263,0.21052631578947367,False,False
sailorbrendan,10,5,15,18,0,Strong community,3,1.2,0.2,False,False
springcabinet,7,4,11,14,0,Strong community,3,1.2727272727272727,0.2727272727272727,False,True
Amaz_the_savage,12,23,35,37,0,Strong community,2,1.0571428571428572,0.05714285714285714,False,False
Budobudo,5,4,9,6,0,Strong community,3,0.6666666666666666,0.3333333333333333,False,True
DiscussTek,12,7,19,18,0,Strong community,1,0.9473684210526315,0.05263157894736842,False,False
FionaLunaris,6,1,7,9,0,Strong community,2,1.2857142857142858,0.2857142857142857,False,False
Sayakai,7,5,12,13,0,Strong community,1,1.0833333333333333,0.08333333333333333,False,False
Stanchthrone482,8,5,13,13,0,Strong community,0,1.0,0.0,False,False
gate18,36,12,48,56,0,Strong community,8,1.1666666666666667,0.16666666666666666,False,False
libra00,19,5,24,27,0,Strong community,3,1.125,0.125,False,False
Ambitious_Carrot3747,3,53,56,39,3,Strong community,17,0.6964285714285714,0.30357142857142855,False,True
Boris-_-Badenov,18,8,26,22,1,Strong community,4,0.8461538461538461,0.15384615384615385,False,False
Bubbly_Chicken_9358,20,3,23,24,3,Strong community,1,1.0434782608695652,0.043478260869565216,False,False
Chaser_Of_The_Abyss,10,2,12,8,1,Strong community,4,0.6666666666666666,0.3333333333333333,False,True
ClaireL58,7,5,12,14,3,Strong community,2,1.1666666666666667,0.16666666666666666,False,False
Crazyandiloveit,6,6,12,13,3,Strong community,1,1.0833333333333333,0.08333333333333333,False,False
Dizzy_Try4939,4,4,8,3,3,Strong community,5,0.375,0.625,False,True
HuntersAngel,7,5,12,10,9,Strong community,2,0.8333333333333334,0.16666666666666666,False,False
Illustrious_Tart_258,6,1,7,4,1,Strong community,3,0.5714285714285714,0.42857142857142855,False,True
K_A_irony,10,2,12,10,3,Strong community,2,0.8333333333333334,0.16666666666666666,False,False
Kami_Sang,21,8,29,32,3,Strong community,3,1.103448275862069,0.10344827586206896,True,False
KrofftSurvivor,7,3,10,11,3,Strong community,1,1.1,0.1,False,False
LazyAd622,26,1,27,31,3,Strong community,4,1.1481481481481481,0.14814814814814814,False,False
Lcdmt3,4,3,7,8,3,Strong community,1,1.1428571428571428,0.14285714285714285,False,False
LisaCabot,6,2,8,8,3,Strong community,0,1.0,0.0,False,False
Ok-Flamingo2801,9,3,12,9,0,Strong community,3,0.75,0.25,False,True
Perdendosi,35,3,38,38,0,Strong community,0,1.0,0.0,False,False
Plus_Ad_9181,27,5,32,30,3,Strong community,2,0.9375,0.0625,False,False
QuestionMaker207,7,5,12,7,9,Strong community,5,0.5833333333333334,0.4166666666666667,False,True
Several-Adeptness-83,4,2,6,6,3,Strong community,0,1.0,0.0,False,False
SigSauerPower320,19,3,22,23,3,Strong community,1,1.0454545454545454,0.045454545454545456,False,False
Spare-Article-396,5,3,8,8,3,Strong community,0,1.0,0.0,False,False
TALKTOME0701,13,6,19,21,3,Strong community,2,1.105263157894737,0.10526315789473684,False,False
TomdeHaan,9,3,12,7,1,Strong community,5,0.5833333333333334,0.4166666666666667,False,True
Unit_08_Pilot,13,7,20,10,1,Strong community,10,0.5,0.5,False,True
anglflw,7,1,8,8,3,Strong community,0,1.0,0.0,False,False
auntlynnie,4,1,5,2,19,Noisy community,3,0.4,0.6,False,False
c0l245,11,4,15,12,0,Strong community,3,0.8,0.2,False,False
cans-of-swine,17,7,24,20,1,Strong community,4,0.8333333333333334,0.16666666666666666,False,False
lammcmahan656,4,1,5,6,3,Strong community,1,1.2,0.2,False,False
lmchatterbox,12,2,14,14,3,Strong community,0,1.0,0.0,False,False
lotteoddities,5,2,7,7,3,Strong community,0,1.0,0.0,False,False
mrtnmnhntr,10,2,12,12,3,Strong community,0,1.0,0.0,False,False
pottersquash,14,7,21,22,3,Strong community,1,1.0476190476190477,0.047619047619047616,False,False
smol9749been,12,6,18,13,3,Strong community,5,0.7222222222222222,0.2777777777777778,False,True
xicor,6,3,9,8,3,Strong community,1,0.8888888888888888,0.1111111111111111,False,False
yeahipostedthat,5,2,7,6,3,Strong community,1,0.8571428571428571,0.14285714285714285,False,False
Ambitious_Table_8585,12,58,70,77,0,Strong community,7,1.1,0.1,True,False
DewinterCor,18,6,24,24,0,Strong community,0,1.0,0.0,False,False
DuePersonality8585,12,7,19,20,0,Strong community,1,1.0526315789473684,0.05263157894736842,False,False
Dyn-O-mite_Rocketeer,7,5,12,16,0,Strong community,4,1.3333333333333333,0.3333333333333333,False,True
Elman89,14,7,21,20,0,Strong community,1,0.9523809523809523,0.047619047619047616,False,False
FrickinLazerBeams,21,21,42,43,0,Strong community,1,1.0238095238095237,0.023809523809523808,False,False
GenericUsername19892,13,7,20,20,0,Strong community,0,1.0,0.0,False,False
HackPhilosopher,12,6,18,21,0,Strong community,3,1.1666666666666667,0.16666666666666666,False,False
ImprovementPutrid441,33,25,58,57,0,Strong community,1,0.9827586206896551,0.017241379310344827,False,False
JKilla1288,31,10,41,40,0,Strong community,1,0.975609756097561,0.024390243902439025,False,False
Legitimate_Gas2966,6,4,10,8,0,Strong community,2,0.8,0.2,False,False
Miserable_Ground_264,32,15,47,51,0,Strong community,4,1.0851063829787233,0.0851063829787234,False,False
Ok-Hunt7450,12,4,16,19,0,Strong community,3,1.1875,0.1875,False,False
Owlblocks,22,5,27,28,0,Strong community,1,1.037037037037037,0.037037037037037035,False,False
ParfaitBurnera,7,4,11,11,0,Strong community,0,1.0,0.0,False,False
RYouNotEntertained,13,10,23,24,0,Strong community,1,1.0434782608695652,0.043478260869565216,False,False
Sea-Chain7394,21,12,33,28,0,Strong community,5,0.8484848484848485,0.15151515151515152,False,False
SingleMaltMouthwash,23,11,34,36,0,Strong community,2,1.0588235294117647,0.058823529411764705,False,False
SnugglesMTG,16,11,27,29,0,Strong community,2,1.0740740740740742,0.07407407407407407,False,False
SpeaksDwarren,7,5,12,10,0,Strong community,2,0.8333333333333334,0.16666666666666666,False,False
Tacenda8279,17,10,27,28,0,Strong community,1,1.037037037037037,0.037037037037037035,False,False
TastyWillingness4475,5,8,13,13,0,Strong community,0,1.0,0.0,False,False
Thestral84,4,4,8,2,11,Weak community,6,0.25,0.75,False,True
Thriftless_Ambition,25,18,43,37,0,Strong community,6,0.8604651162790697,0.13953488372093023,False,False
TonberryFeye,9,2,11,12,0,Strong community,1,1.0909090909090908,0.09090909090909091,False,False
VilleKivinen,11,1,12,8,2,Strong community,4,0.6666666666666666,0.3333333333333333,False,True
WithMaliceTowardFew,14,13,27,24,0,Strong community,3,0.8888888888888888,0.1111111111111111,False,False
bawdiepie,8,4,12,9,0,Strong community,3,0.75,0.25,False,True
citizen_x_,10,5,15,16,0,Strong community,1,1.0666666666666667,0.06666666666666667,False,False
eldankus,13,9,22,25,0,Strong community,3,1.1363636363636365,0.13636363636363635,False,False
fuckounknown,15,11,26,27,0,Strong community,1,1.0384615384615385,0.038461538461538464,False,False
imthesqwid,15,7,22,26,0,Strong community,4,1.1818181818181819,0.18181818181818182,False,False
sanguinemathghamhain,15,9,24,22,0,Strong community,2,0.9166666666666666,0.08333333333333333,False,False
wydileie,20,12,32,32,0,Strong community,0,1.0,0.0,False,False
Anna-Amos,4,36,40,32,3,Strong community,8,0.8,0.2,False,False
Alarmed-Speaker-8330,9,2,11,11,3,Strong community,0,1.0,0.0,False,False
AnotherBogCryptid,9,2,11,11,3,Strong community,0,1.0,0.0,False,False
Cudi_buddy,20,16,36,22,1,Strong community,14,0.6111111111111112,0.3888888888888889,False,True
Deep-Okra1461,48,0,48,53,3,Strong community,5,1.1041666666666667,0.10416666666666667,False,False
Disastrous-Nail-640,14,6,20,12,1,Strong community,8,0.6,0.4,False,True
Educational_Land197,5,5,10,4,9,Strong community,6,0.4,0.6,False,True
Environmental_Art591,6,5,11,9,3,Strong community,2,0.8181818181818182,0.18181818181818182,False,False
Kitastrophe8503,12,4,16,19,3,Strong community,3,1.1875,0.1875,False,False
Latter_Republic1719,12,13,25,27,3,Strong community,2,1.08,0.08,False,False
Legitimate-March9792,9,3,12,11,3,Strong community,1,0.9166666666666666,0.08333333333333333,False,False
Lows-andHighs,10,4,14,14,3,Strong community,0,1.0,0.0,False,False
Nymph-the-scribe,10,5,15,17,3,Strong community,2,1.1333333333333333,0.13333333333333333,False,False
OniyaMCD,5,4,9,8,3,Strong community,1,0.8888888888888888,0.1111111111111111,False,False
PhotoForward2499,8,4,12,12,3,Strong community,0,1.0,0.0,False,False
Polish_girl44,16,14,30,30,3,Strong community,0,1.0,0.0,True,False
PushPopNostalgia,12,5,17,15,0,Strong community,2,0.8823529411764706,0.11764705882352941,False,False
Puzzleheaded-Ad7606,13,8,21,19,3,Strong community,2,0.9047619047619048,0.09523809523809523,False,False
RemarkableRadish5664,5,3,8,4,17,Noisy community,4,0.5,0.5,False,False
Rubycon_,8,8,16,19,3,Strong community,3,1.1875,0.1875,False,False
ServelanDarrow,14,1,15,15,3,Strong community,0,1.0,0.0,False,False
Turbulent_Cow2355,15,17,32,30,3,Strong community,2,0.9375,0.0625,True,False
West-Scale-6800,4,1,5,6,3,Strong community,1,1.2,0.2,False,False
Worth-Season3645,12,2,14,15,3,Strong community,1,1.0714285714285714,0.07142857142857142,False,False
angelerulastiel,11,4,15,14,3,Strong community,1,0.9333333333333333,0.06666666666666667,False,False
camebacklate,8,4,12,11,3,Strong community,1,0.9166666666666666,0.08333333333333333,False,False
meechmeechmeecho,13,9,22,17,0,Strong community,5,0.7727272727272727,0.22727272727272727,False,True
AnswerSingle1566,1,5,6,3,5,Strong community,3,0.5,0.5,False,True
Butter-and-Bourbon,4,1,5,5,5,Strong community,0,1.0,0.0,False,False
Live_Angle4621,11,6,17,8,3,Strong community,9,0.47058823529411764,0.5294117647058824,False,True
AntigoneIMT,7,11,18,22,0,Strong community,4,1.2222222222222223,0.2222222222222222,False,True
R_V_Z,21,7,28,21,2,Strong community,7,0.75,0.25,False,True
Snipedzoi,6,4,10,12,0,Strong community,2,1.2,0.2,False,False
ZestSimple,8,5,13,14,0,Strong community,1,1.0769230769230769,0.07692307692307693,False,False
facefartfreely,16,11,27,34,0,Strong community,7,1.2592592592592593,0.25925925925925924,False,True
parentheticalobject,24,12,36,39,0,Strong community,3,1.0833333333333333,0.08333333333333333,False,False
Antonius_Palatinus,8,13,21,28,0,Strong community,7,1.3333333333333333,0.3333333333333333,False,True
DebutsPal,46,40,86,96,0,Strong community,10,1.1162790697674418,0.11627906976744186,True,False
JurisCommando,24,12,36,42,0,Strong community,6,1.1666666666666667,0.16666666666666666,False,False
Modern_Klassics,14,13,27,30,0,Strong community,3,1.1111111111111112,0.1111111111111111,False,False
RavensQueen502,10,9,19,22,0,Strong community,3,1.1578947368421053,0.15789473684210525,False,False
Zestyclose_Peanut_76,31,15,46,52,0,Strong community,6,1.1304347826086956,0.13043478260869565,False,False
canned_spaghetti85,15,4,19,20,0,Strong community,1,1.0526315789473684,0.05263157894736842,False,False
Any-Oven-9389,4,12,16,19,1,Strong community,3,1.1875,0.1875,False,False
AdventurousWorker176,6,2,8,6,1,Strong community,2,0.75,0.25,False,False
Resident_Course_3342,8,4,12,12,1,Strong community,0,1.0,0.0,False,False
iphxne,4,3,7,9,1,Strong community,2,1.2857142857142858,0.2857142857142857,False,False
jjr4884,17,7,24,23,1,Strong community,1,0.9583333333333334,0.041666666666666664,False,False
revanite3956,17,1,18,20,1,Strong community,2,1.1111111111111112,0.1111111111111111,False,False
Apartment-Drummer,28,34,62,61,1,Strong community,1,0.9838709677419355,0.016129032258064516,True,False
424f42_424f42,10,5,15,14,1,Strong community,1,0.9333333333333333,0.06666666666666667,False,False
DiegoIntrepid,10,15,25,24,1,Strong community,1,0.96,0.04,False,False
Honeycove91,6,3,9,10,1,Strong community,1,1.1111111111111112,0.1111111111111111,False,False
MinerUser,9,3,12,11,1,Strong community,1,0.9166666666666666,0.08333333333333333,False,False
Moonlit_Shade,4,1,5,1,6,Weak community,4,0.2,0.8,False,True
MrJigglyBrown,16,9,25,26,1,Strong community,1,1.04,0.04,False,False
MrWindblade,8,6,14,10,0,Strong community,4,0.7142857142857143,0.2857142857142857,False,True
QuestionSign,20,13,33,33,1,Strong community,0,1.0,0.0,True,False
Specialist-Ad5796,20,5,25,30,1,Strong community,5,1.2,0.2,False,False
ThePhilVv,31,20,51,39,1,Strong community,12,0.7647058823529411,0.23529411764705882,False,True
True_Falsity,3,3,6,6,1,Strong community,0,1.0,0.0,False,False
doublestitch,13,6,19,21,1,Strong community,2,1.105263157894737,0.10526315789473684,False,False
pplatt69,15,4,19,18,1,Strong community,1,0.9473684210526315,0.05263157894736842,False,False
rccrisp,16,5,21,23,1,Strong community,2,1.0952380952380953,0.09523809523809523,False,False
somepeoplewait,4,3,7,2,21,Noisy community,5,0.2857142857142857,0.7142857142857143,False,False
tultommy,9,3,12,13,1,Strong community,1,1.0833333333333333,0.08333333333333333,False,False
Apostate_Mage,11,29,40,45,1,Strong community,5,1.125,0.125,True,False
AfraidOstrich9539,6,5,11,11,3,Strong community,0,1.0,0.0,False,False
BookWormPerson,8,4,12,12,1,Strong community,0,1.0,0.0,False,False
DancingDaffodilius,10,4,14,14,1,Strong community,0,1.0,0.0,False,False
Forward_Party_5355,7,1,8,9,1,Strong community,1,1.125,0.125,False,False
FrostyIcePrincess,12,6,18,16,1,Strong community,2,0.8888888888888888,0.1111111111111111,False,False
NikRsmn,10,8,18,13,1,Strong community,5,0.7222222222222222,0.2777777777777778,False,True
NoahtheRed,51,20,71,74,1,Strong community,3,1.0422535211267605,0.04225352112676056,True,False
SparkleSelkie,46,30,76,74,1,Strong community,2,0.9736842105263158,0.02631578947368421,True,False
TemporaryApartment19,5,3,8,10,1,Strong community,2,1.25,0.25,False,False
Y0___0Y,36,14,50,46,2,Strong community,4,0.92,0.08,False,False
forlackofabetterpost,44,22,66,62,1,Strong community,4,0.9393939393939394,0.06060606060606061,True,False
Appropriate_Cook_508,5,9,14,21,0,Strong community,7,1.5,0.5,False,True
FattestPokemonPlayer,18,3,21,22,0,Strong community,1,1.0476190476190477,0.047619047619047616,False,False
Ok-Eye658,11,8,19,24,0,Strong community,5,1.263157894736842,0.2631578947368421,False,True
WippitGuud,15,7,22,24,0,Strong community,2,1.0909090909090908,0.09090909090909091,False,False
Ariesgh0st,1,9,10,11,3,Strong community,1,1.1,0.1,False,False
Antique-Agent-2992,8,2,10,11,3,Strong community,1,1.1,0.1,False,False
Flat-Replacement4828,39,19,58,61,3,Strong community,3,1.0517241379310345,0.05172413793103448,True,False
pinkpink0430,7,4,11,11,3,Strong community,0,1.0,0.0,False,False
quincebush,8,3,11,13,3,Strong community,2,1.1818181818181819,0.18181818181818182,False,False
Arkhamman367,6,12,18,27,0,Strong community,9,1.5,0.5,False,True
Smee76,6,4,10,11,0,Strong community,1,1.1,0.1,False,False
StillLikesTurtles,47,26,73,84,0,Strong community,11,1.1506849315068493,0.1506849315068493,True,False
StobbstheTiger,8,6,14,16,0,Strong community,2,1.1428571428571428,0.14285714285714285,False,False
Successful-Shopping8,53,118,171,199,0,Strong community,28,1.1637426900584795,0.16374269005847952,True,False
TarumK,11,6,17,16,0,Strong community,1,0.9411764705882353,0.058823529411764705,False,False
ThoseThatComeAfter,10,18,28,34,0,Strong community,6,1.2142857142857142,0.21428571428571427,False,False
Arnaldo1993,33,28,61,76,0,Strong community,15,1.2459016393442623,0.2459016393442623,False,True
AxlLight,11,6,17,10,2,Strong community,7,0.5882352941176471,0.4117647058823529,False,True
BootyMcStuffins,8,5,13,13,0,Strong community,0,1.0,0.0,False,False
Noodlesh89,31,21,52,56,0,Strong community,4,1.0769230769230769,0.07692307692307693,False,False
nightshade78036,5,3,8,12,0,Strong community,4,1.5,0.5,False,True
y0da1927,12,9,21,23,0,Strong community,2,1.0952380952380953,0.09523809523809523,False,False
Artistic_Kangaroo932,1,3,4,6,1,Strong community,2,1.5,0.5,False,False
Artistic_Remote_4665,3,10,13,16,3,Strong community,3,1.2307692307692308,0.23076923076923078,False,True
DawgMom67,11,0,11,12,3,Strong community,1,1.0909090909090908,0.09090909090909091,False,False
JeanSchlemaan,22,9,31,26,3,Strong community,5,0.8387096774193549,0.16129032258064516,False,False
Juilek,24,21,45,48,3,Strong community,3,1.0666666666666667,0.06666666666666667,True,False
OglioVagilio,10,10,20,23,3,Strong community,3,1.15,0.15,False,False
PiccoloImpossible946,8,10,18,16,3,Strong community,2,0.8888888888888888,0.1111111111111111,False,False
ThrowItAway4Evaa,9,7,16,17,3,Strong community,1,1.0625,0.0625,False,False
Usrname52,15,8,23,19,3,Strong community,4,0.8260869565217391,0.17391304347826086,False,False
Zestyclose-Height-36,6,2,8,8,3,Strong community,0,1.0,0.0,False,False
ZookeepergameOld3851,16,11,27,29,3,Strong community,2,1.0740740740740742,0.07407407407407407,False,False
AtheneOrchidSavviest,27,38,65,68,0,Strong community,3,1.0461538461538462,0.046153846153846156,True,False
BCMakoto,15,11,26,28,0,Strong community,2,1.0769230769230769,0.07692307692307693,False,False
Due_Satisfaction2167,10,4,14,18,0,Strong community,4,1.2857142857142858,0.2857142857142857,False,True
Gygsqt,22,23,45,37,0,Strong community,8,0.8222222222222222,0.17777777777777778,False,False
Raznill,18,11,29,29,0,Strong community,0,1.0,0.0,False,False
Rosimongus,13,11,24,25,0,Strong community,1,1.0416666666666667,0.041666666666666664,False,False
im-obsolete,16,6,22,21,0,Strong community,1,0.9545454545454546,0.045454545454545456,False,False
mattyoclock,12,5,17,15,0,Strong community,2,0.8823529411764706,0.11764705882352941,False,False
mred245,8,5,13,12,0,Strong community,1,0.9230769230769231,0.07692307692307693,False,False
pickleparty16,14,6,20,20,0,Strong community,0,1.0,0.0,False,False
rollem,17,6,23,19,0,Strong community,4,0.8260869565217391,0.17391304347826086,False,False
AutoModerator,0,75,75,35,1,Strong community,40,0.4666666666666667,0.5333333333333333,False,False
-Ch4s3-,31,23,54,54,0,Strong community,0,1.0,0.0,False,False
20twentytwos,5,2,7,7,1,Strong community,0,1.0,0.0,False,False
AnalogMojo23,5,3,8,8,1,Strong community,0,1.0,0.0,False,False
AspirationAtWork,31,20,51,41,0,Strong community,10,0.803921568627451,0.19607843137254902,False,False
Criminal_of_Thought,25,14,39,36,0,Strong community,3,0.9230769230769231,0.07692307692307693,False,False
Diego_Pepos,17,15,32,30,1,Strong community,2,0.9375,0.0625,False,False
Downtown-Act-590,41,95,136,132,0,Strong community,4,0.9705882352941176,0.029411764705882353,True,False
Embarrassed_Base_389,3,1,4,2,1,Strong community,2,0.5,0.5,False,False
JohnWittieless,19,13,32,32,0,Strong community,0,1.0,0.0,False,False
MalfoyHolmes14,22,5,27,30,1,Strong community,3,1.1111111111111112,0.1111111111111111,False,False
Mindless_Giraffe6887,17,55,72,59,1,Strong community,13,0.8194444444444444,0.18055555555555555,True,False
No-Necessary7448,12,5,17,16,1,Strong community,1,0.9411764705882353,0.058823529411764705,False,False
ReasonableBroccoli56,8,20,28,33,0,Strong community,5,1.1785714285714286,0.17857142857142858,False,False
RefrigeratorOk7848,17,13,30,27,1,Strong community,3,0.9,0.1,False,False
SirCatsworthTheThird,10,56,66,61,1,Strong community,5,0.9242424242424242,0.07575757575757576,True,False
SlurpingDischarge,19,13,32,34,0,Strong community,2,1.0625,0.0625,False,False
Strict_Berry7446,16,31,47,45,0,Strong community,2,0.9574468085106383,0.0425531914893617,False,False
Type-APersonality,12,36,48,52,0,Strong community,4,1.0833333333333333,0.08333333333333333,False,False
Wismuth_Salix,12,9,21,19,1,Strong community,2,0.9047619047619048,0.09523809523809523,False,False
XimiraSan,10,62,72,78,0,Strong community,6,1.0833333333333333,0.08333333333333333,True,False
andstillthesunrises,12,5,17,19,1,Strong community,2,1.1176470588235294,0.11764705882352941,False,False
atinylittlebug,5,2,7,5,0,Strong community,2,0.7142857142857143,0.2857142857142857,False,False
ballcheese808,10,6,16,20,1,Strong community,4,1.25,0.25,False,True
bbw420x,14,26,40,40,1,Strong community,0,1.0,0.0,True,False
bibliophile222,14,4,18,20,1,Strong community,2,1.1111111111111112,0.1111111111111111,False,False
dummythicktransslut,14,119,133,116,0,Strong community,17,0.8721804511278195,0.12781954887218044,True,False
ennsea,11,24,35,36,1,Strong community,1,1.0285714285714285,0.02857142857142857,True,False
for-a-dreamer,3,2,5,5,1,Strong community,0,1.0,0.0,False,False
jaggsy,8,4,12,10,1,Strong community,2,0.8333333333333334,0.16666666666666666,False,False
lightbulb20seven,14,17,31,38,0,Strong community,7,1.2258064516129032,0.22580645161290322,False,True
nofallingupward,17,3,20,15,1,Strong community,5,0.75,0.25,False,True
pokemonfanj,7,4,11,11,1,Strong community,0,1.0,0.0,False,False
spoilerdudegetrekt,7,4,11,12,0,Strong community,1,1.0909090909090908,0.09090909090909091,False,False
stonerbaby369,2,10,12,12,1,Strong community,0,1.0,0.0,False,False
throwquestions_away,14,16,30,31,0,Strong community,1,1.0333333333333334,0.03333333333333333,False,False
yuejuu,10,6,16,12,0,Strong community,4,0.75,0.25,False,True
Awesomeuser90,58,178,236,262,2,Strong community,26,1.1101694915254237,0.11016949152542373,True,False
-ReadingBug-,14,7,21,19,2,Strong community,2,0.9047619047619048,0.09523809523809523,False,False
-SOFA-KING-VOTE-,23,16,39,39,2,Strong community,0,1.0,0.0,False,False
1QAte4,41,12,53,52,2,Strong community,1,0.9811320754716981,0.018867924528301886,False,False
8to24,49,27,76,74,2,Strong community,2,0.9736842105263158,0.02631578947368421,True,False
AT_Dande,14,8,22,22,2,Strong community,0,1.0,0.0,False,False
Arthur_Edens,8,7,15,7,2,Strong community,8,0.4666666666666667,0.5333333333333333,False,True
Ashamed_Job_8151,16,10,26,26,2,Strong community,0,1.0,0.0,False,False
Aureliamnissan,5,5,10,10,2,Strong community,0,1.0,0.0,False,False
CellularSavant,7,3,10,10,2,Strong community,0,1.0,0.0,False,False
CharlieandtheRed,12,11,23,23,2,Strong community,0,1.0,0.0,False,False
Comfortable-Policy70,10,5,15,13,2,Strong community,2,0.8666666666666667,0.13333333333333333,False,False
Corellian_Browncoat,21,19,40,41,2,Strong community,1,1.025,0.025,False,False
DCBuckeye82,7,6,13,11,2,Strong community,2,0.8461538461538461,0.15384615384615385,False,False
DarkExecutor,6,5,11,11,2,Strong community,0,1.0,0.0,False,False
DrPlatypus1,6,2,8,8,2,Strong community,0,1.0,0.0,False,False
ERedfieldh,24,14,38,38,2,Strong community,0,1.0,0.0,False,False
Fragrant-Luck-8063,21,14,35,34,2,Strong community,1,0.9714285714285714,0.02857142857142857,False,False
GarbledComms,9,6,15,12,2,Strong community,3,0.8,0.2,False,False
GiantPineapple,32,21,53,52,2,Strong community,1,0.9811320754716981,0.018867924528301886,False,False
GoldenInfrared,12,5,17,11,0,Strong community,6,0.6470588235294118,0.35294117647058826,False,True
GrandMasterPuba,16,9,25,24,2,Strong community,1,0.96,0.04,False,False
H_Mc,12,10,22,20,2,Strong community,2,0.9090909090909091,0.09090909090909091,False,False
HeloRising,11,5,16,14,2,Strong community,2,0.875,0.125,False,False
I-Here-555,29,20,49,47,2,Strong community,2,0.9591836734693877,0.04081632653061224,False,False
IceNein,31,16,47,49,2,Strong community,2,1.0425531914893618,0.0425531914893617,False,False
Ind132,11,4,15,15,2,Strong community,0,1.0,0.0,False,False
JKlerk,65,43,108,111,2,Strong community,3,1.0277777777777777,0.027777777777777776,True,False
JQuilty,16,12,28,19,2,Strong community,9,0.6785714285714286,0.32142857142857145,False,True
JonDowd762,16,20,36,35,2,Strong community,1,0.9722222222222222,0.027777777777777776,False,False
JuniorFarcity,23,12,35,34,2,Strong community,1,0.9714285714285714,0.02857142857142857,False,False
Kedulus,20,2,22,25,0,Strong community,3,1.1363636363636365,0.13636363636363635,False,False
Kitchner,4,6,10,11,2,Strong community,1,1.1,0.1,False,False
Kronzypantz,41,88,129,126,2,Strong community,3,0.9767441860465116,0.023255813953488372,True,False
Kuramhan,33,22,55,56,2,Strong community,1,1.018181818181818,0.01818181818181818,True,False
Lanracie,19,9,28,21,2,Strong community,7,0.75,0.25,False,True
LifesARiver,22,12,34,28,2,Strong community,6,0.8235294117647058,0.17647058823529413,False,False
MoonBatsRule,14,9,23,23,2,Strong community,0,1.0,0.0,False,False
Mountain-Resource656,17,10,27,22,0,Strong community,5,0.8148148148148148,0.18518518518518517,False,False
MurrayBothrard,21,14,35,35,2,Strong community,0,1.0,0.0,False,False
NoExcuses1984,19,19,38,39,2,Strong community,1,1.0263157894736843,0.02631578947368421,False,False
Olderscout77,12,13,25,13,2,Strong community,12,0.52,0.48,False,True
OutrageousSummer5259,9,5,14,14,2,Strong community,0,1.0,0.0,False,False
Party_Combination131,9,20,29,28,2,Strong community,1,0.9655172413793104,0.034482758620689655,False,False
Raichu4u,24,109,133,130,2,Strong community,3,0.9774436090225563,0.022556390977443608,True,False
Randolpho,13,7,20,17,0,Strong community,3,0.85,0.15,False,False
Randomn355,7,5,12,10,1,Strong community,2,0.8333333333333334,0.16666666666666666,False,False
RexDraco,5,2,7,8,2,Strong community,1,1.1428571428571428,0.14285714285714285,False,False
Riokaii,23,13,36,35,2,Strong community,1,0.9722222222222222,0.027777777777777776,False,False
Santosp3,44,17,61,49,0,Strong community,12,0.8032786885245902,0.19672131147540983,False,False
Sapriste,39,18,57,33,2,Strong community,24,0.5789473684210527,0.42105263157894735,False,True
ScoobiusMaximus,14,7,21,21,2,Strong community,0,1.0,0.0,False,False
SenoraRaton,10,9,19,3,32,Noisy community,16,0.15789473684210525,0.8421052631578947,False,False
Serious-Top7925,11,8,19,19,2,Strong community,0,1.0,0.0,False,False
Significant-Cancel70,22,16,38,28,2,Strong community,10,0.7368421052631579,0.2631578947368421,False,True
SpoofedFinger,19,7,26,27,2,Strong community,1,1.0384615384615385,0.038461538461538464,False,False
The-Polite-Pervert,18,11,29,29,2,Strong community,0,1.0,0.0,False,False
ThePensiveE,16,5,21,18,2,Strong community,3,0.8571428571428571,0.14285714285714285,False,False
TheTrueMilo,23,17,40,40,2,Strong community,0,1.0,0.0,False,False
The_Law_of_Pizza,66,31,97,65,2,Strong community,32,0.6701030927835051,0.32989690721649484,False,True
ThemesOfMurderBears,19,17,36,30,2,Strong community,6,0.8333333333333334,0.16666666666666666,False,False
Tired8281,6,5,11,12,2,Strong community,1,1.0909090909090908,0.09090909090909091,False,False
Vast-Information4565,6,8,14,13,2,Strong community,1,0.9285714285714286,0.07142857142857142,False,False
VodkaBeatsCube,60,49,109,104,2,Strong community,5,0.9541284403669725,0.045871559633027525,True,False
WavesAndSaves,62,134,196,197,2,Strong community,1,1.0051020408163265,0.00510204081632653,True,False
Wetness_Pensive,19,12,31,30,2,Strong community,1,0.967741935483871,0.03225806451612903,False,False
ZorbaTHut,6,4,10,7,2,Strong community,3,0.7,0.3,False,True
airbear13,9,6,15,14,2,Strong community,1,0.9333333333333333,0.06666666666666667,False,False
barchueetadonai,13,13,26,26,2,Strong community,0,1.0,0.0,False,False
betty_white_bread,11,18,29,30,2,Strong community,1,1.0344827586206897,0.034482758620689655,False,False
bigdon802,19,17,36,22,2,Strong community,14,0.6111111111111112,0.3888888888888889,False,True
bleahdeebleah,12,11,23,20,2,Strong community,3,0.8695652173913043,0.13043478260869565,False,False
bruce_cockburn,7,6,13,13,2,Strong community,0,1.0,0.0,False,False
calguy1955,17,6,23,26,2,Strong community,3,1.1304347826086956,0.13043478260869565,False,False
callmejay,11,7,18,17,0,Strong community,1,0.9444444444444444,0.05555555555555555,False,False
chiaboy,25,16,41,25,0,Strong community,16,0.6097560975609756,0.3902439024390244,False,True
cowboyjosh2010,9,2,11,11,2,Strong community,0,1.0,0.0,False,False
curien,26,14,40,28,2,Strong community,12,0.7,0.3,False,True
davethompson413,11,5,16,16,2,Strong community,0,1.0,0.0,False,False
ddoyen,8,5,13,14,2,Strong community,1,1.0769230769230769,0.07692307692307693,False,False
digbyforever,28,13,41,30,2,Strong community,11,0.7317073170731707,0.2682926829268293,False,True
eggoed,12,6,18,15,2,Strong community,3,0.8333333333333334,0.16666666666666666,False,False
epsilona01,35,27,62,58,2,Strong community,4,0.9354838709677419,0.06451612903225806,True,False
etoneishayeuisky,13,7,20,16,2,Strong community,4,0.8,0.2,False,False
flat6NA,11,7,18,15,2,Strong community,3,0.8333333333333334,0.16666666666666666,False,False
gregaustex,20,5,25,27,2,Strong community,2,1.08,0.08,False,False
hblask,11,6,17,17,2,Strong community,0,1.0,0.0,False,False
jetpacksforall,37,38,75,76,2,Strong community,1,1.0133333333333334,0.013333333333333334,True,False
jfchops3,33,34,67,47,2,Strong community,20,0.7014925373134329,0.29850746268656714,False,True
jmnugent,13,8,21,21,2,Strong community,0,1.0,0.0,False,False
jmtrader2,14,7,21,21,2,Strong community,0,1.0,0.0,False,False
kormer,21,17,38,39,2,Strong community,1,1.0263157894736843,0.02631578947368421,False,False
l1qq,27,10,37,35,2,Strong community,2,0.9459459459459459,0.05405405405405406,False,False
lafigatatia,3,4,7,3,12,Weak community,4,0.42857142857142855,0.5714285714285714,False,True
luminatimids,9,4,13,13,2,Strong community,0,1.0,0.0,False,False
mcgunner1966,18,12,30,28,2,Strong community,2,0.9333333333333333,0.06666666666666667,False,False
morrison4371,7,7,14,14,2,Strong community,0,1.0,0.0,False,False
mycall,12,6,18,18,2,Strong community,0,1.0,0.0,False,False
nanoatzin,14,6,20,21,2,Strong community,1,1.05,0.05,False,False
nylockian,8,3,11,11,2,Strong community,0,1.0,0.0,False,False
ptmd,8,9,17,17,2,Strong community,0,1.0,0.0,False,False
reasonably_plausible,15,11,26,24,2,Strong community,2,0.9230769230769231,0.07692307692307693,False,False
rollingrock16,9,6,15,15,0,Strong community,0,1.0,0.0,False,False
satyrday12,37,25,62,56,2,Strong community,6,0.9032258064516129,0.0967741935483871,True,False
semideclared,23,25,48,47,2,Strong community,1,0.9791666666666666,0.020833333333333332,False,False
siberianmi,24,12,36,35,2,Strong community,1,0.9722222222222222,0.027777777777777776,False,False
socialistrob,15,18,33,33,2,Strong community,0,1.0,0.0,False,False
the_calibre_cat,31,43,74,68,2,Strong community,6,0.918918918918919,0.08108108108108109,True,False
theresourcefulKman,7,2,9,10,2,Strong community,1,1.1111111111111112,0.1111111111111111,False,False
ttown2011,55,35,90,86,2,Strong community,4,0.9555555555555556,0.044444444444444446,True,False
yo2sense,10,8,18,18,2,Strong community,0,1.0,0.0,False,False
Axlerodriguez,12,28,40,49,0,Strong community,9,1.225,0.225,False,True
ChirpyRaven,38,15,53,64,0,Strong community,11,1.2075471698113207,0.20754716981132076,False,False
EdelgardSexHaver,25,13,38,38,0,Strong community,0,1.0,0.0,False,False
GoldenEagle828677,13,7,20,21,0,Strong community,1,1.05,0.05,False,False
Imadevilsadvocater,56,48,104,102,0,Strong community,2,0.9807692307692307,0.019230769230769232,True,False
Orphan_Guy_Incognito,24,15,39,39,0,Strong community,0,1.0,0.0,False,False
Starfleet-Time-Lord,15,7,22,25,0,Strong community,3,1.1363636363636365,0.13636363636363635,False,False
c0i9z,45,39,84,88,0,Strong community,4,1.0476190476190477,0.047619047619047616,True,False
couldbemage,22,29,51,51,0,Strong community,0,1.0,0.0,False,False
deep_sea2,33,20,53,62,0,Strong community,9,1.169811320754717,0.16981132075471697,True,False
orangutanDOTorg,8,4,12,12,1,Strong community,0,1.0,0.0,False,False
vuzz33,7,8,15,16,0,Strong community,1,1.0666666666666667,0.06666666666666667,False,False
zyrkseas97,15,8,23,24,0,Strong community,1,1.0434782608695652,0.043478260869565216,False,False
Ay_respiracion,1,12,13,11,1,Strong community,2,0.8461538461538461,0.15384615384615385,False,False
ExtendedMacaroni,7,2,9,10,1,Strong community,1,1.1111111111111112,0.1111111111111111,False,False
MikrokosmicUnicorn,7,10,17,15,1,Strong community,2,0.8823529411764706,0.11764705882352941,False,False
boringexplanation,15,7,22,13,2,Strong community,9,0.5909090909090909,0.4090909090909091,False,True
B-RapShoeStrap,9,9,18,20,1,Strong community,2,1.1111111111111112,0.1111111111111111,False,False
Choperello,29,20,49,44,0,Strong community,5,0.8979591836734694,0.10204081632653061,False,False
NoTomato7740,16,7,23,18,0,Strong community,5,0.782608695652174,0.21739130434782608,False,False
OkCluejay172,11,7,18,19,1,Strong community,1,1.0555555555555556,0.05555555555555555,False,False
BB_Nips,4,11,15,20,0,Strong community,5,1.3333333333333333,0.3333333333333333,False,True
BeatSteady,5,2,7,6,0,Strong community,1,0.8571428571428571,0.14285714285714285,False,False
JunktownRoller,8,5,13,14,0,Strong community,1,1.0769230769230769,0.07692307692307693,False,False
Subtleiaint,9,12,21,29,0,Strong community,8,1.380952380952381,0.38095238095238093,False,True
TanStewyBeinTanStewy,21,11,32,31,0,Strong community,1,0.96875,0.03125,False,False
BECSP-TEB,17,19,36,37,0,Strong community,1,1.0277777777777777,0.027777777777777776,False,False
LucidLeviathan,27,18,45,47,0,Strong community,2,1.0444444444444445,0.044444444444444446,False,False
scrambledhelix,17,12,29,26,0,Strong community,3,0.896551724137931,0.10344827586206896,False,False
Babygall99,2,4,6,7,1,Strong community,1,1.1666666666666667,0.16666666666666666,False,False
Ok_Requirement_3116,15,2,17,14,1,Strong community,3,0.8235294117647058,0.17647058823529413,False,False
ATXoxoxo,22,7,29,32,0,Strong community,3,1.103448275862069,0.10344827586206896,False,False
Alethia_23,8,8,16,15,0,Strong community,1,0.9375,0.0625,False,False
AppropriateScience9,12,8,20,20,0,Strong community,0,1.0,0.0,False,False
Bonesquire,9,14,23,21,0,Strong community,2,0.9130434782608695,0.08695652173913043,False,False
Bradybigboss,23,111,134,127,0,Strong community,7,0.9477611940298507,0.05223880597014925,True,False
BurningEmbers978,10,5,15,14,0,Strong community,1,0.9333333333333333,0.06666666666666667,False,False
Chinohito,7,5,12,12,0,Strong community,0,1.0,0.0,False,False
Dazzling_Instance_57,26,23,49,49,0,Strong community,0,1.0,0.0,False,False
Didntlikedefaultname,19,5,24,24,0,Strong community,0,1.0,0.0,False,False
EDRootsMusic,12,9,21,21,0,Strong community,0,1.0,0.0,False,False
EvilBubblePopper,18,17,35,41,0,Strong community,6,1.1714285714285715,0.17142857142857143,False,False
JSmith666,21,11,32,25,0,Strong community,7,0.78125,0.21875,False,False
JimDee01,14,7,21,9,2,Strong community,12,0.42857142857142855,0.5714285714285714,False,True
JoJoeyJoJo,15,9,24,24,0,Strong community,0,1.0,0.0,False,False
No-Field3266,5,6,11,11,0,Strong community,0,1.0,0.0,False,False
Reaverion,6,5,11,4,29,Noisy community,7,0.36363636363636365,0.6363636363636364,False,False
Regarded-Illya,10,8,18,18,0,Strong community,0,1.0,0.0,False,False
Salty_Map_9085,16,11,27,29,0,Strong community,2,1.0740740740740742,0.07407407407407407,False,False
Sufficient-Bat-5035,18,2,20,23,0,Strong community,3,1.15,0.15,False,False
TacoBelle2176,7,4,11,11,0,Strong community,0,1.0,0.0,False,False
TellItLikeItIs1994,12,8,20,18,0,Strong community,2,0.9,0.1,False,False
VeganKiwiGuy,30,24,54,54,0,Strong community,0,1.0,0.0,False,False
ancientmarin_,23,21,44,43,0,Strong community,1,0.9772727272727273,0.022727272727272728,False,False
anewaccount69420,18,8,26,21,0,Strong community,5,0.8076923076923077,0.19230769230769232,False,False
chaucer345,67,135,202,241,0,Strong community,39,1.193069306930693,0.19306930693069307,True,False
crawling-alreadygirl,24,21,45,40,0,Strong community,5,0.8888888888888888,0.1111111111111111,False,False
dickpierce69,40,12,52,43,0,Strong community,9,0.8269230769230769,0.17307692307692307,False,False
harpyprincess,10,5,15,13,0,Strong community,2,0.8666666666666667,0.13333333333333333,False,False
iodfuse,15,9,24,25,0,Strong community,1,1.0416666666666667,0.041666666666666664,False,False
isocher,7,6,13,14,0,Strong community,1,1.0769230769230769,0.07692307692307693,False,False
joet889,5,3,8,8,0,Strong community,0,1.0,0.0,False,False
jwrig,35,26,61,67,0,Strong community,6,1.098360655737705,0.09836065573770492,True,False
my-two-centses,28,17,45,48,0,Strong community,3,1.0666666666666667,0.06666666666666667,False,False
pcgamernum1234,17,9,26,25,0,Strong community,1,0.9615384615384616,0.038461538461538464,False,False
rainystast,10,6,16,16,0,Strong community,0,1.0,0.0,False,False
rollingForInitiative,14,7,21,22,0,Strong community,1,1.0476190476190477,0.047619047619047616,False,False
sandwiches_are_real,7,5,12,4,29,Noisy community,8,0.3333333333333333,0.6666666666666666,False,False
sourcreamus,27,20,47,47,0,Strong community,0,1.0,0.0,False,False
spiral8888,12,7,19,16,0,Strong community,3,0.8421052631578947,0.15789473684210525,False,False
ultradav24,27,39,66,62,0,Strong community,4,0.9393939393939394,0.06060606060606061,True,False
DanforthWhitcomb_,55,64,119,116,2,Strong community,3,0.9747899159663865,0.025210084033613446,True,False
ItsAGoodDay,6,3,9,10,2,Strong community,1,1.1111111111111112,0.1111111111111111,False,False
Sarlax,13,10,23,24,2,Strong community,1,1.0434782608695652,0.043478260869565216,False,False
WingerRules,24,21,45,46,2,Strong community,1,1.0222222222222221,0.022222222222222223,False,False
Balarian,7,15,22,29,0,Strong community,7,1.3181818181818181,0.3181818181818182,False,True
BarneyLaurance,10,14,24,35,0,Strong community,11,1.4583333333333333,0.4583333333333333,False,True
Adequate_Images,12,7,19,19,0,Strong community,0,1.0,0.0,False,False
Devourerofworlds_69,16,7,23,25,0,Strong community,2,1.0869565217391304,0.08695652173913043,False,False
Potential_Being_7226,13,5,18,21,0,Strong community,3,1.1666666666666667,0.16666666666666666,False,False
djbuu,5,3,8,10,0,Strong community,2,1.25,0.25,False,False
BarryKentJr,2,6,8,11,1,Strong community,3,1.375,0.375,False,True
CinderrUwU,31,6,37,40,1,Strong community,3,1.0810810810810811,0.08108108108108109,False,False
RunnyDischarge,10,11,21,23,1,Strong community,2,1.0952380952380953,0.09523809523809523,False,False
SupaSaiyajin4,7,10,17,16,1,Strong community,1,0.9411764705882353,0.058823529411764705,False,False
ottoandinga88,20,4,24,21,1,Strong community,3,0.875,0.125,False,False
Basic_Cockroach_9545,13,18,31,34,0,Strong community,3,1.096774193548387,0.0967741935483871,False,False
OrganicFall5526,9,15,24,25,0,Strong community,1,1.0416666666666667,0.041666666666666664,False,False
Basic_Mobile2792,11,12,23,30,0,Strong community,7,1.3043478260869565,0.30434782608695654,False,True
HiddenThinks,6,4,10,6,38,Noisy community,4,0.6,0.4,False,False
ProRuckus,11,4,15,18,0,Strong community,3,1.2,0.2,False,False
Basnap,11,18,29,35,0,Strong community,6,1.206896551724138,0.20689655172413793,False,False
DMTwolf,17,15,32,35,0,Strong community,3,1.09375,0.09375,False,False
Icy_River_8259,43,26,69,75,0,Strong community,6,1.0869565217391304,0.08695652173913043,True,False
dinjamora,9,7,16,17,0,Strong community,1,1.0625,0.0625,False,False
parsonsrazersupport,24,19,43,43,0,Strong community,0,1.0,0.0,False,False
unseemly_turbidity,5,3,8,2,59,Noisy community,6,0.25,0.75,False,False
Battlefeather,15,60,75,77,0,Strong community,2,1.0266666666666666,0.02666666666666667,True,False
A_Duck_Using_Reddit,19,12,31,28,0,Strong community,3,0.9032258064516129,0.0967741935483871,False,False
BigbunnyATK,6,3,9,9,0,Strong community,0,1.0,0.0,False,False
Chemical_Series6082,14,11,25,24,0,Strong community,1,0.96,0.04,False,False
Dakk85,21,18,39,32,0,Strong community,7,0.8205128205128205,0.1794871794871795,False,False
DevelopmentSad2303,8,7,15,15,0,Strong community,0,1.0,0.0,False,False
FearlessResource9785,37,19,56,63,0,Strong community,7,1.125,0.125,True,False
Jaymac720,13,1,14,11,1,Strong community,3,0.7857142857142857,0.21428571428571427,False,False
LewisCarroll95,20,91,111,108,0,Strong community,3,0.972972972972973,0.02702702702702703,True,False
Meii345,21,17,38,35,0,Strong community,3,0.9210526315789473,0.07894736842105263,False,False
Message_10,12,9,21,20,0,Strong community,1,0.9523809523809523,0.047619047619047616,False,False
NegevThunderstorm,34,21,55,58,0,Strong community,3,1.0545454545454545,0.05454545454545454,False,False
Objective-District39,18,12,30,35,0,Strong community,5,1.1666666666666667,0.16666666666666666,False,False
Pastadseven,12,6,18,18,0,Strong community,0,1.0,0.0,False,False
ProfessionalTap2400,24,61,85,103,0,Strong community,18,1.2117647058823529,0.21176470588235294,False,False
RaskyBukowski,35,34,69,83,0,Strong community,14,1.2028985507246377,0.2028985507246377,False,False
RecycledPanOil,7,4,11,11,0,Strong community,0,1.0,0.0,False,False
Rude_Lengthiness_101,6,6,12,12,0,Strong community,0,1.0,0.0,False,False
Slackjawed_Horror,24,25,49,46,0,Strong community,3,0.9387755102040817,0.061224489795918366,False,False
_phish_,6,1,7,5,0,Strong community,2,0.7142857142857143,0.2857142857142857,False,False
amonkus,12,9,21,17,0,Strong community,4,0.8095238095238095,0.19047619047619047,False,False
ethical_arsonist,6,4,10,12,0,Strong community,2,1.2,0.2,False,False
lalahair,63,58,121,126,0,Strong community,5,1.0413223140495869,0.04132231404958678,True,False
lordnacho666,14,6,20,21,0,Strong community,1,1.05,0.05,False,False
monkeysky,9,5,14,16,0,Strong community,2,1.1428571428571428,0.14285714285714285,False,False
snotick,7,5,12,13,0,Strong community,1,1.0833333333333333,0.08333333333333333,False,False
svdomer09,7,6,13,13,0,Strong community,0,1.0,0.0,False,False
Beautiful-Blood-8712,4,15,19,24,0,Strong community,5,1.263157894736842,0.2631578947368421,False,True
Accomplished-Park480,12,3,15,20,0,Strong community,5,1.3333333333333333,0.3333333333333333,False,True
EasternHo,11,7,18,25,0,Strong community,7,1.3888888888888888,0.3888888888888889,False,True
bradlap,19,8,27,28,0,Strong community,1,1.037037037037037,0.037037037037037035,False,False
Beautiful-Fold-3234,6,14,20,24,0,Strong community,4,1.2,0.2,False,False
Bedevyr,3,11,14,15,0,Strong community,1,1.0714285714285714,0.07142857142857142,False,False
yelling_at_moon,12,9,21,25,0,Strong community,4,1.1904761904761905,0.19047619047619047,False,False
Big-Progress3280,8,17,25,31,0,Strong community,6,1.24,0.24,False,True
Big_Mek_Orkimedes,9,8,17,17,0,Strong community,0,1.0,0.0,False,False
DoeCommaJohn,39,13,52,58,0,Strong community,6,1.1153846153846154,0.11538461538461539,False,False
Live_Background_3455,24,13,37,32,0,Strong community,5,0.8648648648648649,0.13513513513513514,False,False
BigBandit01,4,16,20,24,0,Strong community,4,1.2,0.2,False,False
CaptainONaps,13,4,17,22,0,Strong community,5,1.2941176470588236,0.29411764705882354,False,True
InThreeWordsTheySaid,9,6,15,16,0,Strong community,1,1.0666666666666667,0.06666666666666667,False,False
JuicingPickle,9,6,15,14,0,Strong community,1,0.9333333333333333,0.06666666666666667,False,False
PrimaryInjurious,33,27,60,61,0,Strong community,1,1.0166666666666666,0.016666666666666666,False,False
RedMarsRepublic,10,3,13,15,0,Strong community,2,1.1538461538461537,0.15384615384615385,False,False
Big_Sea_5912,10,64,74,75,0,Strong community,1,1.0135135135135136,0.013513513513513514,True,False
AtmosphericReverbMan,16,11,27,28,0,Strong community,1,1.037037037037037,0.037037037037037035,False,False
Aware-Computer4550,18,7,25,25,0,Strong community,0,1.0,0.0,False,False
Brilliant-Lab546,13,7,20,20,0,Strong community,0,1.0,0.0,False,False
CaliMassNC,6,4,10,11,0,Strong community,1,1.1,0.1,False,False
Evilsushione,13,9,22,21,0,Strong community,1,0.9545454545454546,0.045454545454545456,False,False
GrowFreeFood,21,16,37,27,2,Strong community,10,0.7297297297297297,0.2702702702702703,False,True
LifeofTino,10,5,15,16,0,Strong community,1,1.0666666666666667,0.06666666666666667,False,False
PlusAd4034,5,3,8,9,0,Strong community,1,1.125,0.125,False,False
Successful-Crazy-126,13,2,15,9,0,Strong community,6,0.6,0.4,False,True
Successful-Silver485,4,3,7,7,0,Strong community,0,1.0,0.0,False,False
TurnYourHeadNCough,5,4,9,4,35,Noisy community,5,0.4444444444444444,0.5555555555555556,False,False
airboRN_82,33,27,60,68,0,Strong community,8,1.1333333333333333,0.13333333333333333,True,False
cairnrock1,6,3,9,10,0,Strong community,1,1.1111111111111112,0.1111111111111111,False,False
deepstaterecords,9,9,18,13,0,Strong community,5,0.7222222222222222,0.2777777777777778,False,True
dowker1,14,9,23,18,0,Strong community,5,0.782608695652174,0.21739130434782608,False,False
ertri,9,5,14,9,1,Strong community,5,0.6428571428571429,0.35714285714285715,False,True
iamcleek,16,5,21,24,0,Strong community,3,1.1428571428571428,0.14285714285714285,False,False
martco17,44,109,153,178,0,Strong community,25,1.1633986928104576,0.16339869281045752,True,False
revertbritestoan,14,10,24,25,0,Strong community,1,1.0416666666666667,0.041666666666666664,False,False
rzelln,6,7,13,1,60,Noisy community,12,0.07692307692307693,0.9230769230769231,False,False
shthappens03250322,21,7,28,25,0,Strong community,3,0.8928571428571429,0.10714285714285714,False,False
stevie-antelope,12,5,17,19,0,Strong community,2,1.1176470588235294,0.11764705882352941,False,False
washingtonu,13,11,24,5,35,Noisy community,19,0.20833333333333334,0.7916666666666666,False,False
Big_Trash_7504,2,6,8,6,5,Strong community,2,0.75,0.25,False,False
BeforeAndAfterMeme,4,2,6,2,22,Noisy community,4,0.3333333333333333,0.6666666666666666,False,False
Dull_Banana1377,3,2,5,4,3,Strong community,1,0.8,0.2,False,False
No_Lynx1343,5,1,6,8,5,Strong community,2,1.3333333333333333,0.3333333333333333,False,False
nothanks1312,5,3,8,10,5,Strong community,2,1.25,0.25,False,False
BitFiesty,4,31,35,31,1,Strong community,4,0.8857142857142857,0.11428571428571428,False,False
ChemicalCat4181,14,7,21,7,1,Strong community,14,0.3333333333333333,0.6666666666666666,False,True
DosZappos,10,7,17,17,1,Strong community,0,1.0,0.0,False,False
ElGranJerkador,9,3,12,11,1,Strong community,1,0.9166666666666666,0.08333333333333333,False,False
Hambredd,17,11,28,28,1,Strong community,0,1.0,0.0,False,False
HeadGuide4388,15,7,22,15,1,Strong community,7,0.6818181818181818,0.3181818181818182,False,True
K9WorkingDog,8,8,16,15,1,Strong community,1,0.9375,0.0625,False,False
Kimolainen83,14,5,19,17,1,Strong community,2,0.8947368421052632,0.10526315789473684,False,False
TegridyPharmz,12,4,16,15,1,Strong community,1,0.9375,0.0625,False,False
Trinikas,42,7,49,35,0,Strong community,14,0.7142857142857143,0.2857142857142857,False,True
adviceforthrowawayy,14,6,20,13,1,Strong community,7,0.65,0.35,False,True
alphamalejackhammer,5,14,19,7,8,Weak community,12,0.3684210526315789,0.631578947368421,False,True
baddecision116,7,2,9,8,1,Strong community,1,0.8888888888888888,0.1111111111111111,False,False
clutzyninja,27,18,45,38,1,Strong community,7,0.8444444444444444,0.15555555555555556,True,False
duskfinger67,28,24,52,54,0,Strong community,2,1.0384615384615385,0.038461538461538464,False,False
gitismatt,12,6,18,17,1,Strong community,1,0.9444444444444444,0.05555555555555555,False,False
joelene1892,7,3,10,8,1,Strong community,2,0.8,0.2,False,False
the_urban_juror,3,3,6,6,1,Strong community,0,1.0,0.0,False,False
vicente8a,7,4,11,6,1,Strong community,5,0.5454545454545454,0.45454545454545453,False,True
Bitter-Sherbert1607,8,24,32,40,0,Strong community,8,1.25,0.25,False,True
Bilbo332,5,3,8,8,0,Strong community,0,1.0,0.0,False,False
Just_Nefariousness55,18,8,26,29,0,Strong community,3,1.1153846153846154,0.11538461538461539,False,False
Severe_Appointment93,15,23,38,43,0,Strong community,5,1.131578947368421,0.13157894736842105,False,False
blade740,9,5,14,14,0,Strong community,0,1.0,0.0,False,False
poop_drunk,14,6,20,20,0,Strong community,0,1.0,0.0,False,False
stewshi,16,8,24,21,0,Strong community,3,0.875,0.125,False,False
xfvh,16,9,25,27,0,Strong community,2,1.08,0.08,False,False
Blackbird01661,4,13,17,22,3,Strong community,5,1.2941176470588236,0.29411764705882354,False,True
Alternative-Redditer,13,10,23,22,3,Strong community,1,0.9565217391304348,0.043478260869565216,False,False
Fun-Bread-8560,10,2,12,14,3,Strong community,2,1.1666666666666667,0.16666666666666666,False,False
Impossible_Rain_4727,5,2,7,8,3,Strong community,1,1.1428571428571428,0.14285714285714285,False,False
KathrynTheGreat,4,5,9,11,3,Strong community,2,1.2222222222222223,0.2222222222222222,False,False
Living-Assumption272,12,0,12,14,3,Strong community,2,1.1666666666666667,0.16666666666666666,False,False
Only-Breadfruit-6108,18,2,20,24,3,Strong community,4,1.2,0.2,False,False
West_House_2085,19,11,30,33,3,Strong community,3,1.1,0.1,True,False
oliviamrow,10,6,16,23,3,Strong community,7,1.4375,0.4375,False,True
Blackelvis2000,2,16,18,18,1,Strong community,0,1.0,0.0,False,False
Nuckin-Futz666,7,3,10,10,1,Strong community,0,1.0,0.0,False,False
Riceowls29,10,7,17,14,0,Strong community,3,0.8235294117647058,0.17647058823529413,False,False
StalkMeNowCrazyLady,9,6,15,15,1,Strong community,0,1.0,0.0,False,False
Substandard_eng2468,9,4,13,12,1,Strong community,1,0.9230769230769231,0.07692307692307693,False,False
BlazeTheSkeleton,2,11,13,12,1,Strong community,1,0.9230769230769231,0.07692307692307693,False,False
Alive_Ice7937,19,8,27,28,0,Strong community,1,1.037037037037037,0.037037037037037035,False,False
AzSumTuk6891,24,13,37,33,1,Strong community,4,0.8918918918918919,0.10810810810810811,True,False
ExismykindaParte,18,7,25,28,1,Strong community,3,1.12,0.12,False,False
Unfair_Finger5531,7,7,14,12,1,Strong community,2,0.8571428571428571,0.14285714285714285,False,False
notmenotwhenitsyou,6,2,8,7,1,Strong community,1,0.875,0.125,False,False
yvrelna,9,4,13,12,1,Strong community,1,0.9230769230769231,0.07692307692307693,False,False
Blonde_Icon,8,24,32,10,1,Strong community,22,0.3125,0.6875,False,True
DMVlooker,14,4,18,17,0,Strong community,1,0.9444444444444444,0.05555555555555555,False,False
Fletcher-wordy,26,34,60,64,0,Strong community,4,1.0666666666666667,0.06666666666666667,True,False
ItsFreeRight,7,25,32,39,1,Strong community,7,1.21875,0.21875,False,False
Over-Tiger-8818,12,8,20,11,1,Strong community,9,0.55,0.45,False,True
Scared_Ad2563,6,2,8,10,1,Strong community,2,1.25,0.25,False,False
Shalrak,12,6,18,19,0,Strong community,1,1.0555555555555556,0.05555555555555555,False,False
TheYankunian,11,9,20,16,1,Strong community,4,0.8,0.2,False,False
keIIzzz,15,5,20,19,1,Strong community,1,0.95,0.05,False,False
kickintheball,14,8,22,26,1,Strong community,4,1.1818181818181819,0.18181818181818182,False,False
slo1111,15,14,29,20,0,Strong community,9,0.6896551724137931,0.3103448275862069,False,True
uktabilizard,13,9,22,25,0,Strong community,3,1.1363636363636365,0.13636363636363635,False,False
wildOldcheesecake,15,12,27,27,1,Strong community,0,1.0,0.0,False,False
BlueEyedWalrus84,2,8,10,10,1,Strong community,0,1.0,0.0,False,False
-dag-,10,7,17,15,2,Strong community,2,0.8823529411764706,0.11764705882352941,False,False
0WatcherintheWater0,18,14,32,18,2,Strong community,14,0.5625,0.4375,False,True
AmigoDelDiabla,14,12,26,27,2,Strong community,1,1.0384615384615385,0.038461538461538464,False,False
BitterFuture,45,51,96,91,2,Strong community,5,0.9479166666666666,0.052083333333333336,True,False
BotElMago,27,21,48,43,2,Strong community,5,0.8958333333333334,0.10416666666666667,False,False
BrainDamage2029,25,18,43,42,2,Strong community,1,0.9767441860465116,0.023255813953488372,False,False
Brickscratcher,22,24,46,40,2,Strong community,6,0.8695652173913043,0.13043478260869565,False,False
Davec433,10,2,12,12,2,Strong community,0,1.0,0.0,False,False
DeadlySpacePotatoes,5,5,10,9,2,Strong community,1,0.9,0.1,False,False
Delanorix,27,14,41,36,2,Strong community,5,0.8780487804878049,0.12195121951219512,False,False
Done327,11,3,14,14,2,Strong community,0,1.0,0.0,False,False
FreeStall42,14,14,28,26,2,Strong community,2,0.9285714285714286,0.07142857142857142,False,False
FreedomPocket,7,8,15,14,2,Strong community,1,0.9333333333333333,0.06666666666666667,False,False
GabuEx,20,5,25,15,2,Strong community,10,0.6,0.4,False,True
Gr8daze,4,2,6,6,2,Strong community,0,1.0,0.0,False,False
GuyInAChair,25,15,40,37,2,Strong community,3,0.925,0.075,False,False
Inevitable-Ad-9570,11,9,20,20,2,Strong community,0,1.0,0.0,False,False
ItsMichaelScott25,13,8,21,21,2,Strong community,0,1.0,0.0,False,False
JDogg126,24,15,39,39,2,Strong community,0,1.0,0.0,False,False
KevinCarbonara,49,51,100,98,2,Strong community,2,0.98,0.02,True,False
Leopold_Darkworth,23,13,36,35,2,Strong community,1,0.9722222222222222,0.027777777777777776,False,False
Mjolnir2000,14,7,21,20,2,Strong community,1,0.9523809523809523,0.047619047619047616,False,False
NoAttitude1000,16,12,28,28,2,Strong community,0,1.0,0.0,False,False
PoliticalJunkDrawer,9,5,14,14,2,Strong community,0,1.0,0.0,False,False
Positronic_Matrix,7,5,12,13,2,Strong community,1,1.0833333333333333,0.08333333333333333,False,False
Savethecannolis,10,14,24,24,2,Strong community,0,1.0,0.0,False,False
SchuminWeb,13,15,28,27,2,Strong community,1,0.9642857142857143,0.03571428571428571,False,False
SlowMotionSprint,23,15,38,35,2,Strong community,3,0.9210526315789473,0.07894736842105263,False,False
SparksFly55,49,44,93,93,2,Strong community,0,1.0,0.0,True,False
Tadpoleonicwars,9,5,14,14,2,Strong community,0,1.0,0.0,False,False
TheOvy,20,4,24,26,2,Strong community,2,1.0833333333333333,0.08333333333333333,False,False
The_Awful-Truth,9,46,55,56,2,Strong community,1,1.018181818181818,0.01818181818181818,False,False
Za_Lords_Guard,10,9,19,19,2,Strong community,0,1.0,0.0,False,False
akcrono,5,4,9,9,2,Strong community,0,1.0,0.0,False,False
alexmikli,13,13,26,26,2,Strong community,0,1.0,0.0,False,False
almightywhacko,18,3,21,22,2,Strong community,1,1.0476190476190477,0.047619047619047616,False,False
au-smurf,7,4,11,11,2,Strong community,0,1.0,0.0,False,False
ballmermurland,50,42,92,89,2,Strong community,3,0.967391304347826,0.03260869565217391,True,False
burritoace,15,13,28,28,2,Strong community,0,1.0,0.0,False,False
candre23,23,13,36,34,2,Strong community,2,0.9444444444444444,0.05555555555555555,False,False
che-che-chester,9,8,17,17,2,Strong community,0,1.0,0.0,False,False
clarkision,8,4,12,9,2,Strong community,3,0.75,0.25,False,True
coskibum002,26,19,45,43,2,Strong community,2,0.9555555555555556,0.044444444444444446,False,False
daniel_smith_555,17,8,25,18,2,Strong community,7,0.72,0.28,False,True
dravik,20,9,29,29,2,Strong community,0,1.0,0.0,False,False
foul_ol_ron,8,6,14,14,2,Strong community,0,1.0,0.0,False,False
getawarrantfedboi,7,6,13,12,2,Strong community,1,0.9230769230769231,0.07692307692307693,False,False
harrumphstan,14,11,25,23,2,Strong community,2,0.92,0.08,False,False
j_ly,6,6,12,12,2,Strong community,0,1.0,0.0,False,False
jmac31793,8,5,13,15,2,Strong community,2,1.1538461538461537,0.15384615384615385,False,False
lionhearted318,19,11,30,30,2,Strong community,0,1.0,0.0,False,False
meelar,4,3,7,5,2,Strong community,2,0.7142857142857143,0.2857142857142857,False,False
mosesoperandi,8,8,16,17,2,Strong community,1,1.0625,0.0625,False,False
novagenesis,32,35,67,43,2,Strong community,24,0.6417910447761194,0.3582089552238806,False,True
pgriss,14,8,22,22,2,Strong community,0,1.0,0.0,False,False
rainkloud,11,32,43,45,2,Strong community,2,1.0465116279069768,0.046511627906976744,False,False
repeatoffender123456,19,10,29,23,2,Strong community,6,0.7931034482758621,0.20689655172413793,False,False
spacegamer2000,4,2,6,6,2,Strong community,0,1.0,0.0,False,False
swagonflyyyy,18,8,26,27,2,Strong community,1,1.0384615384615385,0.038461538461538464,False,False
tosser1579,22,11,33,33,2,Strong community,0,1.0,0.0,False,False
unknownpoltroon,19,9,28,22,2,Strong community,6,0.7857142857142857,0.21428571428571427,False,False
veryblanduser,12,4,16,16,2,Strong community,0,1.0,0.0,False,False
wip30ut,15,7,22,23,2,Strong community,1,1.0454545454545454,0.045454545454545456,False,False
woahwoahwoah28,14,10,24,15,0,Strong community,9,0.625,0.375,False,True
Aaron_Hamm,10,7,17,18,1,Strong community,1,1.0588235294117647,0.058823529411764705,False,False
DrEckelschmecker,4,3,7,8,1,Strong community,1,1.1428571428571428,0.14285714285714285,False,False
FactorVerborum,14,6,20,21,1,Strong community,1,1.05,0.05,False,False
Fists_full_of_beers,8,9,17,22,1,Strong community,5,1.2941176470588236,0.29411764705882354,False,True
LDel3,4,1,5,2,25,Noisy community,3,0.4,0.6,False,False
OnlineIsNotAPlace,10,6,16,17,1,Strong community,1,1.0625,0.0625,False,False
SaIemKing,6,2,8,7,1,Strong community,1,0.875,0.125,False,False
YoIronFistBro,6,6,12,12,1,Strong community,0,1.0,0.0,False,False
ZaneBradleyX,4,4,8,9,1,Strong community,1,1.125,0.125,False,False
pulsatingcrocs,8,9,17,2,18,Noisy community,15,0.11764705882352941,0.8823529411764706,False,False
Blurjob1992,4,10,14,13,3,Strong community,1,0.9285714285714286,0.07142857142857142,False,False
DirectAntique,6,6,12,14,3,Strong community,2,1.1666666666666667,0.16666666666666666,False,False
KatzAKat,5,0,5,6,3,Strong community,1,1.2,0.2,False,False
Mysterious_Salt_247,7,6,13,16,3,Strong community,3,1.2307692307692308,0.23076923076923078,False,True
harleybidness,10,2,12,12,3,Strong community,0,1.0,0.0,False,False
lihzee,15,5,20,18,3,Strong community,2,0.9,0.1,False,False
Bonaccorso_di_Novara,2,4,6,9,4,Strong community,3,1.5,0.5,False,True
Fauropitotto,13,10,23,20,4,Strong community,3,0.8695652173913043,0.13043478260869565,True,False
fwubglubbel,8,2,10,10,4,Strong community,0,1.0,0.0,False,False
Bothersome_Wench00,0,5,5,5,5,Strong community,0,1.0,0.0,False,False
Appropriate-Error239,3,1,4,6,5,Strong community,2,1.5,0.5,False,False
ildadof3,7,2,9,9,5,Strong community,0,1.0,0.0,False,False
lennoco,18,25,43,49,0,Strong community,6,1.1395348837209303,0.13953488372093023,False,False
6data,30,23,53,54,0,Strong community,1,1.0188679245283019,0.018867924528301886,False,False
Agreeable_Scar_5274,23,23,46,49,0,Strong community,3,1.065217391304348,0.06521739130434782,False,False
Angsty-Panda,13,8,21,22,0,Strong community,1,1.0476190476190477,0.047619047619047616,False,False
AnimatorDifficult429,18,7,25,9,1,Strong community,16,0.36,0.64,False,True
BitterGas69,18,16,34,34,0,Strong community,0,1.0,0.0,False,False
Black_Diammond,15,8,23,22,0,Strong community,1,0.9565217391304348,0.043478260869565216,False,False
Budget-Attorney,12,9,21,15,0,Strong community,6,0.7142857142857143,0.2857142857142857,False,True
Capable-Art-1972,22,47,69,85,0,Strong community,16,1.2318840579710144,0.2318840579710145,False,True
CaptainMarvelOP,16,4,20,22,0,Strong community,2,1.1,0.1,False,False
ComfortableSurvey815,7,4,11,11,0,Strong community,0,1.0,0.0,False,False
Daruuk,15,7,22,23,0,Strong community,1,1.0454545454545454,0.045454545454545456,False,False
DippyMagee555,11,9,20,20,0,Strong community,0,1.0,0.0,False,False
DrSpaceman575,51,72,123,153,0,Strong community,30,1.2439024390243902,0.24390243902439024,False,True
EarlyInside45,6,3,9,9,0,Strong community,0,1.0,0.0,False,False
Electric-Sheepskin,13,6,19,18,1,Strong community,1,0.9473684210526315,0.05263157894736842,False,False
Frederf220,14,7,21,11,1,Strong community,10,0.5238095238095238,0.47619047619047616,False,True
GrouchNslouch777,7,3,10,8,1,Strong community,2,0.8,0.2,False,False
HauntedReader,20,11,31,32,0,Strong community,1,1.032258064516129,0.03225806451612903,False,False
Hektorlisk,8,9,17,17,0,Strong community,0,1.0,0.0,False,False
HereForTheBoos1013,14,11,25,19,0,Strong community,6,0.76,0.24,False,True
Icerith,15,17,32,33,0,Strong community,1,1.03125,0.03125,False,False
InTheTreeMusic,10,8,18,17,0,Strong community,1,0.9444444444444444,0.05555555555555555,False,False
JakeVanderArkWriter,5,4,9,9,0,Strong community,0,1.0,0.0,False,False
NetEnvironmental6346,15,6,21,22,0,Strong community,1,1.0476190476190477,0.047619047619047616,False,False
Ok_Experience_8006,35,49,84,103,0,Strong community,19,1.2261904761904763,0.2261904761904762,False,True
RotML_Official,6,4,10,10,0,Strong community,0,1.0,0.0,False,False
Sense_Difficult,31,17,48,44,0,Strong community,4,0.9166666666666666,0.08333333333333333,False,False
Simon-Says69,7,10,17,17,0,Strong community,0,1.0,0.0,False,False
Software_Vast,20,17,37,34,0,Strong community,3,0.918918918918919,0.08108108108108109,False,False
T2Drink,15,4,19,19,0,Strong community,0,1.0,0.0,False,False
TheDutchin,13,8,21,19,0,Strong community,2,0.9047619047619048,0.09523809523809523,False,False
UntimelyMeditations,10,15,25,25,0,Strong community,0,1.0,0.0,False,False
Utopia_Builder,35,137,172,184,0,Strong community,12,1.069767441860465,0.06976744186046512,True,False
bismark_dindu_nuffin,8,5,13,14,0,Strong community,1,1.0769230769230769,0.07692307692307693,False,False
captainburger31,11,32,43,29,1,Strong community,14,0.6744186046511628,0.32558139534883723,False,True
ctrldwrdns,5,7,12,2,13,Noisy community,10,0.16666666666666666,0.8333333333333334,False,False
deadairis,9,12,21,18,0,Strong community,3,0.8571428571428571,0.14285714285714285,False,False
fffridayenjoyer,10,9,19,20,0,Strong community,1,1.0526315789473684,0.05263157894736842,False,False
johnwcowan,10,13,23,13,2,Strong community,10,0.5652173913043478,0.43478260869565216,False,True
mayasux,5,3,8,6,0,Strong community,2,0.75,0.25,False,False
melissa_liv,7,6,13,9,0,Strong community,4,0.6923076923076923,0.3076923076923077,False,True
metasekvoia,8,5,13,15,0,Strong community,2,1.1538461538461537,0.15384615384615385,False,False
muffinsballhair,25,20,45,45,0,Strong community,0,1.0,0.0,False,False
onetwo3four5,17,4,21,26,0,Strong community,5,1.2380952380952381,0.23809523809523808,False,True
pinetree1998,3,6,9,7,0,Strong community,2,0.7777777777777778,0.2222222222222222,False,False
throwbackblue,9,16,25,13,1,Strong community,12,0.52,0.48,False,True
Brendan_Frost,8,10,18,20,0,Strong community,2,1.1111111111111112,0.1111111111111111,False,False
B1ackHawk12345,7,1,8,3,39,Noisy community,5,0.375,0.625,False,False
Delli-paper,24,17,41,46,0,Strong community,5,1.1219512195121952,0.12195121951219512,False,False
Insectshelf3,16,13,29,28,0,Strong community,1,0.9655172413793104,0.034482758620689655,False,False
BrightColoursPrime,4,8,12,15,3,Strong community,3,1.25,0.25,False,True
ApocalypseCheerBear,6,3,9,11,3,Strong community,2,1.2222222222222223,0.2222222222222222,False,False
fIumpf,9,4,13,16,3,Strong community,3,1.2307692307692308,0.23076923076923078,False,True
Broad-Hunter-5044,7,18,25,32,0,Strong community,7,1.28,0.28,False,True
Boratssecondwife,16,7,23,26,0,Strong community,3,1.1304347826086956,0.13043478260869565,False,False
Ok-Trade-5937,12,7,19,20,0,Strong community,1,1.0526315789473684,0.05263157894736842,False,False
Pasadenaian,8,2,10,15,0,Strong community,5,1.5,0.5,False,True
KendrickBlack502,5,39,44,30,1,Strong community,14,0.6818181818181818,0.3181818181818182,False,True
WelshBen,6,2,8,11,1,Strong community,3,1.375,0.375,False,True
Bubbly_Ad9068,3,14,17,18,3,Strong community,1,1.0588235294117647,0.058823529411764705,False,False
OldSaggytitBiscuits,10,1,11,12,3,Strong community,1,1.0909090909090908,0.09090909090909091,False,False
Sorry_I_Guess,19,8,27,24,3,Strong community,3,0.8888888888888888,0.1111111111111111,False,False
hopelesscaribou,11,5,16,9,3,Strong community,7,0.5625,0.4375,False,True
BuckeyeReason,2,25,27,29,2,Strong community,2,1.0740740740740742,0.07407407407407407,False,False
HideGPOne,7,4,11,13,2,Strong community,2,1.1818181818181819,0.18181818181818182,False,False
Rastiln,20,14,34,26,2,Strong community,8,0.7647058823529411,0.23529411764705882,False,True
Which-Worth5641,25,28,53,50,2,Strong community,3,0.9433962264150944,0.05660377358490566,False,False
chamrockblarneystone,26,29,55,53,2,Strong community,2,0.9636363636363636,0.03636363636363636,False,False
cp5184,12,8,20,16,2,Strong community,4,0.8,0.2,False,False
danappropriate,7,4,11,10,2,Strong community,1,0.9090909090909091,0.09090909090909091,False,False
help_abalone,20,4,24,16,0,Strong community,8,0.6666666666666666,0.3333333333333333,False,True
mrcsrnne,16,8,24,11,2,Strong community,13,0.4583333333333333,0.5416666666666666,False,True
rookieoo,21,11,32,29,2,Strong community,3,0.90625,0.09375,False,False
BulkyZucchini,7,9,16,23,0,Strong community,7,1.4375,0.4375,False,True
DiverseUse,7,6,13,16,0,Strong community,3,1.2307692307692308,0.23076923076923078,False,True
Business-Stretch2208,16,16,32,39,0,Strong community,7,1.21875,0.21875,False,False
Amazing_Might_9280,6,7,13,14,0,Strong community,1,1.0769230769230769,0.07692307692307693,False,False
Fondacey,14,43,57,33,1,Strong community,24,0.5789473684210527,0.42105263157894735,False,True
SANcapITY,29,22,51,61,0,Strong community,10,1.196078431372549,0.19607843137254902,False,False
CJMakesVideos,4,10,14,16,0,Strong community,2,1.1428571428571428,0.14285714285714285,False,False
EmbarrassedYak968,8,10,18,24,0,Strong community,6,1.3333333333333333,0.3333333333333333,False,True
cbusmatty,9,5,14,16,0,Strong community,2,1.1428571428571428,0.14285714285714285,False,False
Call_It_,5,7,12,14,0,Strong community,2,1.1666666666666667,0.16666666666666666,False,False
DunEmeraldSphere,17,9,26,32,0,Strong community,6,1.2307692307692308,0.23076923076923078,False,True
jimmytaco6,11,6,17,17,0,Strong community,0,1.0,0.0,False,False
o_o_o_f,4,4,8,8,0,Strong community,0,1.0,0.0,False,False
Candle-Jolly,11,38,49,50,2,Strong community,1,1.0204081632653061,0.02040816326530612,False,False
GShermit,7,7,14,14,2,Strong community,0,1.0,0.0,False,False
Hartastic,30,34,64,61,2,Strong community,3,0.953125,0.046875,True,False
Honky_Cat,21,14,35,34,2,Strong community,1,0.9714285714285714,0.02857142857142857,False,False
RocketRelm,34,21,55,38,2,Strong community,17,0.6909090909090909,0.3090909090909091,False,True
arbitrageME,15,7,22,19,2,Strong community,3,0.8636363636363636,0.13636363636363635,False,False
blaqsupaman,9,11,20,20,2,Strong community,0,1.0,0.0,False,False
friedgoldfishsticks,21,19,40,40,2,Strong community,0,1.0,0.0,False,False
gravity_kills,14,12,26,25,2,Strong community,1,0.9615384615384616,0.038461538461538464,False,False
indescipherabled,16,16,32,31,2,Strong community,1,0.96875,0.03125,False,False
littleredpinto,12,8,20,18,2,Strong community,2,0.9,0.1,False,False
Canuck_Voyageur,6,2,8,10,4,Strong community,2,1.25,0.25,False,False
21-characters,13,11,24,12,4,Strong community,12,0.5,0.5,False,True
Pongpianskul,11,3,14,14,4,Strong community,0,1.0,0.0,False,False
Alexandur,8,4,12,11,0,Strong community,1,0.9166666666666666,0.08333333333333333,False,False
Fox_Flame,3,2,5,6,0,Strong community,1,1.2,0.2,False,False
GiveMeAHeartOfFlesh,13,7,20,20,0,Strong community,0,1.0,0.0,False,False
Rakkis157,14,10,24,4,7,Weak community,20,0.16666666666666666,0.8333333333333334,False,True
Recent_Weather2228,11,5,16,19,0,Strong community,3,1.1875,0.1875,False,False
Sigmatronic,3,2,5,6,0,Strong community,1,1.2,0.2,False,False
ToranjaNuclear,21,10,31,33,0,Strong community,2,1.064516129032258,0.06451612903225806,False,False
TripleDoubleFart,8,4,12,10,1,Strong community,2,0.8333333333333334,0.16666666666666666,False,False
jayeffkay,6,6,12,13,0,Strong community,1,1.0833333333333333,0.08333333333333333,False,False
nuggets256,39,23,62,70,0,Strong community,8,1.1290322580645162,0.12903225806451613,True,False
qwertyqyle,8,6,14,16,0,Strong community,2,1.1428571428571428,0.14285714285714285,False,False
tbdabbholm,11,6,17,22,0,Strong community,5,1.2941176470588236,0.29411764705882354,False,True
CardiologistAway9619,54,67,121,144,0,Strong community,23,1.1900826446280992,0.19008264462809918,True,False
ARatOnASinkingShip,29,16,45,49,0,Strong community,4,1.0888888888888888,0.08888888888888889,False,False
Blairians,18,6,24,24,0,Strong community,0,1.0,0.0,False,False
ILikeToJustReadHere,9,6,15,4,8,Weak community,11,0.26666666666666666,0.7333333333333333,False,True
Lorata,6,5,11,13,0,Strong community,2,1.1818181818181819,0.18181818181818182,False,False
Proper_Solid_626,11,26,37,38,0,Strong community,1,1.027027027027027,0.02702702702702703,False,False
Soft_Accountant_7062,25,12,37,41,0,Strong community,4,1.1081081081081081,0.10810810810810811,False,False
Surge_Lv1,12,6,18,12,2,Strong community,6,0.6666666666666666,0.3333333333333333,False,True
Visual-Tangelo1979,18,17,35,37,0,Strong community,2,1.0571428571428572,0.05714285714285714,False,False
scarab456,18,8,26,33,0,Strong community,7,1.2692307692307692,0.2692307692307692,False,True
username_6916,18,7,25,24,0,Strong community,1,0.96,0.04,False,False
Careful_Fondant5453,2,8,10,13,3,Strong community,3,1.3,0.3,False,True
Ok-Raspberry7884,12,12,24,21,3,Strong community,3,0.875,0.125,False,False
Remote-Passenger7880,8,4,12,14,3,Strong community,2,1.1666666666666667,0.16666666666666666,False,False
Spare_Ad5009,10,0,10,13,3,Strong community,3,1.3,0.3,False,False
Careless-Interest-25,24,130,154,152,0,Strong community,2,0.987012987012987,0.012987012987012988,True,False
1isOneshot1,17,8,25,28,0,Strong community,3,1.12,0.12,False,False
7059043,8,5,13,10,2,Strong community,3,0.7692307692307693,0.23076923076923078,False,True
AcceptablePea262,15,8,23,23,0,Strong community,0,1.0,0.0,False,False
Apart_Variation1918,9,9,18,16,0,Strong community,2,0.8888888888888888,0.1111111111111111,False,False
Available_Reveal8068,12,6,18,16,0,Strong community,2,0.8888888888888888,0.1111111111111111,False,False
Baby_Needles,20,18,38,20,2,Strong community,18,0.5263157894736842,0.47368421052631576,False,True
Beastmayonnaise,6,5,11,11,0,Strong community,0,1.0,0.0,False,False
Belisarius9818,8,5,13,14,0,Strong community,1,1.0769230769230769,0.07692307692307693,False,False
Boulange1234,14,3,17,17,0,Strong community,0,1.0,0.0,False,False
Buttcrush1,11,2,13,14,0,Strong community,1,1.0769230769230769,0.07692307692307693,False,False
Charming-Leader-250,9,6,15,13,0,Strong community,2,0.8666666666666667,0.13333333333333333,False,False
DeliciousInterview91,13,60,73,75,0,Strong community,2,1.0273972602739727,0.0273972602739726,True,False
DevA248,10,11,21,21,0,Strong community,0,1.0,0.0,False,False
Edens_dark_garden,5,3,8,4,50,Noisy community,4,0.5,0.5,False,False
ElEsDi_25,8,4,12,13,0,Strong community,1,1.0833333333333333,0.08333333333333333,False,False
Extension_Hand1326,7,6,13,13,0,Strong community,0,1.0,0.0,False,False
Eyesofmalice,6,4,10,8,0,Strong community,2,0.8,0.2,False,False
Fifteen_inches,14,7,21,23,0,Strong community,2,1.0952380952380953,0.09523809523809523,False,False
FragrantPiano9334,5,6,11,8,0,Strong community,3,0.7272727272727273,0.2727272727272727,False,True
Fulgore101,11,9,20,20,0,Strong community,0,1.0,0.0,False,False
Glitchy_XCI,8,7,15,15,0,Strong community,0,1.0,0.0,False,False
GrungleMonke,11,7,18,19,0,Strong community,1,1.0555555555555556,0.05555555555555555,False,False
HiramMcknoxt,16,9,25,25,0,Strong community,0,1.0,0.0,False,False
Imaginary_Exam1068,9,9,18,18,0,Strong community,0,1.0,0.0,False,False
Impossible_Pop620,24,22,46,39,2,Strong community,7,0.8478260869565217,0.15217391304347827,False,False
JAMONLEE,5,5,10,10,0,Strong community,0,1.0,0.0,False,False
LisleAdam12,9,7,16,17,0,Strong community,1,1.0625,0.0625,False,False
Live-Cookie178,11,13,24,3,32,Noisy community,21,0.125,0.875,False,False
Locrian6669,6,6,12,12,0,Strong community,0,1.0,0.0,False,False
Lower_Group_1171,16,5,21,20,0,Strong community,1,0.9523809523809523,0.047619047619047616,False,False
MarkHaversham,17,10,27,27,0,Strong community,0,1.0,0.0,False,False
MaterialLeague1968,14,6,20,21,0,Strong community,1,1.05,0.05,False,False
OnePunchReality,8,3,11,4,50,Noisy community,7,0.36363636363636365,0.6363636363636364,False,False
Oppopity,10,14,24,22,0,Strong community,2,0.9166666666666666,0.08333333333333333,False,False
Peefersteefers,7,4,11,11,0,Strong community,0,1.0,0.0,False,False
PhillipTopicall,5,4,9,9,0,Strong community,0,1.0,0.0,False,False
PopIntelligent9515,10,7,17,15,0,Strong community,2,0.8823529411764706,0.11764705882352941,False,False
Prepared_Noob,3,2,5,2,32,Noisy community,3,0.4,0.6,False,False
Purple_Feedback_1683,3,3,6,6,0,Strong community,0,1.0,0.0,False,False
RadiantHC,10,10,20,20,0,Strong community,0,1.0,0.0,False,False
Rokarion14,5,5,10,10,0,Strong community,0,1.0,0.0,False,False
ShakyTheBear,9,7,16,15,0,Strong community,1,0.9375,0.0625,False,False
Subarctic_Monkey,26,12,38,36,0,Strong community,2,0.9473684210526315,0.05263157894736842,False,False
SuggestionHoliday413,4,19,23,25,0,Strong community,2,1.0869565217391304,0.08695652173913043,False,False
TheMidnightBear,10,6,16,16,0,Strong community,0,1.0,0.0,False,False
Vedic70,12,6,18,19,0,Strong community,1,1.0555555555555556,0.05555555555555555,False,False
WaltEnterprises,13,3,16,11,0,Strong community,5,0.6875,0.3125,False,True
WeakandSlowaf,11,9,20,18,0,Strong community,2,0.9,0.1,False,False
Winter-Hedgehog8969,7,2,9,10,0,Strong community,1,1.1111111111111112,0.1111111111111111,False,False
Wise-Opportunity-294,3,2,5,5,0,Strong community,0,1.0,0.0,False,False
Wooba12,11,6,17,16,0,Strong community,1,0.9411764705882353,0.058823529411764705,False,False
Zauberer-IMDB,11,4,15,15,0,Strong community,0,1.0,0.0,False,False
abstractengineer2000,37,14,51,43,0,Strong community,8,0.8431372549019608,0.1568627450980392,False,False
bfwolf1,12,11,23,22,0,Strong community,1,0.9565217391304348,0.043478260869565216,False,False
blandunoffensivename,10,3,13,16,0,Strong community,3,1.2307692307692308,0.23076923076923078,False,True
cnsreddit,8,3,11,11,0,Strong community,0,1.0,0.0,False,False
djseaneq,5,3,8,8,0,Strong community,0,1.0,0.0,False,False
emp-sup-bry,10,6,16,13,0,Strong community,3,0.8125,0.1875,False,False
ghotier,35,29,64,62,0,Strong community,2,0.96875,0.03125,True,False
haterofslimes,8,6,14,4,50,Noisy community,10,0.2857142857142857,0.7142857142857143,False,False
mark_ik,7,7,14,14,0,Strong community,0,1.0,0.0,False,False
nerfherder616,3,1,4,4,0,Strong community,0,1.0,0.0,False,False
nighthawk_something,6,5,11,11,0,Strong community,0,1.0,0.0,False,False
regolith-terroire,16,10,26,22,2,Strong community,4,0.8461538461538461,0.15384615384615385,False,False
roflchopter11,6,9,15,15,0,Strong community,0,1.0,0.0,False,False
trevor32192,22,17,39,30,0,Strong community,9,0.7692307692307693,0.23076923076923078,False,True
Cartire2,11,13,24,24,0,Strong community,0,1.0,0.0,False,False
CaseInformal4066,16,39,55,57,0,Strong community,2,1.0363636363636364,0.03636363636363636,False,False
Cunderwood2020,9,4,13,7,2,Strong community,6,0.5384615384615384,0.46153846153846156,False,True
Direct_Crew_9949,32,12,44,37,0,Strong community,7,0.8409090909090909,0.1590909090909091,False,False
HevalRizgar,6,5,11,10,0,Strong community,1,0.9090909090909091,0.09090909090909091,False,False
OldAdvertising5963,13,4,17,18,0,Strong community,1,1.0588235294117647,0.058823529411764705,False,False
Standard-Secret-4578,16,9,25,23,0,Strong community,2,0.92,0.08,False,False
TheBouwerie,6,3,9,10,0,Strong community,1,1.1111111111111112,0.1111111111111111,False,False
defaultusername-17,9,7,16,16,0,Strong community,0,1.0,0.0,False,False
quietflyr,5,3,8,8,0,Strong community,0,1.0,0.0,False,False
CashMikey,13,77,90,90,0,Strong community,0,1.0,0.0,True,False
Aceturb,13,7,20,17,0,Strong community,3,0.85,0.15,False,False
Adorable_Ad_3478,10,5,15,15,0,Strong community,0,1.0,0.0,False,False
Aware-Enthusiasm-248,13,3,16,17,0,Strong community,1,1.0625,0.0625,False,False
Eyespop4866,28,6,34,24,0,Strong community,10,0.7058823529411765,0.29411764705882354,False,True
ImReverse_Giraffe,17,10,27,25,0,Strong community,2,0.9259259259259259,0.07407407407407407,False,False
KrabbyMccrab,18,9,27,26,0,Strong community,1,0.9629629629629629,0.037037037037037035,False,False
MantisBuffs,30,50,80,84,0,Strong community,4,1.05,0.05,True,False
NugKnights,28,5,33,32,0,Strong community,1,0.9696969696969697,0.030303030303030304,False,False
Omegoon,8,5,13,13,0,Strong community,0,1.0,0.0,False,False
Random_Guy_12345,18,6,24,22,0,Strong community,2,0.9166666666666666,0.08333333333333333,False,False
Rationally-Skeptical,11,7,18,18,0,Strong community,0,1.0,0.0,False,False
RoundCollection4196,12,6,18,7,4,Strong community,11,0.3888888888888889,0.6111111111111112,False,True
Single_Waltz395,17,6,23,10,1,Strong community,13,0.43478260869565216,0.5652173913043478,False,True
Thin-Management-1960,6,2,8,8,0,Strong community,0,1.0,0.0,False,False
ThrowRACoping,5,1,6,1,12,Weak community,5,0.16666666666666666,0.8333333333333334,False,True
flex_tape_salesman,19,10,29,28,0,Strong community,1,0.9655172413793104,0.034482758620689655,False,False
lainelect,4,3,7,7,0,Strong community,0,1.0,0.0,False,False
shittyopinion1,17,12,29,35,0,Strong community,6,1.206896551724138,0.20689655172413793,False,False
slainascully,18,16,34,33,0,Strong community,1,0.9705882352941176,0.029411764705882353,False,False
CatAndBoots,8,18,26,31,0,Strong community,5,1.1923076923076923,0.19230769230769232,False,False
CallMeCorona1,40,9,49,60,0,Strong community,11,1.2244897959183674,0.22448979591836735,False,True
ImmodestPolitician,17,7,24,24,0,Strong community,0,1.0,0.0,False,False
TehNudel,10,4,14,15,0,Strong community,1,1.0714285714285714,0.07142857142857142,False,False
iglidante,27,18,45,49,0,Strong community,4,1.0888888888888888,0.08888888888888889,False,False
leekeater,18,11,29,26,0,Strong community,3,0.896551724137931,0.10344827586206896,False,False
Cautious-Macaroon713,4,14,18,20,1,Strong community,2,1.1111111111111112,0.1111111111111111,False,False
Acceptable_Fox_5560,8,3,11,8,1,Strong community,3,0.7272727272727273,0.2727272727272727,False,True
PandaMime_421,23,12,35,28,0,Strong community,7,0.8,0.2,False,False
Stunning-Artist-5388,9,2,11,10,1,Strong community,1,0.9090909090909091,0.09090909090909091,False,False
TromosLykos,5,3,8,7,1,Strong community,1,0.875,0.125,False,False
genus-corvidae,27,10,37,40,1,Strong community,3,1.0810810810810811,0.08108108108108109,True,False
undermind84,6,2,8,10,1,Strong community,2,1.25,0.25,False,False
ChallengerDelta,1,6,7,6,3,Strong community,1,0.8571428571428571,0.14285714285714285,False,False
Sami_George,15,10,25,26,3,Strong community,1,1.04,0.04,False,False
joe-h2o,6,3,9,10,3,Strong community,1,1.1111111111111112,0.1111111111111111,False,False
Cheap-Party-0420,4,8,12,15,3,Strong community,3,1.25,0.25,False,True
Deep90,5,3,8,6,3,Strong community,2,0.75,0.25,False,False
lemon_charlie,11,11,22,22,3,Strong community,0,1.0,0.0,False,False
throwaway1975764,9,5,14,15,3,Strong community,1,1.0714285714285714,0.07142857142857142,False,False
Both-Personality7664,26,17,43,46,0,Strong community,3,1.069767441860465,0.06976744186046512,False,False
Desperate-Fan695,23,9,32,39,0,Strong community,7,1.21875,0.21875,False,False
DevinTheGrand,18,12,30,31,0,Strong community,1,1.0333333333333334,0.03333333333333333,False,False
Fluffy_Most_662,25,12,37,39,0,Strong community,2,1.054054054054054,0.05405405405405406,False,False
MaggieMae68,15,10,25,24,0,Strong community,1,0.96,0.04,False,False
Wooden-Ad-3382,9,5,14,17,0,Strong community,3,1.2142857142857142,0.21428571428571427,False,False
coiled-serpent,4,6,10,10,0,Strong community,0,1.0,0.0,False,False
wildfirerain,17,16,33,31,0,Strong community,2,0.9393939393939394,0.06060606060606061,False,False
ChrisRemember,4,8,12,16,1,Strong community,4,1.3333333333333333,0.3333333333333333,False,True
nikhkin,6,3,9,10,1,Strong community,1,1.1111111111111112,0.1111111111111111,False,False
velenom,6,1,7,9,1,Strong community,2,1.2857142857142858,0.2857142857142857,False,False
Chuck_Schuldiner,16,23,39,42,0,Strong community,3,1.0769230769230769,0.07692307692307693,False,False
No-Theme4449,12,6,18,19,0,Strong community,1,1.0555555555555556,0.05555555555555555,False,False
Purple_Wizard,13,9,22,24,0,Strong community,2,1.0909090909090908,0.09090909090909091,False,False
jiminak,9,5,14,15,0,Strong community,1,1.0714285714285714,0.07142857142857142,False,False
Cicity545,8,14,22,29,0,Strong community,7,1.3181818181818181,0.3181818181818182,False,True
Szeto802,20,83,103,106,0,Strong community,3,1.029126213592233,0.02912621359223301,True,False
Trambopoline96,13,9,22,24,0,Strong community,2,1.0909090909090908,0.09090909090909091,False,False
sumoraiden,14,13,27,28,0,Strong community,1,1.037037037037037,0.037037037037037035,False,False
ClarkStunning,23,63,86,99,0,Strong community,13,1.1511627906976745,0.1511627906976744,True,False
AddanDeith,6,5,11,8,0,Strong community,3,0.7272727272727273,0.2727272727272727,False,True
Al-Rediph,17,6,23,29,0,Strong community,6,1.2608695652173914,0.2608695652173913,False,True
Choreopithecus,7,6,13,11,0,Strong community,2,0.8461538461538461,0.15384615384615385,False,False
Curiosity_456,17,25,42,51,0,Strong community,9,1.2142857142857142,0.21428571428571427,False,False
Darkcat9000,12,7,19,19,0,Strong community,0,1.0,0.0,False,False
Hatta00,32,18,50,45,0,Strong community,5,0.9,0.1,False,False
HugsForUpvotes,17,10,27,27,0,Strong community,0,1.0,0.0,False,False
K45AR,9,6,15,15,0,Strong community,0,1.0,0.0,False,False
Low-Appearance4875,18,102,120,115,0,Strong community,5,0.9583333333333334,0.041666666666666664,True,False
N9s8mping,23,62,85,88,0,Strong community,3,1.035294117647059,0.03529411764705882,True,False
North-Tourist-8234,4,3,7,6,1,Strong community,1,0.8571428571428571,0.14285714285714285,False,False
Ok-Pause6148,7,3,10,10,0,Strong community,0,1.0,0.0,False,False
Ok_Climate2983,13,8,21,21,0,Strong community,0,1.0,0.0,False,False
Savings_Art5944,14,3,17,18,0,Strong community,1,1.0588235294117647,0.058823529411764705,False,False
Virtual_Technology_9,5,3,8,9,0,Strong community,1,1.125,0.125,False,False
kiwipixi42,22,9,31,21,1,Strong community,10,0.6774193548387096,0.3225806451612903,False,True
redsnake25,12,6,18,20,0,Strong community,2,1.1111111111111112,0.1111111111111111,False,False
sunburn95,7,6,13,11,0,Strong community,2,0.8461538461538461,0.15384615384615385,False,False
unsureNihilist,11,8,19,17,0,Strong community,2,0.8947368421052632,0.10526315789473684,False,False
ClimberMachinist,4,6,10,15,3,Strong community,5,1.5,0.5,False,True
aemondstareye,9,11,20,22,3,Strong community,2,1.1,0.1,False,False
felice60,5,2,7,9,3,Strong community,2,1.2857142857142858,0.2857142857142857,False,False
CockamouseGoesWee,8,16,24,27,1,Strong community,3,1.125,0.125,False,False
40_degree_rain,7,3,10,11,1,Strong community,1,1.1,0.1,False,False
Buhos_En_Pantelones,11,6,17,18,1,Strong community,1,1.0588235294117647,0.058823529411764705,False,False
Civil-Departure-512,12,4,16,14,1,Strong community,2,0.875,0.125,False,False
Confident-Pepper-562,7,4,11,13,1,Strong community,2,1.1818181818181819,0.18181818181818182,False,False
Lady_White_Heart,4,2,6,7,1,Strong community,1,1.1666666666666667,0.16666666666666666,False,False
PsychologicalLuck343,12,8,20,13,1,Strong community,7,0.65,0.35,False,True
epiDXB,5,3,8,8,1,Strong community,0,1.0,0.0,False,False
zacrl1230,8,3,11,11,1,Strong community,0,1.0,0.0,False,False
Cold_Entry3043,9,49,58,60,0,Strong community,2,1.0344827586206897,0.034482758620689655,False,False
IwantRIFbackdummy,9,8,17,5,20,Noisy community,12,0.29411764705882354,0.7058823529411765,False,False
MediumAids,13,9,22,22,0,Strong community,0,1.0,0.0,False,False
PromptStock5332,15,9,24,22,0,Strong community,2,0.9166666666666666,0.08333333333333333,False,False
Zncon,37,27,64,62,0,Strong community,2,0.96875,0.03125,True,False
nikdahl,15,12,27,13,1,Strong community,14,0.48148148148148145,0.5185185185185185,False,True
seanflyon,21,17,38,48,0,Strong community,10,1.263157894736842,0.2631578947368421,False,True
todudeornote,15,6,21,14,2,Strong community,7,0.6666666666666666,0.3333333333333333,False,True
woailyx,14,8,22,20,0,Strong community,2,0.9090909090909091,0.09090909090909091,False,False
Confused_Firefly,12,14,26,24,0,Strong community,2,0.9230769230769231,0.07692307692307693,False,False
Penarol1916,14,9,23,20,1,Strong community,3,0.8695652173913043,0.13043478260869565,False,False
Confused_Homo-Sapien,4,11,15,13,1,Strong community,2,0.8666666666666667,0.13333333333333333,False,False
Appropriate_Mixer,15,10,25,14,1,Strong community,11,0.56,0.44,False,True
HowAManAimS,8,11,19,14,2,Strong community,5,0.7368421052631579,0.2631578947368421,False,True
klimekam,7,2,9,8,1,Strong community,1,0.8888888888888888,0.1111111111111111,False,False
stairway2evan,6,3,9,3,20,Noisy community,6,0.3333333333333333,0.6666666666666666,False,False
ConsistentPressure79,14,39,53,56,0,Strong community,3,1.0566037735849056,0.05660377358490566,False,False
Anchuinse,8,5,13,16,0,Strong community,3,1.2307692307692308,0.23076923076923078,False,True
BERNthisMuthaDown,9,4,13,13,0,Strong community,0,1.0,0.0,False,False
CarrotcakeSuperSand,18,12,30,32,0,Strong community,2,1.0666666666666667,0.06666666666666667,False,False
Evening-Caramel-6093,12,6,18,18,0,Strong community,0,1.0,0.0,False,False
NeuroticKnight,15,9,24,22,0,Strong community,2,0.9166666666666666,0.08333333333333333,False,False
Pale-Ad9012,13,14,27,31,0,Strong community,4,1.1481481481481481,0.14814814814814814,False,False
Xtergo,6,36,42,41,0,Strong community,1,0.9761904761904762,0.023809523809523808,False,False
chewwydraper,5,3,8,8,0,Strong community,0,1.0,0.0,False,False
impoverishedwhtebrd,6,3,9,9,0,Strong community,0,1.0,0.0,False,False
ContextInner9372,1,3,4,3,5,Strong community,1,0.75,0.25,False,False
Cookiedough1206,3,23,26,23,1,Strong community,3,0.8846153846153846,0.11538461538461539,False,False
Apprehensive_Yak2598,9,4,13,12,1,Strong community,1,0.9230769230769231,0.07692307692307693,False,False
Contemplating_Prison,16,5,21,14,1,Strong community,7,0.6666666666666666,0.3333333333333333,False,True
IamJohnnyHotPants,6,2,8,9,1,Strong community,1,1.125,0.125,False,False
MoultingRoach,12,6,18,18,1,Strong community,0,1.0,0.0,False,False
TheHvam,7,1,8,9,1,Strong community,1,1.125,0.125,False,False
madeat1am,10,4,14,11,7,Weak community,3,0.7857142857142857,0.21428571428571427,False,False
petrichorax,11,11,22,20,1,Strong community,2,0.9090909090909091,0.09090909090909091,False,False
woodwork16,11,3,14,16,1,Strong community,2,1.1428571428571428,0.14285714285714285,False,False
DeathMetal007,29,15,44,45,0,Strong community,1,1.0227272727272727,0.022727272727272728,False,False
Just_a_nonbeliever,13,12,25,26,0,Strong community,1,1.04,0.04,False,False
LocketheAuthentic,6,5,11,13,0,Strong community,2,1.1818181818181819,0.18181818181818182,False,False
Particular-Way-8669,18,9,27,28,0,Strong community,1,1.037037037037037,0.037037037037037035,False,False
Sandaydreamer,8,6,14,14,0,Strong community,0,1.0,0.0,False,False
Serious-Cucumber-54,27,56,83,92,0,Strong community,9,1.108433734939759,0.10843373493975904,True,False
Stock-Film-3609,13,6,19,19,0,Strong community,0,1.0,0.0,False,False
Tessenreacts,33,223,256,244,0,Strong community,12,0.953125,0.046875,True,False
Tinman5278,16,4,20,11,1,Strong community,9,0.55,0.45,False,True
saul_not_goodman,7,7,14,14,0,Strong community,0,1.0,0.0,False,False
bindermichi,5,1,6,6,1,Strong community,0,1.0,0.0,False,False
Busy-Objective5228,8,5,13,3,11,Weak community,10,0.23076923076923078,0.7692307692307693,False,True
Helpful_Loss_3739,18,15,33,43,0,Strong community,10,1.303030303030303,0.30303030303030304,False,True
Intelligent-Cow-7122,4,3,7,2,59,Noisy community,5,0.2857142857142857,0.7142857142857143,False,False
LolaLazuliLapis,15,9,24,17,0,Strong community,7,0.7083333333333334,0.2916666666666667,False,True
MarxCosmo,8,5,13,13,0,Strong community,0,1.0,0.0,False,False
National_Ad_682,10,6,16,16,0,Strong community,0,1.0,0.0,False,False
ObsessedKilljoy,10,6,16,17,0,Strong community,1,1.0625,0.0625,False,False
Roxylius,8,4,12,7,1,Strong community,5,0.5833333333333334,0.4166666666666667,False,True
TheTyger,10,8,18,19,0,Strong community,1,1.0555555555555556,0.05555555555555555,False,False
TomCormack,18,4,22,25,0,Strong community,3,1.1363636363636365,0.13636363636363635,False,False
jawrsh21,12,7,19,14,1,Strong community,5,0.7368421052631579,0.2631578947368421,False,True
juliacar,35,12,47,51,0,Strong community,4,1.0851063829787233,0.0851063829787234,False,False
oppacklij,11,33,44,48,0,Strong community,4,1.0909090909090908,0.09090909090909091,False,False
sir_pirriplin,12,11,23,21,0,Strong community,2,0.9130434782608695,0.08695652173913043,False,False
vettewiz,25,17,42,43,0,Strong community,1,1.0238095238095237,0.023809523809523808,False,False
yankeeboy1865,13,8,21,22,0,Strong community,1,1.0476190476190477,0.047619047619047616,False,False
CreditSuccessful1921,1,9,10,6,22,Noisy community,4,0.6,0.4,False,False
Guilty-Bookkeeper837,3,1,4,1,22,Noisy community,3,0.25,0.75,False,False
Gullible-Minute-9482,3,2,5,1,22,Noisy community,4,0.2,0.8,False,False
Man_under_Bridge420,1,0,1,1,22,Noisy community,0,1.0,0.0,False,False
Unusual_Potato9485,7,4,11,11,1,Strong community,0,1.0,0.0,False,False
pyramidalembargo,8,5,13,1,22,Noisy community,12,0.07692307692307693,0.9230769230769231,False,False
Creedsman03,4,17,21,23,0,Strong community,2,1.0952380952380953,0.09523809523809523,False,False
Crowdev1138,17,45,62,52,3,Strong community,10,0.8387096774193549,0.16129032258064516,True,False
Electronic-Poet-1328,9,8,17,9,3,Strong community,8,0.5294117647058824,0.47058823529411764,False,True
Exotic-Knowledge-243,16,9,25,25,3,Strong community,0,1.0,0.0,False,False
MystifiedByPeople,11,10,21,20,3,Strong community,1,0.9523809523809523,0.047619047619047616,False,False
NoSignSaysNo,10,8,18,19,3,Strong community,1,1.0555555555555556,0.05555555555555555,False,False
NomadicusRex,9,7,16,16,3,Strong community,0,1.0,0.0,False,False
SecretRecipe,6,2,8,4,5,Strong community,4,0.5,0.5,False,True
SophisticatedScreams,12,9,21,4,6,Weak community,17,0.19047619047619047,0.8095238095238095,False,True
StructEngineer91,6,2,8,8,3,Strong community,0,1.0,0.0,False,False
Sweeper1985,10,4,14,2,40,Noisy community,12,0.14285714285714285,0.8571428571428571,False,False
Tight_Jaguar_3881,10,5,15,15,3,Strong community,0,1.0,0.0,False,False
beckdawg19,6,5,11,12,3,Strong community,1,1.0909090909090908,0.09090909090909091,False,False
flowerybutterfly96,9,4,13,14,3,Strong community,1,1.0769230769230769,0.07692307692307693,False,False
jindoowner,7,2,9,7,3,Strong community,2,0.7777777777777778,0.2222222222222222,False,False
loki2002,16,29,45,28,1,Strong community,17,0.6222222222222222,0.37777777777777777,False,True
shelwood46,24,7,31,31,3,Strong community,0,1.0,0.0,False,False
sheramom4,7,4,11,11,3,Strong community,0,1.0,0.0,False,False
swillshop,19,0,19,20,3,Strong community,1,1.0526315789473684,0.05263157894736842,False,False
thieh,6,4,10,10,0,Strong community,0,1.0,0.0,False,False
wesmorgan1,12,8,20,15,3,Strong community,5,0.75,0.25,False,True
Cultural-Tutor-2260,7,37,44,30,1,Strong community,14,0.6818181818181818,0.3181818181818182,False,True
Agreetedboat123,12,15,27,23,0,Strong community,4,0.8518518518518519,0.14814814814814814,False,False
DowntownManThrow,13,21,34,42,0,Strong community,8,1.2352941176470589,0.23529411764705882,False,True
Hawk13424,10,6,16,16,1,Strong community,0,1.0,0.0,False,False
Letshavemorefun,38,23,61,59,0,Strong community,2,0.9672131147540983,0.03278688524590164,False,False
New_Construction_111,4,3,7,7,1,Strong community,0,1.0,0.0,False,False
YnotBbrave,20,9,29,23,2,Strong community,6,0.7931034482758621,0.20689655172413793,False,False
fryerandice,6,3,9,10,1,Strong community,1,1.1111111111111112,0.1111111111111111,False,False
xukly,5,2,7,6,1,Strong community,1,0.8571428571428571,0.14285714285714285,False,False
Archophob,18,12,30,28,0,Strong community,2,0.9333333333333333,0.06666666666666667,False,False
BBQ_game_COCKS,7,5,12,2,33,Noisy community,10,0.16666666666666666,0.8333333333333334,False,False
Bolognahole_Vers2,23,16,39,18,1,Strong community,21,0.46153846153846156,0.5384615384615384,False,True
Business-Adagio6032,7,2,9,11,0,Strong community,2,1.2222222222222223,0.2222222222222222,False,False
ButterscotchLow7330,12,10,22,16,0,Strong community,6,0.7272727272727273,0.2727272727272727,False,True
Careful_Abroad7511,18,6,24,24,0,Strong community,0,1.0,0.0,False,False
CnC-223,28,17,45,51,0,Strong community,6,1.1333333333333333,0.13333333333333333,False,False
DrFabio23,17,7,24,28,0,Strong community,4,1.1666666666666667,0.16666666666666666,False,False
DutchDave87,6,3,9,8,0,Strong community,1,0.8888888888888888,0.1111111111111111,False,False
EasyAsaparagus,19,15,34,36,0,Strong community,2,1.0588235294117647,0.058823529411764705,False,False
Eodbatman,11,4,15,16,0,Strong community,1,1.0666666666666667,0.06666666666666667,False,False
FiendishNoodles,16,16,32,31,0,Strong community,1,0.96875,0.03125,False,False
H4RN4SS,18,16,34,39,0,Strong community,5,1.1470588235294117,0.14705882352941177,False,False
Jelly_bean82,11,5,16,15,0,Strong community,1,0.9375,0.0625,False,False
JeruTz,21,12,33,34,0,Strong community,1,1.0303030303030303,0.030303030303030304,False,False
Lagkiller,17,10,27,27,0,Strong community,0,1.0,0.0,False,False
LycheeRoutine3959,21,15,36,33,0,Strong community,3,0.9166666666666666,0.08333333333333333,False,False
No-Cauliflower8890,17,14,31,35,0,Strong community,4,1.1290322580645162,0.12903225806451613,False,False
NoWhySkillIssueBussy,17,12,29,27,0,Strong community,2,0.9310344827586207,0.06896551724137931,False,False
Obi-Brawn-Kenobi,12,10,22,20,0,Strong community,2,0.9090909090909091,0.09090909090909091,False,False
PuckSenior,31,21,52,54,0,Strong community,2,1.0384615384615385,0.038461538461538464,False,False
PuddleOfHamster,4,2,6,3,3,Strong community,3,0.5,0.5,False,True
QuesoStain2,9,6,15,15,0,Strong community,0,1.0,0.0,False,False
RemoteCompetitive688,24,15,39,41,0,Strong community,2,1.0512820512820513,0.05128205128205128,False,False
Riflemate,9,4,13,15,0,Strong community,2,1.1538461538461537,0.15384615384615385,False,False
Sharp_Bet_8181,7,7,14,14,0,Strong community,0,1.0,0.0,False,False
Stunning-Drawing8240,8,6,14,3,12,Weak community,11,0.21428571428571427,0.7857142857142857,False,True
TotaLibertarian,16,16,32,32,0,Strong community,0,1.0,0.0,False,False
Tullyswimmer,23,17,40,41,0,Strong community,1,1.025,0.025,False,False
UltimaGabe,6,4,10,8,0,Strong community,2,0.8,0.2,False,False
Unique_Statement7811,17,15,32,23,0,Strong community,9,0.71875,0.28125,False,True
Vegetable-Two-4644,8,7,15,13,0,Strong community,2,0.8666666666666667,0.13333333333333333,False,False
courtd93,17,13,30,31,0,Strong community,1,1.0333333333333334,0.03333333333333333,False,False
fizzmore,11,6,17,17,0,Strong community,0,1.0,0.0,False,False
happyinheart,17,10,27,29,0,Strong community,2,1.0740740740740742,0.07407407407407407,False,False
hatlock,14,17,31,30,0,Strong community,1,0.967741935483871,0.03225806451612903,False,False
kwamzilla,20,12,32,29,0,Strong community,3,0.90625,0.09375,False,False
laz1b01,15,7,22,23,0,Strong community,1,1.0454545454545454,0.045454545454545456,False,False
michaelochurch,19,11,30,32,0,Strong community,2,1.0666666666666667,0.06666666666666667,False,False
mikehocalate,4,35,39,39,0,Strong community,0,1.0,0.0,False,False
pastimereading,5,15,20,20,1,Strong community,0,1.0,0.0,False,False
revilocaasi,18,11,29,29,0,Strong community,0,1.0,0.0,False,False
throwawaydanc3rrr,30,9,39,40,0,Strong community,1,1.0256410256410255,0.02564102564102564,False,False
turboprancer,16,19,35,39,0,Strong community,4,1.1142857142857143,0.11428571428571428,False,False
DahliaB85,1,4,5,3,5,Strong community,2,0.6,0.4,False,False
Square-Dragonfruit76,40,64,104,118,0,Strong community,14,1.1346153846153846,0.1346153846153846,True,False
Swimreadmed,8,4,12,15,0,Strong community,3,1.25,0.25,False,True
favorable_vampire,17,19,36,35,0,Strong community,1,0.9722222222222222,0.027777777777777776,False,False
Curiousman1911,3,56,59,64,2,Strong community,5,1.0847457627118644,0.0847457627118644,False,False
-Foxer,18,12,30,22,2,Strong community,8,0.7333333333333333,0.26666666666666666,False,True
Dineology,17,6,23,21,2,Strong community,2,0.9130434782608695,0.08695652173913043,False,False
Feisty-Elderberry898,12,4,16,17,2,Strong community,1,1.0625,0.0625,False,False
Fromage_Frey,13,11,24,24,2,Strong community,0,1.0,0.0,False,False
Hautamaki,6,7,13,14,2,Strong community,1,1.0769230769230769,0.07692307692307693,False,False
Idk_Very_Much,13,5,18,19,2,Strong community,1,1.0555555555555556,0.05555555555555555,False,False
ImDeputyDurland,5,2,7,4,41,Noisy community,3,0.5714285714285714,0.42857142857142855,False,False
KingKnotts,25,27,52,52,2,Strong community,0,1.0,0.0,False,False
LookAtMeNow247,11,8,19,18,2,Strong community,1,0.9473684210526315,0.05263157894736842,False,False
MrMrLavaLava,8,5,13,14,2,Strong community,1,1.0769230769230769,0.07692307692307693,False,False
PolicyWonka,10,4,14,14,2,Strong community,0,1.0,0.0,False,False
ThePoppaJ,5,4,9,2,41,Noisy community,7,0.2222222222222222,0.7777777777777778,False,False
TheSameGamer651,14,14,28,27,2,Strong community,1,0.9642857142857143,0.03571428571428571,False,False
The_B_Wolf,60,21,81,62,2,Strong community,19,0.7654320987654321,0.2345679012345679,False,True
Tliish,24,11,35,33,2,Strong community,2,0.9428571428571428,0.05714285714285714,False,False
bomerr,4,2,6,6,2,Strong community,0,1.0,0.0,False,False
cakeandale,17,7,24,22,2,Strong community,2,0.9166666666666666,0.08333333333333333,False,False
illegalmorality,9,18,27,28,2,Strong community,1,1.037037037037037,0.037037037037037035,False,False
kerouacrimbaud,7,6,13,12,2,Strong community,1,0.9230769230769231,0.07692307692307693,False,False
mormagils,19,11,30,22,2,Strong community,8,0.7333333333333333,0.26666666666666666,False,True
wedgebert,10,8,18,13,2,Strong community,5,0.7222222222222222,0.2777777777777778,False,True
Current-Director-875,35,28,63,75,0,Strong community,12,1.1904761904761905,0.19047619047619047,True,False
LamdasNo,12,19,31,44,0,Strong community,13,1.4193548387096775,0.41935483870967744,False,True
DIXi3N0rMu5,10,84,94,68,0,Strong community,26,0.723404255319149,0.2765957446808511,False,True
CrowsSayCawCaw,7,2,9,7,0,Strong community,2,0.7777777777777778,0.2222222222222222,False,False
Electrical-Type-6150,4,3,7,2,8,Weak community,5,0.2857142857142857,0.7142857142857143,False,True
Happy_Food9190,17,91,108,119,0,Strong community,11,1.1018518518518519,0.10185185185185185,True,False
Hold-Professional,29,11,40,43,1,Strong community,3,1.075,0.075,True,False
IBribeMyBF,9,15,24,26,0,Strong community,2,1.0833333333333333,0.08333333333333333,False,False
LaconicGirth,15,11,26,22,1,Strong community,4,0.8461538461538461,0.15384615384615385,False,False
MikeUsesNotion,19,11,30,28,1,Strong community,2,0.9333333333333333,0.06666666666666667,False,False
Nuthetes,8,3,11,10,1,Strong community,1,0.9090909090909091,0.09090909090909091,False,False
PeteMichaud,14,6,20,18,0,Strong community,2,0.9,0.1,False,False
Rag3asy33,7,4,11,8,1,Strong community,3,0.7272727272727273,0.2727272727272727,False,True
Raise_A_Thoth,18,13,31,32,0,Strong community,1,1.032258064516129,0.03225806451612903,False,False
Thortok2000,9,5,14,15,0,Strong community,1,1.0714285714285714,0.07142857142857142,False,False
Various_Succotash_79,10,9,19,19,0,Strong community,0,1.0,0.0,False,False
Wic-a-ding-dong,11,10,21,19,0,Strong community,2,0.9047619047619048,0.09523809523809523,False,False
_Dingaloo,11,10,21,19,0,Strong community,2,0.9047619047619048,0.09523809523809523,False,False
_robjamesmusic,12,14,26,26,0,Strong community,0,1.0,0.0,False,False
cs_____question1031,6,24,30,25,1,Strong community,5,0.8333333333333334,0.16666666666666666,False,False
doggo816,11,8,19,20,0,Strong community,1,1.0526315789473684,0.05263157894736842,False,False
draculabakula,9,6,15,17,0,Strong community,2,1.1333333333333333,0.13333333333333333,False,False
go_fly_a_kite,7,4,11,11,0,Strong community,0,1.0,0.0,False,False
insaneHoshi,16,15,31,32,0,Strong community,1,1.032258064516129,0.03225806451612903,False,False
noonefuckslikegaston,18,16,34,17,1,Strong community,17,0.5,0.5,False,True
pipboy_warrior,13,10,23,21,1,Strong community,2,0.9130434782608695,0.08695652173913043,False,False
skysinsane,22,21,43,41,0,Strong community,2,0.9534883720930233,0.046511627906976744,False,False
yea_i_doubt_that,16,6,22,5,25,Noisy community,17,0.22727272727272727,0.7727272727272727,False,False
The_Black_Adder_,6,6,12,12,0,Strong community,0,1.0,0.0,False,False
RusticBucket2,5,1,6,4,5,Strong community,2,0.6666666666666666,0.3333333333333333,False,False
DaleRod2468,3,8,11,6,16,Noisy community,5,0.5454545454545454,0.45454545454545453,False,False
Advanced-Ad6210,6,5,11,2,16,Noisy community,9,0.18181818181818182,0.8181818181818182,False,False
automaks,5,3,8,3,16,Noisy community,5,0.375,0.625,False,False
DanaTheCelery,4,27,31,34,2,Strong community,3,1.096774193548387,0.0967741935483871,False,False
214ObstructedReverie,16,11,27,27,2,Strong community,0,1.0,0.0,False,False
FancyyPelosi,10,9,19,17,2,Strong community,2,0.8947368421052632,0.10526315789473684,False,False
Gta6MePleaseBrigade,17,10,27,28,2,Strong community,1,1.037037037037037,0.037037037037037035,False,False
LiberalArtsAndCrafts,20,8,28,26,0,Strong community,2,0.9285714285714286,0.07142857142857142,False,False
demihope,13,7,20,21,2,Strong community,1,1.05,0.05,False,False
nickcan,7,8,15,12,2,Strong community,3,0.8,0.2,False,False
spam__likely,16,13,29,28,2,Strong community,1,0.9655172413793104,0.034482758620689655,False,False
wellwisher-1,27,12,39,38,2,Strong community,1,0.9743589743589743,0.02564102564102564,False,False
Daniel_Kendall,12,17,29,44,0,Strong community,15,1.5172413793103448,0.5172413793103449,False,True
FaceInJuice,3,3,6,9,0,Strong community,3,1.5,0.5,False,True
Wonderful-Effort-466,12,1,13,14,0,Strong community,1,1.0769230769230769,0.07692307692307693,False,False
acesoverking,22,18,40,48,0,Strong community,8,1.2,0.2,False,False
Danny_DeWario,2,7,9,11,0,Strong community,2,1.2222222222222223,0.2222222222222222,False,False
InspectionDirection,45,32,77,75,0,Strong community,2,0.974025974025974,0.025974025974025976,True,False
LUL_Level-Up-Life,9,10,19,23,0,Strong community,4,1.2105263157894737,0.21052631578947367,False,False
CyclopsRock,10,5,15,17,0,Strong community,2,1.1333333333333333,0.13333333333333333,False,False
DrawingOverall4306,23,9,32,34,0,Strong community,2,1.0625,0.0625,False,False
Ignore-Me_-,9,10,19,18,0,Strong community,1,0.9473684210526315,0.05263157894736842,False,False
Darnitol1,6,4,10,12,1,Strong community,2,1.2,0.2,False,False
DeathStrike56,8,10,18,20,0,Strong community,2,1.1111111111111112,0.1111111111111111,False,False
Agitated-Quit-6148,8,5,13,14,0,Strong community,1,1.0769230769230769,0.07692307692307693,False,False
No-Dinner-5894,14,8,22,20,0,Strong community,2,0.9090909090909091,0.09090909090909091,False,False
ObsidianKing,4,3,7,2,40,Noisy community,5,0.2857142857142857,0.7142857142857143,False,False
welltechnically7,8,3,11,16,0,Strong community,5,1.4545454545454546,0.45454545454545453,False,True
Deep-Engine2367,3,8,11,15,0,Strong community,4,1.3636363636363635,0.36363636363636365,False,True
Hefty-Reaction-3028,18,12,30,28,0,Strong community,2,0.9333333333333333,0.06666666666666667,False,False
PandaDerZwote,13,6,19,23,0,Strong community,4,1.2105263157894737,0.21052631578947367,False,False
Paper-Dramatic,24,154,178,172,0,Strong community,6,0.9662921348314607,0.033707865168539325,True,False
VforVenndiagram_,11,5,16,19,0,Strong community,3,1.1875,0.1875,False,False
Deep-Two7452,31,67,98,124,0,Strong community,26,1.2653061224489797,0.2653061224489796,False,True
Bitter-Assignment464,19,10,29,17,0,Strong community,12,0.5862068965517241,0.41379310344827586,False,True
Chowderr92,19,14,33,35,0,Strong community,2,1.0606060606060606,0.06060606060606061,False,False
Confident-Staff-8792,12,1,13,16,0,Strong community,3,1.2307692307692308,0.23076923076923078,False,True
Free-Database-9917,18,19,37,48,0,Strong community,11,1.2972972972972974,0.2972972972972973,False,True
GOT_Wyvern,12,7,19,19,0,Strong community,0,1.0,0.0,False,False
Gertrude_D,20,9,29,10,2,Strong community,19,0.3448275862068966,0.6551724137931034,False,True
JustifiedSinner01,6,4,10,11,0,Strong community,1,1.1,0.1,False,False
MajorPayne1911,15,28,43,43,0,Strong community,0,1.0,0.0,False,False
MyNameIsNotKyle,14,10,24,26,0,Strong community,2,1.0833333333333333,0.08333333333333333,False,False
Outcast129,11,4,15,17,0,Strong community,2,1.1333333333333333,0.13333333333333333,False,False
PIE-314,12,9,21,16,0,Strong community,5,0.7619047619047619,0.23809523809523808,False,True
RequirementRoyal8666,38,20,58,57,0,Strong community,1,0.9827586206896551,0.017241379310344827,False,False
Veritas_the_absolute,4,3,7,9,0,Strong community,2,1.2857142857142858,0.2857142857142857,False,False
Yippykyyyay,8,8,16,4,8,Weak community,12,0.25,0.75,False,True
humanino,9,7,16,17,0,Strong community,1,1.0625,0.0625,False,False
underboobfunk,16,8,24,21,0,Strong community,3,0.875,0.125,False,False
walkaroundmoney,9,3,12,15,0,Strong community,3,1.25,0.25,False,True
wuzxonrs,8,3,11,13,0,Strong community,2,1.1818181818181819,0.18181818181818182,False,False
AcanthocephalaLow502,5,5,10,4,3,Strong community,6,0.4,0.6,False,True
Conscious_Pen_3485,17,13,30,27,0,Strong community,3,0.9,0.1,False,False
Cool-Expression-4727,17,9,26,24,0,Strong community,2,0.9230769230769231,0.07692307692307693,False,False
Garganello,3,5,8,7,0,Strong community,1,0.875,0.125,False,False
GnomeChompskie,8,7,15,15,0,Strong community,0,1.0,0.0,False,False
LevelDry5807,11,11,22,26,0,Strong community,4,1.1818181818181819,0.18181818181818182,False,False
Realitymatter,5,4,9,9,0,Strong community,0,1.0,0.0,False,False
RebornGod,12,6,18,13,0,Strong community,5,0.7222222222222222,0.2777777777777778,False,True
Shadow42184,7,16,23,30,0,Strong community,7,1.3043478260869565,0.30434782608695654,False,True
SpotResident6135,12,8,20,20,0,Strong community,0,1.0,0.0,False,False
Taidixiong,13,6,19,15,0,Strong community,4,0.7894736842105263,0.21052631578947367,False,False
WillyShankspeare,16,10,26,28,0,Strong community,2,1.0769230769230769,0.07692307692307693,False,False
freakydeku,7,9,16,16,0,Strong community,0,1.0,0.0,False,False
illiter-it,9,32,41,41,0,Strong community,0,1.0,0.0,False,False
kittenTakeover,25,4,29,18,0,Strong community,11,0.6206896551724138,0.3793103448275862,False,True
Delicious_Delilah,2,22,24,26,1,Strong community,2,1.0833333333333333,0.08333333333333333,False,False
Aggravating_Kale8248,13,1,14,13,1,Strong community,1,0.9285714285714286,0.07142857142857142,False,False
GovernmentChance4182,4,12,16,15,1,Strong community,1,0.9375,0.0625,False,False
OceanBlueSeaTurtle,7,4,11,11,0,Strong community,0,1.0,0.0,False,False
Ok-Cardiologist8717,9,33,42,45,1,Strong community,3,1.0714285714285714,0.07142857142857142,False,False
cib0hph0bic,4,21,25,21,1,Strong community,4,0.84,0.16,False,False
godammitdonut,5,3,8,9,1,Strong community,1,1.125,0.125,False,False
java_sloth,5,7,12,12,1,Strong community,0,1.0,0.0,False,False
steelthyshovel73,4,2,6,6,1,Strong community,0,1.0,0.0,False,False
Wonderful-Group-8502,5,4,9,9,0,Strong community,0,1.0,0.0,False,False
Wooden_Ad_1019,12,29,41,48,0,Strong community,7,1.170731707317073,0.17073170731707318,False,False
bastiancontrari,12,7,19,18,0,Strong community,1,0.9473684210526315,0.05263157894736842,False,False
coleman57,12,5,17,1,42,Noisy community,16,0.058823529411764705,0.9411764705882353,False,False
ethanb473,16,4,20,16,0,Strong community,4,0.8,0.2,False,False
ghoulthebraineater,4,2,6,3,1,Strong community,3,0.5,0.5,False,True
sirswantepalm,24,33,57,29,2,Strong community,28,0.5087719298245614,0.49122807017543857,False,True
Designer-Chance-3590,4,20,24,27,1,Strong community,3,1.125,0.125,False,False
HR_King,7,3,10,12,1,Strong community,2,1.2,0.2,False,False
KrisHughes2,9,17,26,24,1,Strong community,2,0.9230769230769231,0.07692307692307693,False,False
LughCrow,14,5,19,23,1,Strong community,4,1.2105263157894737,0.21052631578947367,False,False
Particular_Can_7726,13,5,18,16,1,Strong community,2,0.8888888888888888,0.1111111111111111,False,False
Desperate_Donkey2212,8,24,32,37,3,Strong community,5,1.15625,0.15625,False,False
Permit-Extreme-117,16,18,34,34,3,Strong community,0,1.0,0.0,True,False
R4eth,21,6,27,28,3,Strong community,1,1.037037037037037,0.037037037037037035,False,False
darkd360,7,6,13,11,3,Strong community,2,0.8461538461538461,0.15384615384615385,False,False
roseofjuly,14,5,19,17,3,Strong community,2,0.8947368421052632,0.10526315789473684,False,False
Disastrous-Fact-7782,12,21,33,38,0,Strong community,5,1.1515151515151516,0.15151515151515152,False,False
LongRest,11,4,15,18,0,Strong community,3,1.2,0.2,False,False
asr,14,8,22,22,0,Strong community,0,1.0,0.0,False,False
DisastrousClerk216,10,34,44,42,3,Strong community,2,0.9545454545454546,0.045454545454545456,True,False
Cakeday_at_Christmas,5,7,12,10,3,Strong community,2,0.8333333333333334,0.16666666666666666,False,False
Dizzy_Needleworker_3,16,14,30,31,3,Strong community,1,1.0333333333333334,0.03333333333333333,True,False
Intelligent_Arm_9241,7,2,9,9,3,Strong community,0,1.0,0.0,False,False
MACRS_or_Break,4,1,5,5,3,Strong community,0,1.0,0.0,False,False
No-Giraffe49,11,1,12,11,3,Strong community,1,0.9166666666666666,0.08333333333333333,False,False
SalaudChaud,8,1,9,9,3,Strong community,0,1.0,0.0,False,False
Smarterthanuthink867,8,6,14,16,3,Strong community,2,1.1428571428571428,0.14285714285714285,False,False
Super_Selection1522,5,1,6,3,3,Strong community,3,0.5,0.5,False,True
TheFilthyDIL,8,2,10,12,3,Strong community,2,1.2,0.2,False,False
keesouth,17,8,25,29,3,Strong community,4,1.16,0.16,False,False
Disastrous_Onion_958,7,12,19,27,0,Strong community,8,1.4210526315789473,0.42105263157894735,False,True
Frylock304,18,16,34,35,0,Strong community,1,1.0294117647058822,0.029411764705882353,False,False
Disastrous_Wave1283,5,19,24,26,0,Strong community,2,1.0833333333333333,0.08333333333333333,False,False
TheAzureMage,18,14,32,35,0,Strong community,3,1.09375,0.09375,False,False
Dismal-Ninja6343,3,14,17,21,3,Strong community,4,1.2352941176470589,0.23529411764705882,False,True
Accurate-Signature55,8,7,15,15,3,Strong community,0,1.0,0.0,False,False
EwwDavvidd,5,1,6,7,3,Strong community,1,1.1666666666666667,0.16666666666666666,False,False
LogicalHoney4689,3,2,5,5,3,Strong community,0,1.0,0.0,False,False
SaraAB87,6,4,10,10,3,Strong community,0,1.0,0.0,False,False
hamdinger125,7,10,17,17,3,Strong community,0,1.0,0.0,False,False
Dogago19,4,4,8,7,1,Strong community,1,0.875,0.125,False,False
Donkletown,45,64,109,115,0,Strong community,6,1.055045871559633,0.05504587155963303,True,False
AnimateDuckling,11,4,15,17,0,Strong community,2,1.1333333333333333,0.13333333333333333,False,False
EH1987,13,9,22,20,0,Strong community,2,0.9090909090909091,0.09090909090909091,False,False
FriendofMolly,12,47,59,65,0,Strong community,6,1.1016949152542372,0.1016949152542373,True,False
JJ_Redditer,27,69,96,95,0,Strong community,1,0.9895833333333334,0.010416666666666666,True,False
Least_Inspector_5478,7,14,21,27,0,Strong community,6,1.2857142857142858,0.2857142857142857,False,True
Technical-King-1412,23,16,39,37,0,Strong community,2,0.9487179487179487,0.05128205128205128,False,False
Traditional_Still960,4,5,9,8,0,Strong community,1,0.8888888888888888,0.1111111111111111,False,False
dickermuffer,18,10,28,29,0,Strong community,1,1.0357142857142858,0.03571428571428571,False,False
fuggitdude22,15,2,17,12,0,Strong community,5,0.7058823529411765,0.29411764705882354,False,True
kjj34,33,17,50,51,0,Strong community,1,1.02,0.02,False,False
somefunmaths,8,7,15,17,0,Strong community,2,1.1333333333333333,0.13333333333333333,False,False
tarkinn,4,4,8,9,0,Strong community,1,1.125,0.125,False,False
Ancient_Confusion237,16,10,26,29,0,Strong community,3,1.1153846153846154,0.11538461538461539,False,False
IT_ServiceDesk,33,13,46,46,0,Strong community,0,1.0,0.0,False,False
JaggedMetalOs,14,6,20,26,0,Strong community,6,1.3,0.3,False,True
Acrobatic-Hippo-6419,10,6,16,13,0,Strong community,3,0.8125,0.1875,False,False
Bitter_Detective4719,4,4,8,10,0,Strong community,2,1.25,0.25,False,False
Eldritch_Chemistry,7,3,10,10,0,Strong community,0,1.0,0.0,False,False
JRDZ1993,9,3,12,12,0,Strong community,0,1.0,0.0,False,False
Low_Imagination_1224,17,18,35,43,0,Strong community,8,1.2285714285714286,0.22857142857142856,False,True
Mcwedlav,9,4,13,14,0,Strong community,1,1.0769230769230769,0.07692307692307693,False,False
Proof-Technician-202,14,6,20,17,0,Strong community,3,0.85,0.15,False,False
Puresuner,6,5,11,11,0,Strong community,0,1.0,0.0,False,False
RareMajority,9,5,14,14,0,Strong community,0,1.0,0.0,False,False
Research_Matters,6,5,11,11,0,Strong community,0,1.0,0.0,False,False
Skwiish,5,3,8,8,0,Strong community,0,1.0,0.0,False,False
TVC_i5,9,6,15,15,0,Strong community,0,1.0,0.0,False,False
Tea-Unlucky,6,3,9,9,0,Strong community,0,1.0,0.0,False,False
Timely-Way-4923,29,44,73,87,0,Strong community,14,1.1917808219178083,0.1917808219178082,True,False
Wayoutofthewayof,7,4,11,12,0,Strong community,1,1.0909090909090908,0.09090909090909091,False,False
Xepherya,16,6,22,12,1,Strong community,10,0.5454545454545454,0.45454545454545453,False,True
bigbjarne,5,6,11,11,0,Strong community,0,1.0,0.0,False,False
kinrove1386,15,13,28,28,0,Strong community,0,1.0,0.0,False,False
lastberserker,23,19,42,43,0,Strong community,1,1.0238095238095237,0.023809523809523808,False,False
mutantraniE,15,12,27,29,0,Strong community,2,1.0740740740740742,0.07407407407407407,False,False
rpolkcz,10,8,18,19,0,Strong community,1,1.0555555555555556,0.05555555555555555,False,False
vllaznia35,25,88,113,125,0,Strong community,12,1.1061946902654867,0.10619469026548672,True,False
Fun_Squirrel_9539,3,3,6,7,0,Strong community,1,1.1666666666666667,0.16666666666666666,False,False
LookWhatlCanDo,3,3,6,7,0,Strong community,1,1.1666666666666667,0.16666666666666666,False,False
Barqa,12,7,19,19,0,Strong community,0,1.0,0.0,False,False
DiscordianDreams,5,3,8,9,0,Strong community,1,1.125,0.125,False,False
HiHoJufro,13,7,20,18,0,Strong community,2,0.9,0.1,False,False
LvL98MissingNo,8,5,13,14,0,Strong community,1,1.0769230769230769,0.07692307692307693,False,False
Red_Canuck,5,3,8,9,0,Strong community,1,1.125,0.125,False,False
Retr0r0cketVersion2,5,4,9,10,0,Strong community,1,1.1111111111111112,0.1111111111111111,False,False
Treon_Lotsky,16,7,23,29,0,Strong community,6,1.2608695652173914,0.2608695652173913,False,True
Dramatic_Board891,6,11,17,24,0,Strong community,7,1.411764705882353,0.4117647058823529,False,True
caseybvdc74,13,19,32,44,0,Strong community,12,1.375,0.375,False,True
Dreadsin,9,48,57,52,1,Strong community,5,0.9122807017543859,0.08771929824561403,False,False
Asher-D,7,8,15,15,1,Strong community,0,1.0,0.0,False,False
IDontKnowMyUsernameq,7,3,10,8,1,Strong community,2,0.8,0.2,False,False
Jordangander,14,4,18,19,1,Strong community,1,1.0555555555555556,0.05555555555555555,False,False
Kittymeow123,11,5,16,8,1,Strong community,8,0.5,0.5,False,True
Kobe_stan_,8,2,10,3,1,Strong community,7,0.3,0.7,False,True
Mike__O,12,5,17,14,1,Strong community,3,0.8235294117647058,0.17647058823529413,False,False
Some_nerd_______,4,3,7,8,1,Strong community,1,1.1428571428571428,0.14285714285714285,False,False
TheSkyIsBeautiful,7,3,10,11,1,Strong community,1,1.1,0.1,False,False
burnfaith,7,6,13,9,0,Strong community,4,0.6923076923076923,0.3076923076923077,False,True
cerialthriller,8,4,12,10,1,Strong community,2,0.8333333333333334,0.16666666666666666,False,False
dankp3ngu1n69,12,3,15,13,1,Strong community,2,0.8666666666666667,0.13333333333333333,False,False
davidm2232,14,10,24,23,1,Strong community,1,0.9583333333333334,0.041666666666666664,False,False
koosley,17,11,28,25,1,Strong community,3,0.8928571428571429,0.10714285714285714,False,False
massinvader,11,6,17,16,1,Strong community,1,0.9411764705882353,0.058823529411764705,False,False
Drob10,1,14,15,3,4,Strong community,12,0.2,0.8,False,True
Anomander,19,7,26,20,4,Strong community,6,0.7692307692307693,0.23076923076923078,False,True
ProofJournalist,5,1,6,6,4,Strong community,0,1.0,0.0,False,False
Sad-Paramedic-8523,11,8,19,4,14,Noisy community,15,0.21052631578947367,0.7894736842105263,False,False
Droopynator,4,25,29,33,1,Strong community,4,1.1379310344827587,0.13793103448275862,False,False
PathlessMammal,8,4,12,12,1,Strong community,0,1.0,0.0,False,False
Planterizer,6,4,10,5,0,Strong community,5,0.5,0.5,False,True
benji_billingsworth,6,6,12,12,1,Strong community,0,1.0,0.0,False,False
emilia12197144,16,8,24,25,1,Strong community,1,1.0416666666666667,0.041666666666666664,False,False
youchasechickens,9,5,14,13,1,Strong community,1,0.9285714285714286,0.07142857142857142,False,False
Drphatkat,1,19,20,8,13,Noisy community,12,0.4,0.6,False,False
CombinationRough8699,9,10,19,5,13,Noisy community,14,0.2631578947368421,0.7368421052631579,False,False
DazzlingFruit7495,4,3,7,5,13,Noisy community,2,0.7142857142857143,0.2857142857142857,False,False
Knight_Machiavelli,13,12,25,5,13,Noisy community,20,0.2,0.8,False,False
Magic_Man_Boobs,10,6,16,3,13,Noisy community,13,0.1875,0.8125,False,False
ReactionAble7945,19,6,25,12,4,Strong community,13,0.48,0.52,False,True
Sniper_96_,6,4,10,9,0,Strong community,1,0.9,0.1,False,False
SpaceCowboy1929,4,2,6,6,13,Noisy community,0,1.0,0.0,False,False
Spirited-Feed-9927,15,4,19,16,0,Strong community,3,0.8421052631578947,0.15789473684210525,False,False
TheMuffler42069,5,3,8,7,13,Noisy community,1,0.875,0.125,False,False
volvavirago,10,2,12,10,0,Strong community,2,0.8333333333333334,0.16666666666666666,False,False
DryCaterpillar5351,11,28,39,47,0,Strong community,8,1.205128205128205,0.20512820512820512,False,False
DT-Sodium,8,5,13,15,0,Strong community,2,1.1538461538461537,0.15384615384615385,False,False
DinkandDrunk,12,6,18,16,0,Strong community,2,0.8888888888888888,0.1111111111111111,False,False
KFrancesC,6,5,11,11,0,Strong community,0,1.0,0.0,False,False
Vertigobee,10,9,19,21,0,Strong community,2,1.105263157894737,0.10526315789473684,False,False
Due_Air_7255,2,3,5,1,5,Strong community,4,0.2,0.8,False,True
Ok-Recipe5434,6,3,9,10,0,Strong community,1,1.1111111111111112,0.1111111111111111,False,False
VorpalSplade,6,5,11,13,0,Strong community,2,1.1818181818181819,0.18181818181818182,False,False
Duke_Nicetius,2,4,6,5,4,Strong community,1,0.8333333333333334,0.16666666666666666,False,False
00rb,6,6,12,6,4,Strong community,6,0.5,0.5,False,True
DumbMudDrumbBuddy,5,22,27,25,1,Strong community,2,0.9259259259259259,0.07407407407407407,False,False
3WayIntersection,12,12,24,24,1,Strong community,0,1.0,0.0,False,False
Emmyisme,8,2,10,10,1,Strong community,0,1.0,0.0,False,False
Rfg711,5,2,7,7,1,Strong community,0,1.0,0.0,False,False
Visual_Disaster,6,3,9,9,1,Strong community,0,1.0,0.0,False,False
Early-Possibility367,7,19,26,33,0,Strong community,7,1.2692307692307692,0.2692307692307692,False,True
QuercusSambucus,8,7,15,17,0,Strong community,2,1.1333333333333333,0.13333333333333333,False,False
Brainsonastick,15,6,21,8,4,Strong community,13,0.38095238095238093,0.6190476190476191,False,True
Economy-Trip728,4,6,10,9,4,Strong community,1,0.9,0.1,False,False
InfernalOrgasm,10,9,19,20,4,Strong community,1,1.0526315789473684,0.05263157894736842,True,False
PrivilegeCheckmate,4,2,6,6,4,Strong community,0,1.0,0.0,False,False
Treethorn_Yelm,4,1,5,6,4,Strong community,1,1.2,0.2,False,False
EdHistory101,16,20,36,48,0,Strong community,12,1.3333333333333333,0.3333333333333333,False,True
AureliasTenant,12,7,19,21,0,Strong community,2,1.105263157894737,0.10526315789473684,False,False
LtMM_,11,7,18,21,0,Strong community,3,1.1666666666666667,0.16666666666666666,False,False
EdgarKafka,13,86,99,105,0,Strong community,6,1.0606060606060606,0.06060606060606061,True,False
BlasphemousRykard,15,8,23,23,0,Strong community,0,1.0,0.0,False,False
CriskCross,6,4,10,2,51,Noisy community,8,0.2,0.8,False,False
DaRandomRhino,6,5,11,9,0,Strong community,2,0.8181818181818182,0.18181818181818182,False,False
ExpressLaneCharlie,6,4,10,10,0,Strong community,0,1.0,0.0,False,False
Funkywurm,12,10,22,20,0,Strong community,2,0.9090909090909091,0.09090909090909091,False,False
Iconic_Mithrandir,14,11,25,25,0,Strong community,0,1.0,0.0,False,False
Imaginary-Fact-3486,7,3,10,11,0,Strong community,1,1.1,0.1,False,False
LessBalance6122,8,4,12,12,0,Strong community,0,1.0,0.0,False,False
Low-Staff7002,4,7,11,10,0,Strong community,1,0.9090909090909091,0.09090909090909091,False,False
Manaliv3,7,5,12,3,4,Strong community,9,0.25,0.75,False,True
Personal-Advance-494,24,11,35,34,0,Strong community,1,0.9714285714285714,0.02857142857142857,False,False
PriceofObedience,13,7,20,19,0,Strong community,1,0.95,0.05,False,False
Square-Bite1355,6,5,11,11,0,Strong community,0,1.0,0.0,False,False
TheGreatBenjie,5,2,7,7,0,Strong community,0,1.0,0.0,False,False
TheOneFreeEngineer,15,15,30,30,0,Strong community,0,1.0,0.0,False,False
Warny55,34,114,148,152,0,Strong community,4,1.027027027027027,0.02702702702702703,True,False
djjmar92,6,7,13,12,0,Strong community,1,0.9230769230769231,0.07692307692307693,False,False
madmaxwashere,12,7,19,20,0,Strong community,1,1.0526315789473684,0.05263157894736842,False,False
oingerboinger,19,10,29,17,0,Strong community,12,0.5862068965517241,0.41379310344827586,False,True
pine905,13,32,45,55,0,Strong community,10,1.2222222222222223,0.2222222222222222,False,True
sahuxley2,6,8,14,12,0,Strong community,2,0.8571428571428571,0.14285714285714285,False,False
tres_ecstuffuan,4,4,8,8,0,Strong community,0,1.0,0.0,False,False
wildcatwoody,13,11,24,21,0,Strong community,3,0.875,0.125,False,False
EducationalWin5908,3,6,9,11,3,Strong community,2,1.2222222222222223,0.2222222222222222,False,False
EfficiencyHonest9381,7,19,26,36,0,Strong community,10,1.3846153846153846,0.38461538461538464,False,True
Frix,8,4,12,10,0,Strong community,2,0.8333333333333334,0.16666666666666666,False,False
Thinslayer,8,4,12,14,0,Strong community,2,1.1666666666666667,0.16666666666666666,False,False
Efficient_Tip_9991,2,5,7,6,4,Strong community,1,0.8571428571428571,0.14285714285714285,False,False
shitposts_over_9000,4,3,7,7,4,Strong community,0,1.0,0.0,False,False
Either-Log-1570,3,6,9,5,34,Noisy community,4,0.5555555555555556,0.4444444444444444,False,False
brutishbloodgod,2,2,4,5,34,Noisy community,1,1.25,0.25,False,False
firematt422,6,5,11,4,34,Noisy community,7,0.36363636363636365,0.6363636363636364,False,False
Embarrassed-Dress211,13,32,45,48,0,Strong community,3,1.0666666666666667,0.06666666666666667,False,False
Ace0spades808,12,7,19,21,0,Strong community,2,1.105263157894737,0.10526315789473684,False,False
FishyWishySwishy,9,2,11,11,0,Strong community,0,1.0,0.0,False,False
The-_Captain,23,61,84,92,0,Strong community,8,1.0952380952380953,0.09523809523809523,True,False
EmbarrassedFront3705,6,26,32,31,3,Strong community,1,0.96875,0.03125,False,False
Acrobatic_Hippo_9593,10,3,13,14,3,Strong community,1,1.0769230769230769,0.07692307692307693,False,False
Elegant-Bee7654,8,8,16,13,3,Strong community,3,0.8125,0.1875,False,False
EnterprisingAss,15,44,59,56,0,Strong community,3,0.9491525423728814,0.05084745762711865,False,False
ImpossibleReason2204,16,11,27,29,3,Strong community,2,1.0740740740740742,0.07407407407407407,False,False
Particular-Wind5918,3,3,6,7,3,Strong community,1,1.1666666666666667,0.16666666666666666,False,False
RefrigeratorFun4676,7,4,11,12,3,Strong community,1,1.0909090909090908,0.09090909090909091,False,False
SoccerProblem3547,15,12,27,31,3,Strong community,4,1.1481481481481481,0.14814814814814814,True,False
epichuntarz,11,9,20,20,3,Strong community,0,1.0,0.0,False,False
homtulce,2,4,6,7,3,Strong community,1,1.1666666666666667,0.16666666666666666,False,False
owls_and_cardinals,15,6,21,24,3,Strong community,3,1.1428571428571428,0.14285714285714285,False,False
reredd1tt1n,15,12,27,25,3,Strong community,2,0.9259259259259259,0.07407407407407407,False,False
shortasalways,6,3,9,10,3,Strong community,1,1.1111111111111112,0.1111111111111111,False,False
wrenwynn,12,6,18,14,3,Strong community,4,0.7777777777777778,0.2222222222222222,False,True
Embarrassed_Field_84,8,20,28,27,1,Strong community,1,0.9642857142857143,0.03571428571428571,False,False
MrCockingFinally,7,2,9,8,1,Strong community,1,0.8888888888888888,0.1111111111111111,False,False
Waberweeber,8,16,24,18,1,Strong community,6,0.75,0.25,False,True
aj_future,4,3,7,7,1,Strong community,0,1.0,0.0,False,False
guyincognito121,5,4,9,10,1,Strong community,1,1.1111111111111112,0.1111111111111111,False,False
hellonameismyname,5,4,9,10,1,Strong community,1,1.1111111111111112,0.1111111111111111,False,False
icecubtrays,3,2,5,3,0,Strong community,2,0.6,0.4,False,False
shadracko,5,3,8,6,1,Strong community,2,0.75,0.25,False,False
vrnvorona,14,11,25,27,1,Strong community,2,1.08,0.08,False,False
Bandro,10,7,17,15,1,Strong community,2,0.8823529411764706,0.11764705882352941,False,False
Severe-Bicycle-9469,15,12,27,15,1,Strong community,12,0.5555555555555556,0.4444444444444444,False,True
amstrumpet,9,6,15,13,1,Strong community,2,0.8666666666666667,0.13333333333333333,False,False
EnbySheriff,4,15,19,19,1,Strong community,0,1.0,0.0,False,False
Loose_Biscotti9075,7,2,9,9,1,Strong community,0,1.0,0.0,False,False
tolgren,14,2,16,15,0,Strong community,1,0.9375,0.0625,False,False
EnderSlayer9977,9,22,31,38,0,Strong community,7,1.2258064516129032,0.22580645161290322,False,True
DadTheMaskedTerror,8,4,12,15,0,Strong community,3,1.25,0.25,False,True
DominionSeraph,9,6,15,18,0,Strong community,3,1.2,0.2,False,False
MercurianAspirations,21,6,27,29,0,Strong community,2,1.0740740740740742,0.07407407407407407,False,False
blitzkrieg_bop,10,11,21,27,0,Strong community,6,1.2857142857142858,0.2857142857142857,False,True
Maximum-Lack8642,15,6,21,26,0,Strong community,5,1.2380952380952381,0.23809523809523808,False,True
RandomizedNameSystem,8,3,11,12,0,Strong community,1,1.0909090909090908,0.09090909090909091,False,False
Realistic_Yogurt1902,7,3,10,11,0,Strong community,1,1.1,0.1,False,False
mavrik36,6,4,10,11,0,Strong community,1,1.1,0.1,False,False
EnvironmentalCow6217,5,6,11,16,3,Strong community,5,1.4545454545454546,0.45454545454545453,False,True
CoverCharacter8179,8,2,10,11,3,Strong community,1,1.1,0.1,False,False
Equivalent_Day_4078,6,16,22,29,0,Strong community,7,1.3181818181818181,0.3181818181818182,False,True
IceNeun,8,5,13,15,0,Strong community,2,1.1538461538461537,0.15384615384615385,False,False
PlainSodaWater,6,4,10,11,0,Strong community,1,1.1,0.1,False,False
EstablishmentKooky50,12,15,27,34,0,Strong community,7,1.2592592592592593,0.25925925925925924,False,True
Ok_Bag6451,15,10,25,25,0,Strong community,0,1.0,0.0,False,False
Saargb,8,7,15,16,0,Strong community,1,1.0666666666666667,0.06666666666666667,False,False
atav1k,5,3,8,9,0,Strong community,1,1.125,0.125,False,False
Even-Ad-9930,9,19,28,33,0,Strong community,5,1.1785714285714286,0.17857142857142858,False,False
Gremlin95x,16,6,22,24,0,Strong community,2,1.0909090909090908,0.09090909090909091,False,False
Every_Ease1297,14,23,37,47,3,Strong community,10,1.2702702702702702,0.2702702702702703,False,True
1RainbowUnicorn,13,5,18,19,3,Strong community,1,1.0555555555555556,0.05555555555555555,False,False
Alternative_End_7174,5,3,8,8,3,Strong community,0,1.0,0.0,False,False
Grrrrr_Arrrrrgh,6,5,11,13,3,Strong community,2,1.1818181818181819,0.18181818181818182,False,False
Sea_Owl6146,6,5,11,12,3,Strong community,1,1.0909090909090908,0.09090909090909091,False,False
Shadow4summer,5,7,12,9,3,Strong community,3,0.75,0.25,False,True
ShagFit,10,12,22,19,0,Strong community,3,0.8636363636363636,0.13636363636363635,False,False
throwAWweddingwoe,7,2,9,11,3,Strong community,2,1.2222222222222223,0.2222222222222222,False,False
Everyones-Bro,18,31,49,44,0,Strong community,5,0.8979591836734694,0.10204081632653061,False,False
No-Ear7988,18,25,43,26,2,Strong community,17,0.6046511627906976,0.3953488372093023,False,True
figuring_ItOut12,21,12,33,29,2,Strong community,4,0.8787878787878788,0.12121212121212122,False,False
Borigh,6,5,11,14,0,Strong community,3,1.2727272727272727,0.2727272727272727,False,True
Excellent_Chest_5896,13,113,126,123,0,Strong community,3,0.9761904761904762,0.023809523809523808,True,False
According-Werewolf10,4,3,7,7,0,Strong community,0,1.0,0.0,False,False
AndlenaRaines,16,8,24,16,2,Strong community,8,0.6666666666666666,0.3333333333333333,False,True
Beljuril-home,3,1,4,5,0,Strong community,1,1.25,0.25,False,False
CaptainFingerling,12,9,21,18,0,Strong community,3,0.8571428571428571,0.14285714285714285,False,False
Caracalla81,20,16,36,34,0,Strong community,2,0.9444444444444444,0.05555555555555555,False,False
Carlpanzram1916,22,8,30,26,0,Strong community,4,0.8666666666666667,0.13333333333333333,False,False
ContextEffects01,7,4,11,12,0,Strong community,1,1.0909090909090908,0.09090909090909091,False,False
Either_Operation7586,10,8,18,11,2,Strong community,7,0.6111111111111112,0.3888888888888889,False,True
Every3Years,9,11,20,20,0,Strong community,0,1.0,0.0,False,False
Harbinger2001,10,3,13,13,0,Strong community,0,1.0,0.0,False,False
King-JelIy,7,12,19,25,0,Strong community,6,1.3157894736842106,0.3157894736842105,False,True
Nodaker1,9,6,15,15,0,Strong community,0,1.0,0.0,False,False
Passive_Menis79,13,2,15,17,0,Strong community,2,1.1333333333333333,0.13333333333333333,False,False
Savings-Willow4709,8,5,13,13,0,Strong community,0,1.0,0.0,False,False
Shadeylark,13,8,21,24,0,Strong community,3,1.1428571428571428,0.14285714285714285,False,False
Sspifffyman,10,9,19,9,2,Strong community,10,0.47368421052631576,0.5263157894736842,False,True
Yntol,7,3,10,2,31,Noisy community,8,0.2,0.8,False,False
ZeerVreemd,11,12,23,22,0,Strong community,1,0.9565217391304348,0.043478260869565216,False,False
fox-mcleod,25,21,46,35,0,Strong community,11,0.7608695652173914,0.2391304347826087,False,True
h0sti1e17,14,7,21,24,0,Strong community,3,1.1428571428571428,0.14285714285714285,False,False
qstomizecom,4,3,7,5,0,Strong community,2,0.7142857142857143,0.2857142857142857,False,False
rbminer456,21,40,61,74,0,Strong community,13,1.2131147540983607,0.21311475409836064,False,False
sal696969,18,5,23,23,0,Strong community,0,1.0,0.0,False,False
sumit24021990,12,11,23,25,0,Strong community,2,1.0869565217391304,0.08695652173913043,False,False
thoughtsome,7,5,12,10,0,Strong community,2,0.8333333333333334,0.16666666666666666,False,False
Exciting_Sky1634,2,2,4,6,4,Strong community,2,1.5,0.5,False,False
ExoG198765432,6,10,16,17,1,Strong community,1,1.0625,0.0625,False,False
ChronaMewX,9,5,14,11,1,Strong community,3,0.7857142857142857,0.21428571428571427,False,False
Expensive_Choice2742,0,3,3,5,5,Strong community,2,1.6666666666666667,0.6666666666666666,False,False
IWannaHideThrowaway,4,16,20,11,5,Strong community,9,0.55,0.45,False,True
ExternalSeat,16,39,55,63,0,Strong community,8,1.1454545454545455,0.14545454545454545,True,False
Accomplished_Mind792,7,4,11,4,33,Noisy community,7,0.36363636363636365,0.6363636363636364,False,False
ZappSmithBrannigan,29,18,47,43,0,Strong community,4,0.9148936170212766,0.0851063829787234,False,False
redhillbones,17,15,32,32,0,Strong community,0,1.0,0.0,False,False
redroserequiems,3,2,5,5,0,Strong community,0,1.0,0.0,False,False
unbelizeable1,10,8,18,19,0,Strong community,1,1.0555555555555556,0.05555555555555555,False,False
Fabulous-Earth-4871,5,10,15,16,0,Strong community,1,1.0666666666666667,0.06666666666666667,False,False
dragonfirestorm948,6,12,18,19,0,Strong community,1,1.0555555555555556,0.05555555555555555,False,False
Adventurous_Class_90,8,4,12,12,0,Strong community,0,1.0,0.0,False,False
CEO-Soul-Collector,7,3,10,5,0,Strong community,5,0.5,0.5,False,True
ChickerWings,14,5,19,2,51,Noisy community,17,0.10526315789473684,0.8947368421052632,False,False
Chocotacoturtle,17,10,27,14,2,Strong community,13,0.5185185185185185,0.48148148148148145,False,True
Former_Star1081,8,2,10,9,0,Strong community,1,0.9,0.1,False,False
Guldur,7,4,11,9,0,Strong community,2,0.8181818181818182,0.18181818181818182,False,False
HImainland,11,6,17,17,0,Strong community,0,1.0,0.0,False,False
Obvious_Chapter2082,28,16,44,18,2,Strong community,26,0.4090909090909091,0.5909090909090909,False,True
Scrappy_101,13,10,23,17,0,Strong community,6,0.7391304347826086,0.2608695652173913,False,True
ThatOtherGuyTPM,13,11,24,11,2,Strong community,13,0.4583333333333333,0.5416666666666666,False,True
Writing_is_Bleeding,16,8,24,23,0,Strong community,1,0.9583333333333334,0.041666666666666664,False,False
YouLearnedNothing,15,8,23,21,0,Strong community,2,0.9130434782608695,0.08695652173913043,False,False
alaskanperson,11,3,14,8,0,Strong community,6,0.5714285714285714,0.42857142857142855,False,True
azuredota,7,5,12,11,0,Strong community,1,0.9166666666666666,0.08333333333333333,False,False
cant_pass_CAPTCHA,15,8,23,18,0,Strong community,5,0.782608695652174,0.21739130434782608,False,False
captainhukk,5,2,7,8,0,Strong community,1,1.1428571428571428,0.14285714285714285,False,False
cutegolpnik,6,4,10,10,0,Strong community,0,1.0,0.0,False,False
kkdawg22,20,15,35,35,0,Strong community,0,1.0,0.0,False,False
ranchojasper,18,18,36,3,27,Noisy community,33,0.08333333333333333,0.9166666666666666,False,False
Fando1234,14,27,41,46,0,Strong community,5,1.1219512195121952,0.12195121951219512,False,False
Mestoph,6,3,9,11,0,Strong community,2,1.2222222222222223,0.2222222222222222,False,False
Zerguu,9,2,11,10,0,Strong community,1,0.9090909090909091,0.09090909090909091,False,False
ZeusThunder369,22,43,65,65,0,Strong community,0,1.0,0.0,True,False
kyngston,10,6,16,17,0,Strong community,1,1.0625,0.0625,False,False
WaterNerd518,10,6,16,11,0,Strong community,5,0.6875,0.3125,False,True
generallydisagree,36,17,53,46,0,Strong community,7,0.8679245283018868,0.1320754716981132,False,False
Far-Oven-6023,5,33,38,35,3,Strong community,3,0.9210526315789473,0.07894736842105263,False,False
Unrelated_gringo,7,6,13,14,3,Strong community,1,1.0769230769230769,0.07692307692307693,False,False
jmgolden33,5,2,7,7,3,Strong community,0,1.0,0.0,False,False
silfy_star,8,2,10,10,3,Strong community,0,1.0,0.0,False,False
treehuggerfroglover,13,6,19,10,1,Strong community,9,0.5263157894736842,0.47368421052631576,False,True
uber_neutrino,20,12,32,28,0,Strong community,4,0.875,0.125,False,False
use_your_smarts,10,7,17,13,3,Strong community,4,0.7647058823529411,0.23529411764705882,False,True
Far_Reindeer3003,19,34,53,68,0,Strong community,15,1.2830188679245282,0.2830188679245283,False,True
Monte_Cristos_Count,9,2,11,8,1,Strong community,3,0.7272727272727273,0.2727272727272727,False,True
Saranoya,15,31,46,53,0,Strong community,7,1.1521739130434783,0.15217391304347827,False,False
panna__cotta,6,4,10,11,0,Strong community,1,1.1,0.1,False,False
physioworld,17,50,67,52,0,Strong community,15,0.7761194029850746,0.22388059701492538,False,True
tanglekelp,10,6,16,19,0,Strong community,3,1.1875,0.1875,False,False
FeedingCactus,1,7,8,10,1,Strong community,2,1.25,0.25,False,False
Cynykl,11,4,15,16,1,Strong community,1,1.0666666666666667,0.06666666666666667,False,False
StrategericAmbiguity,5,3,8,7,1,Strong community,1,0.875,0.125,False,False
alvysinger0412,7,2,9,8,1,Strong community,1,0.8888888888888888,0.1111111111111111,False,False
theGRAYblanket,6,3,9,8,1,Strong community,1,0.8888888888888888,0.1111111111111111,False,False
Feisty-Giraffe-8650,8,12,20,30,0,Strong community,10,1.5,0.5,False,True
charlesth1ckens,31,15,46,47,0,Strong community,1,1.0217391304347827,0.021739130434782608,False,False
Felix_Fickelgruber,2,19,21,16,3,Strong community,5,0.7619047619047619,0.23809523809523808,False,True
Anon-Sham,6,4,10,9,1,Strong community,1,0.9,0.1,False,False
fishbikerun,4,20,24,24,3,Strong community,0,1.0,0.0,False,False
quick_justice,9,1,10,11,3,Strong community,1,1.1,0.1,False,False
Aneurhythms,10,5,15,15,2,Strong community,0,1.0,0.0,False,False
BothDiscussion9832,22,15,37,35,2,Strong community,2,0.9459459459459459,0.05405405405405406,False,False
DMayleeRevengeReveng,15,7,22,21,2,Strong community,1,0.9545454545454546,0.045454545454545456,False,False
Marchtmdsmiling,14,15,29,28,2,Strong community,1,0.9655172413793104,0.034482758620689655,False,False
NepheliLouxWarrior,20,6,26,22,2,Strong community,4,0.8461538461538461,0.15384615384615385,False,False
PropofolMargarita,6,9,15,15,2,Strong community,0,1.0,0.0,False,False
Serious_Senator,9,9,18,10,2,Strong community,8,0.5555555555555556,0.4444444444444444,False,True
SkeptioningQuestic,8,4,12,1,56,Noisy community,11,0.08333333333333333,0.9166666666666666,False,False
SkiingAway,10,5,15,13,2,Strong community,2,0.8666666666666667,0.13333333333333333,False,False
TJ11240,7,4,11,12,2,Strong community,1,1.0909090909090908,0.09090909090909091,False,False
Time_Minute_6036,10,252,262,247,2,Strong community,15,0.9427480916030534,0.05725190839694656,True,False
Unfounded_archeology,3,4,7,8,2,Strong community,1,1.1428571428571428,0.14285714285714285,False,False
bionicfeetgrl,11,7,18,14,2,Strong community,4,0.7777777777777778,0.2222222222222222,False,True
wha-haa,26,26,52,50,2,Strong community,2,0.9615384615384616,0.038461538461538464,False,False
Few_Republic1136,4,20,24,25,1,Strong community,1,1.0416666666666667,0.041666666666666664,False,False
Privacy-Boggle,9,4,13,12,1,Strong community,1,0.9230769230769231,0.07692307692307693,False,False
moist-astronaut,6,4,10,11,1,Strong community,1,1.1,0.1,False,False
rescuers_downunder,16,19,35,31,1,Strong community,4,0.8857142857142857,0.11428571428571428,False,False
sovereignlogik,9,5,14,13,1,Strong community,1,0.9285714285714286,0.07142857142857142,False,False
whenishit-itsbigturd,9,5,14,11,1,Strong community,3,0.7857142857142857,0.21428571428571427,False,False
Fickle-Syllabub6730,2,8,10,10,4,Strong community,0,1.0,0.0,False,False
FinTecTec,3,8,11,14,0,Strong community,3,1.2727272727272727,0.2727272727272727,False,True
Financial_Pound_9448,1,2,3,5,3,Strong community,2,1.6666666666666667,0.6666666666666666,False,False
FindingWise7677,15,15,30,27,1,Strong community,3,0.9,0.1,False,False
Affectionate-Key-265,8,4,12,16,1,Strong community,4,1.3333333333333333,0.3333333333333333,False,True
amf_devils_best,8,6,14,12,0,Strong community,2,0.8571428571428571,0.14285714285714285,False,False
sparklybeast,10,6,16,16,1,Strong community,0,1.0,0.0,False,False
FireflyRebellion,6,9,15,19,0,Strong community,4,1.2666666666666666,0.26666666666666666,False,True
ComfortRelative1884,4,4,8,10,0,Strong community,2,1.25,0.25,False,False
Due_Visual_4613,8,4,12,13,0,Strong community,1,1.0833333333333333,0.08333333333333333,False,False
FishFollower74,3,3,6,5,4,Strong community,1,0.8333333333333334,0.16666666666666666,False,False
Impressive-Floor-700,3,3,6,5,4,Strong community,1,0.8333333333333334,0.16666666666666666,False,False
checker280,30,25,55,48,2,Strong community,7,0.8727272727272727,0.12727272727272726,False,False
Fisics_,13,181,194,181,0,Strong community,13,0.9329896907216495,0.06701030927835051,True,False
81forest,8,8,16,19,0,Strong community,3,1.1875,0.1875,False,False
Acceptable_Wonder614,5,3,8,8,0,Strong community,0,1.0,0.0,False,False
Alternative_Buy_4000,21,10,31,27,0,Strong community,4,0.8709677419354839,0.12903225806451613,False,False
Anti-genocide-club,7,8,15,13,0,Strong community,2,0.8666666666666667,0.13333333333333333,False,False
Boring_Investment241,3,2,5,6,0,Strong community,1,1.2,0.2,False,False
Call_Me_Clark,4,3,7,7,0,Strong community,0,1.0,0.0,False,False
CarsTrutherGuy,9,4,13,15,0,Strong community,2,1.1538461538461537,0.15384615384615385,False,False
Conscious_Spray_5331,5,4,9,9,0,Strong community,0,1.0,0.0,False,False
CreativeContract2170,3,3,6,7,0,Strong community,1,1.1666666666666667,0.16666666666666666,False,False
Effective_Jury4363,14,9,23,22,0,Strong community,1,0.9565217391304348,0.043478260869565216,False,False
Fit_Employment_2944,6,4,10,9,0,Strong community,1,0.9,0.1,False,False
Hungry-Struggle-1448,30,36,66,70,0,Strong community,4,1.0606060606060606,0.06060606060606061,True,False
Hyubris11,4,3,7,2,29,Noisy community,5,0.2857142857142857,0.7142857142857143,False,False
InterestingTheory9,14,12,26,25,0,Strong community,1,0.9615384615384616,0.038461538461538464,False,False
K-CN,5,5,10,10,0,Strong community,0,1.0,0.0,False,False
KathrynBooks,12,10,22,23,0,Strong community,1,1.0454545454545454,0.045454545454545456,False,False
Kuriyamikitty,8,5,13,13,0,Strong community,0,1.0,0.0,False,False
LanceBarney,10,2,12,11,0,Strong community,1,0.9166666666666666,0.08333333333333333,False,False
Lopsided_Thing_9474,7,5,12,14,0,Strong community,2,1.1666666666666667,0.16666666666666666,False,False
Meowmixalotlol,6,5,11,10,0,Strong community,1,0.9090909090909091,0.09090909090909091,False,False
Normal-Advisor5269,16,9,25,25,0,Strong community,0,1.0,0.0,False,False
OldTiredGamer86,5,19,24,27,0,Strong community,3,1.125,0.125,False,False
OneNoteToRead,6,4,10,10,0,Strong community,0,1.0,0.0,False,False
OptimisticRealist__,8,3,11,1,40,Noisy community,10,0.09090909090909091,0.9090909090909091,False,False
PanzerOfTheLake115,6,6,12,12,0,Strong community,0,1.0,0.0,False,False
PermissionHuman1901,4,1,5,5,0,Strong community,0,1.0,0.0,False,False
Ponce2170,8,8,16,16,0,Strong community,0,1.0,0.0,False,False
ProjectConfident8584,8,5,13,13,0,Strong community,0,1.0,0.0,False,False
Se4_h0rse,9,8,17,17,0,Strong community,0,1.0,0.0,False,False
SnooStrawberries620,7,3,10,10,0,Strong community,0,1.0,0.0,False,False
Steamed_Memes24,15,45,60,57,0,Strong community,3,0.95,0.05,False,False
Szygani,7,5,12,13,0,Strong community,1,1.0833333333333333,0.08333333333333333,False,False
TSllama,19,13,32,26,0,Strong community,6,0.8125,0.1875,False,False
TheMCMC,10,4,14,8,0,Strong community,6,0.5714285714285714,0.42857142857142855,False,True
Volume2KVorochilov,5,5,10,5,40,Noisy community,5,0.5,0.5,False,False
_Hamburger_Helper_,8,4,12,9,0,Strong community,3,0.75,0.25,False,True
anaconda4290,13,15,28,28,0,Strong community,0,1.0,0.0,False,False
arrogant_ambassador,10,6,16,16,0,Strong community,0,1.0,0.0,False,False
awelles,6,6,12,9,0,Strong community,3,0.75,0.25,False,True
banhs5,7,3,10,10,0,Strong community,0,1.0,0.0,False,False
baptiser2,11,21,32,36,0,Strong community,4,1.125,0.125,False,False
bfhurricane,18,11,29,20,2,Strong community,9,0.6896551724137931,0.3103448275862069,False,True
eteran,6,4,10,10,0,Strong community,0,1.0,0.0,False,False
fixie-pilled420,6,4,10,11,0,Strong community,1,1.1,0.1,False,False
jpotion88,5,7,12,12,0,Strong community,0,1.0,0.0,False,False
km3r,14,5,19,18,0,Strong community,1,0.9473684210526315,0.05263157894736842,False,False
lightmaker918,6,3,9,7,0,Strong community,2,0.7777777777777778,0.2222222222222222,False,False
pragmojo,9,9,18,1,52,Noisy community,17,0.05555555555555555,0.9444444444444444,False,False
properchewns,9,7,16,16,0,Strong community,0,1.0,0.0,False,False
redosipod,7,7,14,12,0,Strong community,2,0.8571428571428571,0.14285714285714285,False,False
sabesundae,5,3,8,9,0,Strong community,1,1.125,0.125,False,False
thebolts,7,6,13,7,2,Strong community,6,0.5384615384615384,0.46153846153846156,False,True
udcvr,5,6,11,11,0,Strong community,0,1.0,0.0,False,False
walletinsurance,4,9,13,13,0,Strong community,0,1.0,0.0,False,False
AdFun5641,13,3,16,19,0,Strong community,3,1.1875,0.1875,False,False
Bourbon-Decay,8,7,15,10,0,Strong community,5,0.6666666666666666,0.3333333333333333,False,True
Darkagent1,12,9,21,22,0,Strong community,1,1.0476190476190477,0.047619047619047616,False,False
Few_Mistake4144,8,8,16,16,0,Strong community,0,1.0,0.0,False,False
Gnarly-Beard,8,7,15,17,0,Strong community,2,1.1333333333333333,0.13333333333333333,False,False
Honeycrispcombe,10,8,18,15,0,Strong community,3,0.8333333333333334,0.16666666666666666,False,False
Hopeful_Ad_7719,3,1,4,1,15,Noisy community,3,0.25,0.75,False,False
Logical_Strike_1520,3,3,6,1,10,Weak community,5,0.16666666666666666,0.8333333333333334,False,True
NTXGBR,8,12,20,21,0,Strong community,1,1.05,0.05,False,False
Rehcamretsnef,15,4,19,22,0,Strong community,3,1.1578947368421053,0.15789473684210525,False,False
Wizbran,5,3,8,2,11,Weak community,6,0.25,0.75,False,True
haikuandhoney,12,8,20,2,34,Noisy community,18,0.1,0.9,False,False
seedoilbaths,25,85,110,92,0,Strong community,18,0.8363636363636363,0.16363636363636364,True,False
Flat-Butterscotch325,5,20,25,28,3,Strong community,3,1.12,0.12,False,False
Donutsmell,11,2,13,15,3,Strong community,2,1.1538461538461537,0.15384615384615385,False,False
Embarrassed-Kale-744,7,5,12,14,3,Strong community,2,1.1666666666666667,0.16666666666666666,False,False
Wise_Session_5370,10,3,13,16,3,Strong community,3,1.2307692307692308,0.23076923076923078,False,True
Flinn2,9,11,20,22,0,Strong community,2,1.1,0.1,False,False
Ferengsten,9,7,16,15,0,Strong community,1,0.9375,0.0625,False,False
pensivewombat,7,9,16,13,0,Strong community,3,0.8125,0.1875,False,False
tdifen,6,4,10,10,0,Strong community,0,1.0,0.0,False,False
FluidManufacturer952,32,108,140,159,0,Strong community,19,1.1357142857142857,0.1357142857142857,True,False
Punctual-Dragon,10,7,17,17,0,Strong community,0,1.0,0.0,False,False
SkyeWulver,10,5,15,15,0,Strong community,0,1.0,0.0,False,False
StathMIA,3,3,6,7,0,Strong community,1,1.1666666666666667,0.16666666666666666,False,False
dsteffee,23,64,87,34,2,Strong community,53,0.39080459770114945,0.6091954022988506,False,True
elmekia_lance,17,16,33,24,2,Strong community,9,0.7272727272727273,0.2727272727272727,False,True
enigmatic_erudition,8,4,12,15,0,Strong community,3,1.25,0.25,False,True
itswhatisaid,21,29,50,53,0,Strong community,3,1.06,0.06,False,False
ru_empty,4,3,7,7,0,Strong community,0,1.0,0.0,False,False
Fluid_Sky_4246,0,5,5,4,5,Strong community,1,0.8,0.2,False,False
CorpseDefiled,4,1,5,5,5,Strong community,0,1.0,0.0,False,False
Agitated-Country-969,10,5,15,11,1,Strong community,4,0.7333333333333333,0.26666666666666666,False,True
Altruistic_Key_1266,6,1,7,7,1,Strong community,0,1.0,0.0,False,False
Few-Scene-3183,6,5,11,10,1,Strong community,1,0.9090909090909091,0.09090909090909091,False,False
Mister-ellaneous,5,4,9,10,1,Strong community,1,1.1111111111111112,0.1111111111111111,False,False
Negativefalsehoods,11,12,23,17,1,Strong community,6,0.7391304347826086,0.2608695652173913,False,True
WickdWitchoftheBitch,8,2,10,8,1,Strong community,2,0.8,0.2,False,False
big-cheese49,8,18,26,24,1,Strong community,2,0.9230769230769231,0.07692307692307693,False,False
notapoliticalalt,20,15,35,20,2,Strong community,15,0.5714285714285714,0.42857142857142855,False,True
Goddamitdonut,6,4,10,9,1,Strong community,1,0.9,0.1,False,False
HyderintheHouse,4,4,8,8,1,Strong community,0,1.0,0.0,False,False
Intelligent_Break_12,6,8,14,11,1,Strong community,3,0.7857142857142857,0.21428571428571427,False,False
Proper-Bug-3843,4,5,9,4,28,Noisy community,5,0.4444444444444444,0.5555555555555556,False,False
Stoic_Fervor,10,3,13,1,8,Weak community,12,0.07692307692307693,0.9230769230769231,False,True
armrha,16,4,20,22,1,Strong community,2,1.1,0.1,False,False
justcougit,7,2,9,9,1,Strong community,0,1.0,0.0,False,False
slowsundaycoffeeclub,11,5,16,15,1,Strong community,1,0.9375,0.0625,False,False
wibbly-water,15,6,21,25,0,Strong community,4,1.1904761904761905,0.19047619047619047,False,False
ForgetfullRelms,7,18,25,33,0,Strong community,8,1.32,0.32,False,True
Forgotten_Dog1954,2,9,11,12,1,Strong community,1,1.0909090909090908,0.09090909090909091,False,False
Mysterious_Dark_2298,8,3,11,12,1,Strong community,1,1.0909090909090908,0.09090909090909091,False,False
oakfield01,8,6,14,14,1,Strong community,0,1.0,0.0,False,False
Xiibe,20,11,31,35,0,Strong community,4,1.1290322580645162,0.12903225806451613,False,False
ButtholeSurfur,7,5,12,11,1,Strong community,1,0.9166666666666666,0.08333333333333333,False,False
DilbertHigh,12,8,20,13,1,Strong community,7,0.65,0.35,False,True
Kiowascout,13,8,21,23,1,Strong community,2,1.0952380952380953,0.09523809523809523,False,False
Orion_69_420,4,2,6,4,1,Strong community,2,0.6666666666666666,0.3333333333333333,False,False
Racer13l,4,3,7,5,0,Strong community,2,0.7142857142857143,0.2857142857142857,False,False
cwcam86,7,3,10,9,1,Strong community,1,0.9,0.1,False,False
katsock,10,1,11,13,1,Strong community,2,1.1818181818181819,0.18181818181818182,False,False
wpotman,11,3,14,15,1,Strong community,1,1.0714285714285714,0.07142857142857142,False,False
CandidateNew3518,7,7,14,14,0,Strong community,0,1.0,0.0,False,False
One-Independent8303,11,7,18,19,0,Strong community,1,1.0555555555555556,0.05555555555555555,False,False
FunMammoth6910,2,10,12,12,3,Strong community,0,1.0,0.0,False,False
PoetLocksmith,6,4,10,11,3,Strong community,1,1.1,0.1,False,False
Specialist-Owl2660,6,4,10,10,3,Strong community,0,1.0,0.0,False,False
TheBossOfItAll,7,4,11,5,3,Strong community,6,0.45454545454545453,0.5454545454545454,False,True
Unholy_mess169,5,4,9,8,3,Strong community,1,0.8888888888888888,0.1111111111111111,False,False
moo-chu,13,10,23,23,3,Strong community,0,1.0,0.0,False,False
GameMythYT,6,7,13,18,0,Strong community,5,1.3846153846153846,0.38461538461538464,False,True
GamingCatGuy,6,34,40,39,0,Strong community,1,0.975,0.025,False,False
Adiv_Kedar2,13,5,18,19,0,Strong community,1,1.0555555555555556,0.05555555555555555,False,False
Potatussus26,21,73,94,93,0,Strong community,1,0.9893617021276596,0.010638297872340425,True,False
WreckinRich,7,5,12,11,0,Strong community,1,0.9166666666666666,0.08333333333333333,False,False
alienassasin3,9,9,18,21,0,Strong community,3,1.1666666666666667,0.16666666666666666,False,False
GasHistorical5064,5,29,34,38,2,Strong community,4,1.1176470588235294,0.11764705882352941,False,False
AVonGauss,9,4,13,12,2,Strong community,1,0.9230769230769231,0.07692307692307693,False,False
Complex-Field7054,29,24,53,42,2,Strong community,11,0.7924528301886793,0.20754716981132076,False,False
Kman17,33,10,43,24,2,Strong community,19,0.5581395348837209,0.4418604651162791,False,True
Konflictcam,6,7,13,13,2,Strong community,0,1.0,0.0,False,False
Wave_File,27,14,41,33,2,Strong community,8,0.8048780487804879,0.1951219512195122,False,False
apiaryaviary,10,7,17,18,2,Strong community,1,1.0588235294117647,0.058823529411764705,False,False
bearrosaurus,9,7,16,16,2,Strong community,0,1.0,0.0,False,False
GenGanges,11,25,36,40,0,Strong community,4,1.1111111111111112,0.1111111111111111,False,False
igna92ts,13,8,21,21,0,Strong community,0,1.0,0.0,False,False
General_Cherry_6285,6,18,24,25,1,Strong community,1,1.0416666666666667,0.041666666666666664,False,False
Breakin7,7,3,10,9,1,Strong community,1,0.9,0.1,False,False
CalligrapherDizzy201,16,8,24,19,1,Strong community,5,0.7916666666666666,0.20833333333333334,False,False
DingbattheGreat,4,1,5,5,1,Strong community,0,1.0,0.0,False,False
queefymacncheese,15,2,17,17,1,Strong community,0,1.0,0.0,False,False
side_noted,9,5,14,11,1,Strong community,3,0.7857142857142857,0.21428571428571427,False,False
Glass-Pain3562,15,37,52,64,0,Strong community,12,1.2307692307692308,0.23076923076923078,False,True
Fleeting_Dopamine,10,7,17,19,0,Strong community,2,1.1176470588235294,0.11764705882352941,False,False
Mother_Sand_6336,11,7,18,10,0,Strong community,8,0.5555555555555556,0.4444444444444444,False,True
Whatswrongbaby9,14,6,20,17,0,Strong community,3,0.85,0.15,False,False
Glittering_Ad_6027,5,9,14,17,0,Strong community,3,1.2142857142857142,0.21428571428571427,False,False
Drneroflame,7,5,12,14,0,Strong community,2,1.1666666666666667,0.16666666666666666,False,False
Glittering_Desk_8575,1,3,4,6,3,Strong community,2,1.5,0.5,False,False
SmarterThanCornPop,11,8,19,19,0,Strong community,0,1.0,0.0,False,False
terryjuicelawson,14,6,20,19,1,Strong community,1,0.95,0.05,False,False
Rough_Elk_3952,7,4,11,10,1,Strong community,1,0.9090909090909091,0.09090909090909091,False,False
GreenParrot785,6,11,17,22,0,Strong community,5,1.2941176470588236,0.29411764705882354,False,True
Tradition96,4,3,7,8,0,Strong community,1,1.1428571428571428,0.14285714285714285,False,False
Gritty_gutty,9,12,21,28,0,Strong community,7,1.3333333333333333,0.3333333333333333,False,True
Guildernstern87,6,17,23,30,0,Strong community,7,1.3043478260869565,0.30434782608695654,False,True
HannahKentucky,3,7,10,14,1,Strong community,4,1.4,0.4,False,True
Expert-Examination86,7,2,9,9,1,Strong community,0,1.0,0.0,False,False
randell1985,7,6,13,11,1,Strong community,2,0.8461538461538461,0.15384615384615385,False,False
thorpie88,21,9,30,28,1,Strong community,2,0.9333333333333333,0.06666666666666667,False,False
Bojack35,13,8,21,19,0,Strong community,2,0.9047619047619048,0.09523809523809523,False,False
BreadAndToast99,10,5,15,15,0,Strong community,0,1.0,0.0,False,False
Glad-Way-637,7,7,14,14,0,Strong community,0,1.0,0.0,False,False
LosingTrackByNow,6,6,12,13,0,Strong community,1,1.0833333333333333,0.08333333333333333,False,False
MinuteBubbly9249,13,6,19,8,3,Strong community,11,0.42105263157894735,0.5789473684210527,False,True
NoShape7689,5,3,8,8,0,Strong community,0,1.0,0.0,False,False
Old-Research3367,12,7,19,19,0,Strong community,0,1.0,0.0,False,False
Particular_Ant_4429,12,9,21,22,0,Strong community,1,1.0476190476190477,0.047619047619047616,False,False
The_Itsy_BitsySpider,17,8,25,27,0,Strong community,2,1.08,0.08,False,False
beethebuz,11,5,16,16,0,Strong community,0,1.0,0.0,False,False
cuntpimp,9,7,16,16,0,Strong community,0,1.0,0.0,False,False
dundreggen,8,8,16,14,0,Strong community,2,0.875,0.125,False,False
quantum-fitness,7,2,9,9,0,Strong community,0,1.0,0.0,False,False
Haunting-Ad-7760,4,35,39,37,0,Strong community,2,0.9487179487179487,0.05128205128205128,False,False
InternationalClick78,9,6,15,6,8,Weak community,9,0.4,0.6,False,True
Patient-Courage-9764,11,6,17,19,0,Strong community,2,1.1176470588235294,0.11764705882352941,False,False
HauntingPayment4761,2,3,5,7,3,Strong community,2,1.4,0.4,False,False
HazzaB0o,2,5,7,10,3,Strong community,3,1.4285714285714286,0.42857142857142855,False,True
HeWhoReddits,14,69,83,87,0,Strong community,4,1.0481927710843373,0.04819277108433735,True,False
Brave-Silver8736,5,6,11,11,0,Strong community,0,1.0,0.0,False,False
BugRevolution,6,4,10,8,0,Strong community,2,0.8,0.2,False,False
Conscious-Function-2,12,3,15,17,0,Strong community,2,1.1333333333333333,0.13333333333333333,False,False
IEATASSETS,5,4,9,10,0,Strong community,1,1.1111111111111112,0.1111111111111111,False,False
KRAy_Z_n1nja,7,4,11,10,0,Strong community,1,0.9090909090909091,0.09090909090909091,False,False
LeRoyRouge,8,5,13,9,2,Strong community,4,0.6923076923076923,0.3076923076923077,False,True
MainPlankton9612,7,2,9,7,0,Strong community,2,0.7777777777777778,0.2222222222222222,False,False
Mejari,11,12,23,24,0,Strong community,1,1.0434782608695652,0.043478260869565216,False,False
Thencewasit,10,4,14,14,0,Strong community,0,1.0,0.0,False,False
WVUEnchilada,4,4,8,8,0,Strong community,0,1.0,0.0,False,False
anomie89,12,5,17,8,1,Strong community,9,0.47058823529411764,0.5294117647058824,False,True
garnet420,7,3,10,11,0,Strong community,1,1.1,0.1,False,False
Healthy-Decision-206,13,24,37,34,3,Strong community,3,0.918918918918919,0.08108108108108109,True,False
MattDaveys,5,0,5,6,3,Strong community,1,1.2,0.2,False,False
pierogieman5,3,2,5,4,3,Strong community,1,0.8,0.2,False,False
A_Soporific,10,9,19,21,0,Strong community,2,1.105263157894737,0.10526315789473684,False,False
Glorfendail,17,10,27,26,0,Strong community,1,0.9629629629629629,0.037037037037037035,False,False
Neither-Stage-238,5,4,9,11,0,Strong community,2,1.2222222222222223,0.2222222222222222,False,False
Nervous-Procedure-63,16,10,26,26,0,Strong community,0,1.0,0.0,False,False
Previous_Impact7129,8,8,16,13,0,Strong community,3,0.8125,0.1875,False,False
Royal_Negotiation_91,21,10,31,32,0,Strong community,1,1.032258064516129,0.03225806451612903,False,False
Sharkbait_ooohaha,6,4,10,10,0,Strong community,0,1.0,0.0,False,False
TSN09,5,2,7,7,0,Strong community,0,1.0,0.0,False,False
Temporary-Truth2048,7,4,11,11,0,Strong community,0,1.0,0.0,False,False
aguafiestas,6,2,8,2,43,Noisy community,6,0.25,0.75,False,False
aspiringimmortal,17,18,35,35,0,Strong community,0,1.0,0.0,False,False
breakbeforedawn,15,16,31,32,0,Strong community,1,1.032258064516129,0.03225806451612903,False,False
iAmBalfrog,4,0,4,4,0,Strong community,0,1.0,0.0,False,False
HelenOlivas,4,7,11,16,0,Strong community,5,1.4545454545454546,0.45454545454545453,False,True
NoGoodDrifter99,9,6,15,17,0,Strong community,2,1.1333333333333333,0.13333333333333333,False,False
Gladfire,2,2,4,6,0,Strong community,2,1.5,0.5,False,False
custodial_art,15,10,25,27,0,Strong community,2,1.08,0.08,False,False
Hermeslost,14,46,60,70,0,Strong community,10,1.1666666666666667,0.16666666666666666,True,False
soldiergeneal,6,7,13,12,0,Strong community,1,0.9230769230769231,0.07692307692307693,False,False
HistoricalAd6321,36,164,200,187,0,Strong community,13,0.935,0.065,True,False
4art4,28,12,40,41,0,Strong community,1,1.025,0.025,False,False
AhsokaSolo,4,4,8,4,41,Noisy community,4,0.5,0.5,False,False
ArCovino,8,7,15,15,0,Strong community,0,1.0,0.0,False,False
Cold_Breeze3,9,9,18,17,0,Strong community,1,0.9444444444444444,0.05555555555555555,False,False
DBFool2019,8,7,15,15,0,Strong community,0,1.0,0.0,False,False
DJFrostyTips,5,2,7,2,41,Noisy community,5,0.2857142857142857,0.7142857142857143,False,False
EclipseNine,8,4,12,12,0,Strong community,0,1.0,0.0,False,False
FlippinSnip3r,3,1,4,2,44,Noisy community,2,0.5,0.5,False,False
GarryofRiverton,11,10,21,22,0,Strong community,1,1.0476190476190477,0.047619047619047616,False,False
Grish__,4,4,8,9,0,Strong community,1,1.125,0.125,False,False
ICantCoexistWithFish,3,4,7,8,0,Strong community,1,1.1428571428571428,0.14285714285714285,False,False
In-Brightest-Day,6,3,9,6,2,Strong community,3,0.6666666666666666,0.3333333333333333,False,True
Jmcduff5,9,5,14,12,0,Strong community,2,0.8571428571428571,0.14285714285714285,False,False
Junior_Razzmatazz164,5,3,8,9,0,Strong community,1,1.125,0.125,False,False
MisfireMillennial,6,4,10,11,0,Strong community,1,1.1,0.1,False,False
Monty_Bentley,14,8,22,22,0,Strong community,0,1.0,0.0,False,False
PerspectiveViews,5,3,8,9,0,Strong community,1,1.125,0.125,False,False
Significant_Arm4246,21,9,30,16,2,Strong community,14,0.5333333333333333,0.4666666666666667,False,True
Sovereign_Black,4,2,6,6,0,Strong community,0,1.0,0.0,False,False
SuperRocketRumble,10,8,18,12,2,Strong community,6,0.6666666666666666,0.3333333333333333,False,True
ary31415,12,9,21,17,0,Strong community,4,0.8095238095238095,0.19047619047619047,False,False
bearington,14,12,26,20,0,Strong community,6,0.7692307692307693,0.23076923076923078,False,True
frederick_the_duck,8,11,19,18,0,Strong community,1,0.9473684210526315,0.05263157894736842,False,False
itsdeeps80,22,17,39,36,2,Strong community,3,0.9230769230769231,0.07692307692307693,False,False
jamerson537,7,6,13,9,0,Strong community,4,0.6923076923076923,0.3076923076923077,False,True
jspook,9,3,12,13,0,Strong community,1,1.0833333333333333,0.08333333333333333,False,False
north_canadian_ice,7,7,14,14,0,Strong community,0,1.0,0.0,False,False
steponmedaddies,8,11,19,19,0,Strong community,0,1.0,0.0,False,False
HistoricalGur6037,0,4,4,4,5,Strong community,0,1.0,0.0,False,False
AakKiinYol,3,0,3,5,5,Strong community,2,1.6666666666666667,0.6666666666666666,False,False
Honka_Ponka,7,10,17,17,1,Strong community,0,1.0,0.0,False,False
HopeRelevant6951,1,3,4,4,5,Strong community,0,1.0,0.0,False,False
Hot-Drama-9802,8,17,25,27,0,Strong community,2,1.08,0.08,False,False
ThrowRAboredinAZ77,13,4,17,18,0,Strong community,1,1.0588235294117647,0.058823529411764705,False,False
HotAdhesiveness2860,2,3,5,4,5,Strong community,1,0.8,0.2,False,False
Uncommon_Sense93,4,5,9,10,5,Strong community,1,1.1111111111111112,0.1111111111111111,False,False
Humble-Math6565,5,5,10,13,0,Strong community,3,1.3,0.3,False,True
BigBoetje,21,13,34,33,0,Strong community,1,0.9705882352941176,0.029411764705882353,False,False
TheManInTheShack,5,4,9,8,0,Strong community,1,0.8888888888888888,0.1111111111111111,False,False
HuntFlimsy2354,3,10,13,17,3,Strong community,4,1.3076923076923077,0.3076923076923077,False,True
HyacinthMacaw13,13,23,36,42,0,Strong community,6,1.1666666666666667,0.16666666666666666,False,False
Chronoblivion,14,8,22,21,0,Strong community,1,0.9545454545454546,0.045454545454545456,False,False
Imaginary_Day_876,8,8,16,17,0,Strong community,1,1.0625,0.0625,False,False
ICuriosityCatI,7,15,22,27,0,Strong community,5,1.2272727272727273,0.22727272727272727,False,True
Real-Intention-7998,29,45,74,83,0,Strong community,9,1.1216216216216217,0.12162162162162163,True,False
Hard-Object2,4,3,7,7,14,Noisy community,0,1.0,0.0,False,False
RL203,7,3,10,9,2,Strong community,1,0.9,0.1,False,False
iOawe,16,3,19,17,1,Strong community,2,0.8947368421052632,0.10526315789473684,False,False
I_Lick_Emus,7,9,16,23,0,Strong community,7,1.4375,0.4375,False,True
I_Short_TSLA,7,19,26,31,0,Strong community,5,1.1923076923076923,0.19230769230769232,False,False
Iamnotcrazy_youare,11,38,49,17,7,Weak community,32,0.3469387755102041,0.6530612244897959,False,True
BeginningMedia4738,11,7,18,16,0,Strong community,2,0.8888888888888888,0.1111111111111111,False,False
Dusk_Flame_11th,15,5,20,5,7,Weak community,15,0.25,0.75,False,True
Hapciuuu,6,4,10,9,0,Strong community,1,0.9,0.1,False,False
KarsaOrlong1,7,4,11,4,7,Weak community,7,0.36363636363636365,0.6363636363636364,False,True
KingJayKayT,5,5,10,9,7,Weak community,1,0.9,0.1,False,False
TheBrutalVegan,4,3,7,3,7,Weak community,4,0.42857142857142855,0.5714285714285714,False,True
Vanaquish231,6,5,11,5,7,Weak community,6,0.45454545454545453,0.5454545454545454,False,True
acassiopa,7,7,14,7,7,Weak community,7,0.5,0.5,False,True
strawberry_jaaam,17,18,35,43,0,Strong community,8,1.2285714285714286,0.22857142857142856,False,True
vnth93,14,21,35,41,0,Strong community,6,1.1714285714285715,0.17142857142857143,False,False
xAnnie3000,6,4,10,5,7,Weak community,5,0.5,0.5,False,True
yonasismad,3,3,6,4,7,Weak community,2,0.6666666666666666,0.3333333333333333,False,False
IceWorried5205,3,6,9,14,3,Strong community,5,1.5555555555555556,0.5555555555555556,False,True
Ifyouliveinadream,5,11,16,21,0,Strong community,5,1.3125,0.3125,False,True
IllScience1286,14,48,62,60,0,Strong community,2,0.967741935483871,0.03225806451612903,False,False
AlphaBetaSigmaNerd,10,7,17,18,0,Strong community,1,1.0588235294117647,0.058823529411764705,False,False
AppendixN,9,4,13,14,0,Strong community,1,1.0769230769230769,0.07692307692307693,False,False
ChazzLamborghini,13,4,17,14,2,Strong community,3,0.8235294117647058,0.17647058823529413,False,False
R1R1FyaNeg,18,45,63,76,0,Strong community,13,1.2063492063492063,0.20634920634920634,False,False
The_White_Ram,17,12,29,31,0,Strong community,2,1.0689655172413792,0.06896551724137931,False,False
TownAfterTown,12,9,21,22,0,Strong community,1,1.0476190476190477,0.047619047619047616,False,False
ImA10inPuyallup,4,13,17,19,1,Strong community,2,1.1176470588235294,0.11764705882352941,False,False
I-own-a-shovel,6,2,8,8,1,Strong community,0,1.0,0.0,False,False
jittery_raccoon,7,7,14,15,1,Strong community,1,1.0714285714285714,0.07142857142857142,False,False
onefellswoop70,8,15,23,25,1,Strong community,2,1.0869565217391304,0.08695652173913043,False,False
Imaginary_Skin_3283,6,11,17,21,0,Strong community,4,1.2352941176470589,0.23529411764705882,False,True
Suspicious_War5435,3,2,5,5,0,Strong community,0,1.0,0.0,False,False
Immediate-River-874,15,77,92,91,0,Strong community,1,0.9891304347826086,0.010869565217391304,True,False
EnvChem89,15,7,22,26,0,Strong community,4,1.1818181818181819,0.18181818181818182,False,False
LastDayWork,7,12,19,23,0,Strong community,4,1.2105263157894737,0.21052631578947367,False,False
Poeking,18,9,27,23,0,Strong community,4,0.8518518518518519,0.14814814814814814,False,False
PoliticsDunnRight,12,19,31,37,0,Strong community,6,1.1935483870967742,0.1935483870967742,False,False
Significant_Bid2142,9,3,12,12,0,Strong community,0,1.0,0.0,False,False
Some_Excitement1659,9,10,19,18,0,Strong community,1,0.9473684210526315,0.05263157894736842,False,False
Witty-Stock-4913,12,5,17,5,9,Strong community,12,0.29411764705882354,0.7058823529411765,False,True
gawddayumboiii,4,21,25,28,0,Strong community,3,1.12,0.12,False,False
midbossstythe,10,8,18,17,0,Strong community,1,0.9444444444444444,0.05555555555555555,False,False
ImpossibleSupport215,1,26,27,19,3,Strong community,8,0.7037037037037037,0.2962962962962963,False,True
MountainDogMama,6,5,11,11,3,Strong community,0,1.0,0.0,False,False
Original-Common-7010,8,4,12,4,30,Noisy community,8,0.3333333333333333,0.6666666666666666,False,False
SomeoneYouDontKnow70,5,0,5,4,3,Strong community,1,0.8,0.2,False,False
Spiritual_Address_18,7,3,10,5,23,Noisy community,5,0.5,0.5,False,False
janus1981,10,10,20,21,3,Strong community,1,1.05,0.05,False,False
Impossible_Host2420,7,10,17,21,0,Strong community,4,1.2352941176470589,0.23529411764705882,False,True
Independent-Long1928,3,6,9,12,3,Strong community,3,1.3333333333333333,0.3333333333333333,False,True
CandylandCanada,9,5,14,16,3,Strong community,2,1.1428571428571428,0.14285714285714285,False,False
LiveKindly01,20,18,38,39,3,Strong community,1,1.0263157894736843,0.02631578947368421,True,False
tosser9212,12,5,17,18,3,Strong community,1,1.0588235294117647,0.058823529411764705,False,False
Independent-Waltz157,6,11,17,18,3,Strong community,1,1.0588235294117647,0.058823529411764705,False,False
radialomens,5,4,9,7,3,Strong community,2,0.7777777777777778,0.2222222222222222,False,False
silentjudge_,6,2,8,9,3,Strong community,1,1.125,0.125,False,False
Inevitable-Walk-9343,1,16,17,18,3,Strong community,1,1.0588235294117647,0.058823529411764705,False,False
fishling,7,4,11,11,0,Strong community,0,1.0,0.0,False,False
Infamous-Interest499,4,16,20,21,3,Strong community,1,1.05,0.05,False,False
Classic_Might_5948,5,3,8,7,3,Strong community,1,0.875,0.125,False,False
ThisWillAgeWell,14,13,27,29,3,Strong community,2,1.0740740740740742,0.07407407407407407,False,False
Garblin,7,3,10,9,4,Strong community,1,0.9,0.1,False,False
InsideTrack6955,17,26,43,49,0,Strong community,6,1.1395348837209303,0.13953488372093023,False,False
Interesting-Sail1414,18,28,46,60,0,Strong community,14,1.3043478260869565,0.30434782608695654,False,True
Particular-Flan5721,19,47,66,69,0,Strong community,3,1.0454545454545454,0.045454545454545456,True,False
Interesting_Claim414,27,70,97,117,0,Strong community,20,1.2061855670103092,0.20618556701030927,False,False
AuspiciouslyAutistic,3,3,6,8,0,Strong community,2,1.3333333333333333,0.3333333333333333,False,False
Efficient_Phase1313,4,3,7,7,0,Strong community,0,1.0,0.0,False,False
Eyuplove_,4,3,7,7,0,Strong community,0,1.0,0.0,False,False
HuckleberryEmpty4988,6,3,9,10,0,Strong community,1,1.1111111111111112,0.1111111111111111,False,False
Maximus3311,13,6,19,19,0,Strong community,0,1.0,0.0,False,False
Mediocre-Risk3581,7,4,11,11,0,Strong community,0,1.0,0.0,False,False
TheRunningMD,11,14,25,28,0,Strong community,3,1.12,0.12,False,False
TomatoTrebuchet,14,10,24,25,0,Strong community,1,1.0416666666666667,0.041666666666666664,False,False
Upset_Gerbil,4,3,7,8,0,Strong community,1,1.1428571428571428,0.14285714285714285,False,False
fghhjhffjjhf,15,9,24,35,0,Strong community,11,1.4583333333333333,0.4583333333333333,False,True
lithiumcitizen,7,5,12,14,0,Strong community,2,1.1666666666666667,0.16666666666666666,False,False
trolletariat69,6,2,8,8,0,Strong community,0,1.0,0.0,False,False
Interesting_Shift885,2,40,42,40,3,Strong community,2,0.9523809523809523,0.047619047619047616,False,False
DefiantMemory9,9,5,14,8,9,Strong community,6,0.5714285714285714,0.42857142857142855,False,True
HisGirlFriday1983,18,9,27,24,3,Strong community,3,0.8888888888888888,0.1111111111111111,False,False
Pkfrompa,6,0,6,7,3,Strong community,1,1.1666666666666667,0.16666666666666666,False,False
Uubilicious_The_Wise,18,11,29,28,3,Strong community,1,0.9655172413793104,0.034482758620689655,False,False
kestrova,3,3,6,6,3,Strong community,0,1.0,0.0,False,False
seriouslees,7,4,11,11,3,Strong community,0,1.0,0.0,False,False
Internal-Hat9827,8,26,34,26,1,Strong community,8,0.7647058823529411,0.23529411764705882,False,True
Chemical_Signal2753,18,1,19,19,1,Strong community,0,1.0,0.0,False,False
MinFootspace,8,6,14,16,1,Strong community,2,1.1428571428571428,0.14285714285714285,False,False
YourAdvertisingPal,6,7,13,9,0,Strong community,4,0.6923076923076923,0.3076923076923077,False,True
__wasitacatisaw__,10,10,20,19,1,Strong community,1,0.95,0.05,False,False
thelongestusernameee,2,2,4,2,18,Noisy community,2,0.5,0.5,False,False
IronHorseTitan,1,8,9,9,1,Strong community,0,1.0,0.0,False,False
Kakashisith,6,4,10,10,1,Strong community,0,1.0,0.0,False,False
Petcai,4,3,7,8,1,Strong community,1,1.1428571428571428,0.14285714285714285,False,False
Pompous_Italics,9,1,10,11,1,Strong community,1,1.1,0.1,False,False
TurnoverInfamous3705,3,2,5,6,1,Strong community,1,1.2,0.2,False,False
clothanger,12,0,12,14,1,Strong community,2,1.1666666666666667,0.16666666666666666,False,False
Cool_Relative7359,6,6,12,9,0,Strong community,3,0.75,0.25,False,True
Kerlyle,5,4,9,9,0,Strong community,0,1.0,0.0,False,False
health_throwaway195,10,7,17,17,0,Strong community,0,1.0,0.0,False,False
Jackie_Lantern_,9,23,32,37,0,Strong community,5,1.15625,0.15625,False,False
JagroCrag,14,38,52,54,0,Strong community,2,1.0384615384615385,0.038461538461538464,False,False
Furryballs239,6,5,11,11,0,Strong community,0,1.0,0.0,False,False
Marty-the-monkey,7,5,12,11,0,Strong community,1,0.9166666666666666,0.08333333333333333,False,False
amberlikesowls,7,2,9,4,3,Strong community,5,0.4444444444444444,0.5555555555555556,False,True
thaisweetheart,15,14,29,24,0,Strong community,5,0.8275862068965517,0.1724137931034483,False,False
unscanable,14,9,23,24,0,Strong community,1,1.0434782608695652,0.043478260869565216,False,False
JaguarSad5115,11,91,102,83,1,Strong community,19,0.8137254901960784,0.18627450980392157,True,False
-JustJoel-,6,5,11,11,1,Strong community,0,1.0,0.0,False,False
AdDramatic2351,5,3,8,4,17,Noisy community,4,0.5,0.5,False,False
Aetheldrake,5,2,7,8,1,Strong community,1,1.1428571428571428,0.14285714285714285,False,False
Beautiful_Bag6707,18,10,28,27,0,Strong community,1,0.9642857142857143,0.03571428571428571,False,False
DeliciousBeanWater,5,2,7,5,1,Strong community,2,0.7142857142857143,0.2857142857142857,False,False
F_ur_feelingss,8,5,13,12,1,Strong community,1,0.9230769230769231,0.07692307692307693,False,False
Legitimate_Ad_7822,4,4,8,9,1,Strong community,1,1.125,0.125,False,False
Lost_Roku_Remote,7,108,115,87,1,Strong community,28,0.7565217391304347,0.24347826086956523,False,True
No_Meringue_8736,13,11,24,24,1,Strong community,0,1.0,0.0,False,False
Ok_Marionberry_3118,5,1,6,6,1,Strong community,0,1.0,0.0,False,False
PrpleSparklyUnicrn13,8,3,11,10,1,Strong community,1,0.9090909090909091,0.09090909090909091,False,False
Relevant_Program_958,4,4,8,6,1,Strong community,2,0.75,0.25,False,False
Travelmusicman35,4,1,5,5,1,Strong community,0,1.0,0.0,False,False
Troysmith1,5,3,8,4,2,Strong community,4,0.5,0.5,False,True
diescheide,3,12,15,14,1,Strong community,1,0.9333333333333333,0.06666666666666667,False,False
dinodare,9,4,13,10,1,Strong community,3,0.7692307692307693,0.23076923076923078,False,True
mailslot,9,6,15,15,1,Strong community,0,1.0,0.0,False,False
riri1281,11,23,34,39,0,Strong community,5,1.1470588235294117,0.14705882352941177,False,False
Jakko_Lantarn,1,5,6,8,3,Strong community,2,1.3333333333333333,0.3333333333333333,False,False
accidentalscientist_,5,4,9,7,1,Strong community,2,0.7777777777777778,0.2222222222222222,False,False
Jazlynxoxo,2,9,11,12,3,Strong community,1,1.0909090909090908,0.09090909090909091,False,False
KayItaly,7,5,12,10,3,Strong community,2,0.8333333333333334,0.16666666666666666,False,False
Jazzper1,5,8,13,17,3,Strong community,4,1.3076923076923077,0.3076923076923077,False,True
JustheBean,10,7,17,20,3,Strong community,3,1.1764705882352942,0.17647058823529413,False,False
JesusLovesYouMyChild,13,26,39,47,0,Strong community,8,1.205128205128205,0.20512820512820512,False,False
Current_Mistake800,6,5,11,5,6,Weak community,6,0.45454545454545453,0.5454545454545454,False,True
Mindless_Humor_3156,23,34,57,70,0,Strong community,13,1.2280701754385965,0.22807017543859648,False,True
PrintFearless3249,16,10,26,23,0,Strong community,3,0.8846153846153846,0.11538461538461539,False,False
blumieplume,11,9,20,8,8,Weak community,12,0.4,0.6,False,True
therealallpro,5,5,10,13,0,Strong community,3,1.3,0.3,False,True
JetreL,3,16,19,7,4,Strong community,12,0.3684210526315789,0.631578947368421,False,True
Taraxian,7,6,13,13,0,Strong community,0,1.0,0.0,False,False
Jncocontrol,9,21,30,35,0,Strong community,5,1.1666666666666667,0.16666666666666666,False,False
FakeVoiceOfReason,4,2,6,7,0,Strong community,1,1.1666666666666667,0.16666666666666666,False,False
Johnnyg150,8,12,20,31,0,Strong community,11,1.55,0.55,False,True
Much-Jackfruit2599,9,3,12,12,1,Strong community,0,1.0,0.0,False,False
Qwertyham,15,6,21,17,1,Strong community,4,0.8095238095238095,0.19047619047619047,False,False
Sang1188,6,1,7,8,1,Strong community,1,1.1428571428571428,0.14285714285714285,False,False
buffy624,6,5,11,11,1,Strong community,0,1.0,0.0,False,False
rogue-iceberg,4,1,5,4,1,Strong community,1,0.8,0.2,False,False
Kangaru82,15,69,84,76,1,Strong community,8,0.9047619047619048,0.09523809523809523,True,False
CABILATOR,5,0,5,3,1,Strong community,2,0.6,0.4,False,False
DaveyDumplings,7,3,10,13,1,Strong community,3,1.3,0.3,False,True
Educational_Fox6899,3,1,4,4,1,Strong community,0,1.0,0.0,False,False
Intelligent_Fig_4852,5,4,9,10,1,Strong community,1,1.1111111111111112,0.1111111111111111,False,False
LCJonSnow,8,2,10,10,1,Strong community,0,1.0,0.0,False,False
NothingButACasual,7,8,15,15,1,Strong community,0,1.0,0.0,False,False
hmmyeah3030,9,4,13,12,1,Strong community,1,0.9230769230769231,0.07692307692307693,False,False
Katarack21,5,6,11,13,2,Strong community,2,1.1818181818181819,0.18181818181818182,False,False
174wrestler,11,4,15,13,1,Strong community,2,0.8666666666666667,0.13333333333333333,False,False
Immediate_Loquat_246,5,4,9,4,1,Strong community,5,0.4444444444444444,0.5555555555555556,False,True
Indigo-Waterfall,4,1,5,2,61,Noisy community,3,0.4,0.6,False,False
Ms-Metal,3,5,8,3,33,Noisy community,5,0.375,0.625,False,False
Pale_Row1166,11,5,16,4,6,Weak community,12,0.25,0.75,False,True
Rredhead926,5,4,9,6,1,Strong community,3,0.6666666666666666,0.3333333333333333,False,True
SaltyLonghorn,8,4,12,8,1,Strong community,4,0.6666666666666666,0.3333333333333333,False,True
TestingBrokenGadgets,33,28,61,58,1,Strong community,3,0.9508196721311475,0.04918032786885246,True,False
UniqueGuy362,1,4,5,2,5,Strong community,3,0.4,0.6,False,True
Various_Jaguar_5539,2,4,6,6,5,Strong community,0,1.0,0.0,False,False
itmeMEEPMEEP,7,3,10,3,52,Noisy community,7,0.3,0.7,False,False
Key_Palpitation_7975,5,6,11,16,0,Strong community,5,1.4545454545454546,0.45454545454545453,False,True
Kimzhal,7,39,46,47,0,Strong community,1,1.0217391304347827,0.021739130434782608,False,False
Dependent-Fig-2517,12,5,17,18,0,Strong community,1,1.0588235294117647,0.058823529411764705,False,False
pi_3141592653589,6,6,12,2,44,Noisy community,10,0.16666666666666666,0.8333333333333334,False,False
SkinnerBoxBaddie,10,6,16,16,0,Strong community,0,1.0,0.0,False,False
oversoul00,13,8,21,22,0,Strong community,1,1.0476190476190477,0.047619047619047616,False,False
King_Lothar_,34,108,142,153,0,Strong community,11,1.0774647887323943,0.07746478873239436,True,False
Acrobatic-Stay-9687,7,5,12,8,3,Strong community,4,0.6666666666666666,0.3333333333333333,False,True
BelleColibri,4,3,7,8,0,Strong community,1,1.1428571428571428,0.14285714285714285,False,False
Fragrant-Swing-1106,8,6,14,11,0,Strong community,3,0.7857142857142857,0.21428571428571427,False,False
JJSF2021,5,3,8,9,0,Strong community,1,1.125,0.125,False,False
JadedDruid,36,25,61,55,0,Strong community,6,0.9016393442622951,0.09836065573770492,False,False
Lorguis,10,7,17,17,0,Strong community,0,1.0,0.0,False,False
Mediocre-Pudding-815,1,5,6,7,0,Strong community,1,1.1666666666666667,0.16666666666666666,False,False
PublikSkoolGradU8,16,4,20,24,0,Strong community,4,1.2,0.2,False,False
TheTrueCampor,7,4,11,13,0,Strong community,2,1.1818181818181819,0.18181818181818182,False,False
TrueKing9458,5,2,7,8,0,Strong community,1,1.1428571428571428,0.14285714285714285,False,False
WhoopsDroppedTheBaby,3,3,6,7,0,Strong community,1,1.1666666666666667,0.16666666666666666,False,False
_segamega_,3,2,5,6,0,Strong community,1,1.2,0.2,False,False
blangenie,5,4,9,9,0,Strong community,0,1.0,0.0,False,False
disisathrowaway,12,7,19,20,0,Strong community,1,1.0526315789473684,0.05263157894736842,False,False
drtropo,14,12,26,22,0,Strong community,4,0.8461538461538461,0.15384615384615385,False,False
thebottomblocks,8,6,14,14,0,Strong community,0,1.0,0.0,False,False
ThemisChosen,8,3,11,13,0,Strong community,2,1.1818181818181819,0.18181818181818182,False,False
Realistic-Weight5078,5,3,8,7,1,Strong community,1,0.875,0.125,False,False
Tired_Redneck,4,3,7,8,1,Strong community,1,1.1428571428571428,0.14285714285714285,False,False
ktbear716,13,4,17,15,1,Strong community,2,0.8823529411764706,0.11764705882352941,False,False
AmusingMusing7,8,5,13,10,2,Strong community,3,0.7692307692307693,0.23076923076923078,False,True
Automatic-Flounder-3,18,14,32,25,2,Strong community,7,0.78125,0.21875,False,False
CrawlerSiegfriend,9,0,9,9,2,Strong community,0,1.0,0.0,False,False
LateralEntry,22,15,37,24,2,Strong community,13,0.6486486486486487,0.35135135135135137,False,True
NOOBFUNK,10,4,14,10,2,Strong community,4,0.7142857142857143,0.2857142857142857,False,True
NekoCatSidhe,37,19,56,54,2,Strong community,2,0.9642857142857143,0.03571428571428571,False,False
Tw1tcHy,16,18,34,29,2,Strong community,5,0.8529411764705882,0.14705882352941177,False,False
equiNine,14,8,22,21,2,Strong community,1,0.9545454545454546,0.045454545454545456,False,False
goddamnitwhalen,24,19,43,43,2,Strong community,0,1.0,0.0,False,False
jethomas5,12,15,27,25,2,Strong community,2,0.9259259259259259,0.07407407407407407,False,False
neverendingchalupas,18,17,35,34,2,Strong community,1,0.9714285714285714,0.02857142857142857,False,False
stinkywrinkly,8,9,17,17,2,Strong community,0,1.0,0.0,False,False
xXxdethl0rdxXx,9,3,12,10,2,Strong community,2,0.8333333333333334,0.16666666666666666,False,False
Over-Group8722,9,5,14,15,0,Strong community,1,1.0714285714285714,0.07142857142857142,False,False
Late-Reception-2897,10,18,28,32,0,Strong community,4,1.1428571428571428,0.14285714285714285,False,False
Late_Gap2089,7,12,19,25,0,Strong community,6,1.3157894736842106,0.3157894736842105,False,True
Paradoxe-999,8,9,17,17,0,Strong community,0,1.0,0.0,False,False
Vanman04,11,2,13,9,0,Strong community,4,0.6923076923076923,0.3076923076923077,False,True
Leading-Ostrich200,8,21,29,29,0,Strong community,0,1.0,0.0,False,False
StockfishLaughed,11,5,16,17,0,Strong community,1,1.0625,0.0625,False,False
saltedmangos,13,6,19,12,0,Strong community,7,0.631578947368421,0.3684210526315789,False,True
LeagueEfficient5945,6,19,25,32,0,Strong community,7,1.28,0.28,False,True
Much-Performer1190,7,6,13,10,0,Strong community,3,0.7692307692307693,0.23076923076923078,False,True
cereal_killer1337,7,4,11,12,0,Strong community,1,1.0909090909090908,0.09090909090909091,False,False
LeonidasKing,13,91,104,105,2,Strong community,1,1.0096153846153846,0.009615384615384616,True,False
AlChandus,6,5,11,11,2,Strong community,0,1.0,0.0,False,False
Baselines_shift,10,9,19,18,2,Strong community,1,0.9473684210526315,0.05263157894736842,False,False
Iustis,14,10,24,22,2,Strong community,2,0.9166666666666666,0.08333333333333333,False,False
LukasJackson67,18,13,31,30,2,Strong community,1,0.967741935483871,0.03225806451612903,False,False
NJBarFly,7,9,16,6,4,Strong community,10,0.375,0.625,False,True
RabbaJabba,14,8,22,23,2,Strong community,1,1.0454545454545454,0.045454545454545456,False,False
YakCDaddy,6,6,12,8,2,Strong community,4,0.6666666666666666,0.3333333333333333,False,True
bjdevar25,22,12,34,25,2,Strong community,9,0.7352941176470589,0.2647058823529412,False,True
bones_bones1,13,1,14,14,2,Strong community,0,1.0,0.0,False,False
cpatkyanks24,8,2,10,11,2,Strong community,1,1.1,0.1,False,False
eldomtom2,6,4,10,10,2,Strong community,0,1.0,0.0,False,False
furtive_phrasing_,24,70,94,98,0,Strong community,4,1.0425531914893618,0.0425531914893617,True,False
rctid_taco,9,10,19,16,2,Strong community,3,0.8421052631578947,0.15789473684210525,False,False
schistkicker,14,11,25,25,2,Strong community,0,1.0,0.0,False,False
servetheKitty,5,7,12,12,2,Strong community,0,1.0,0.0,False,False
tekyy342,15,6,21,23,2,Strong community,2,1.0952380952380953,0.09523809523809523,False,False
Flapjack_Ace,6,3,9,1,25,Noisy community,8,0.1111111111111111,0.8888888888888888,False,False
Fulg3n,12,5,17,15,0,Strong community,2,0.8823529411764706,0.11764705882352941,False,False
Gauss-JordanMatrix,5,4,9,9,0,Strong community,0,1.0,0.0,False,False
Legal-Hunt-93,6,6,12,12,0,Strong community,0,1.0,0.0,False,False
ManofTheNightsWatch,5,4,9,11,0,Strong community,2,1.2222222222222223,0.2222222222222222,False,False
Revachol_Dawn,9,8,17,15,0,Strong community,2,0.8823529411764706,0.11764705882352941,False,False
VirtualMoneyLover,13,16,29,27,0,Strong community,2,0.9310344827586207,0.06896551724137931,False,False
seattleseahawks2014,3,6,9,2,43,Noisy community,7,0.2222222222222222,0.7777777777777778,False,False
unitedshoes,9,13,22,22,0,Strong community,0,1.0,0.0,False,False
Life-Dinner-8516,3,19,22,19,3,Strong community,3,0.8636363636363636,0.13636363636363635,False,False
sreno77,15,5,20,19,3,Strong community,1,0.95,0.05,False,False
Lightlicker3000,3,27,30,22,1,Strong community,8,0.7333333333333333,0.26666666666666666,False,True
Blecher_onthe_Hudson,4,6,10,9,1,Strong community,1,0.9,0.1,False,False
OrthodoxAnarchoMom,11,5,16,14,1,Strong community,2,0.875,0.125,False,False
Quiet-Joke6518,4,3,7,4,20,Noisy community,3,0.5714285714285714,0.42857142857142855,False,False
Raptor_197,4,2,6,2,20,Noisy community,4,0.3333333333333333,0.6666666666666666,False,False
LilWackmutant,3,18,21,13,4,Strong community,8,0.6190476190476191,0.38095238095238093,False,True
InvestigatorOk7015,8,3,11,12,4,Strong community,1,1.0909090909090908,0.09090909090909091,False,False
Ok-Condition-6932,6,4,10,3,4,Strong community,7,0.3,0.7,False,True
Story_Man_75,10,5,15,7,4,Strong community,8,0.4666666666666667,0.5333333333333333,False,True
TFOLLT,4,2,6,6,4,Strong community,0,1.0,0.0,False,False
LiquidAssholeOfDeath,8,19,27,34,0,Strong community,7,1.2592592592592593,0.25925925925925924,False,True
Livid-Equal9311,1,2,3,3,62,Noisy community,0,1.0,0.0,False,False
VioletteToussaint,1,1,2,3,62,Noisy community,1,1.5,0.5,False,False
LocationOld6656,5,48,53,50,1,Strong community,3,0.9433962264150944,0.05660377358490566,False,False
CandelaBelen,4,3,7,7,1,Strong community,0,1.0,0.0,False,False
CarrieDurst,10,9,19,12,9,Strong community,7,0.631578947368421,0.3684210526315789,False,True
Reflxing,5,51,56,48,1,Strong community,8,0.8571428571428571,0.14285714285714285,False,False
faux-fox-paws,6,5,11,10,0,Strong community,1,0.9090909090909091,0.09090909090909091,False,False
weedful_things,3,4,7,5,1,Strong community,2,0.7142857142857143,0.2857142857142857,False,False
Logical_Trainer1939,3,10,13,21,3,Strong community,8,1.6153846153846154,0.6153846153846154,False,True
Tobias_Kitsune,6,4,10,10,0,Strong community,0,1.0,0.0,False,False
Lonely-Medicine-8832,11,17,28,35,0,Strong community,7,1.25,0.25,False,True
Loopy_Legend,3,11,14,18,0,Strong community,4,1.2857142857142858,0.2857142857142857,False,True
I-am-that-b,8,6,14,8,1,Strong community,6,0.5714285714285714,0.42857142857142855,False,True
Miss_Honesty_,5,2,7,6,0,Strong community,1,0.8571428571428571,0.14285714285714285,False,False
No-Recording-7486,5,2,7,7,1,Strong community,0,1.0,0.0,False,False
Oheligud,6,8,14,16,1,Strong community,2,1.1428571428571428,0.14285714285714285,False,False
Open-Gate-7769,5,17,22,19,1,Strong community,3,0.8636363636363636,0.13636363636363635,False,False
Own_Reaction9442,8,7,15,15,1,Strong community,0,1.0,0.0,False,False
PjJones91,12,7,19,15,1,Strong community,4,0.7894736842105263,0.21052631578947367,False,False
Spirited-Humor-554,6,2,8,8,1,Strong community,0,1.0,0.0,False,False
Talk-O-Boy,7,5,12,10,1,Strong community,2,0.8333333333333334,0.16666666666666666,False,False
ThePepperPopper,2,2,4,2,1,Strong community,2,0.5,0.5,False,False
eugeneugene,8,4,12,12,1,Strong community,0,1.0,0.0,False,False
mr-snrub-,6,3,9,8,1,Strong community,1,0.8888888888888888,0.1111111111111111,False,False
-Resident-One-,8,7,15,16,0,Strong community,1,1.0666666666666667,0.06666666666666667,False,False
2074red2074,4,3,7,3,44,Noisy community,4,0.42857142857142855,0.5714285714285714,False,False
BeastMasterHung7769,11,7,18,14,0,Strong community,4,0.7777777777777778,0.2222222222222222,False,True
Formal-Hat-7533,7,6,13,12,0,Strong community,1,0.9230769230769231,0.07692307692307693,False,False
IndependentlyBrewed,6,4,10,1,45,Noisy community,9,0.1,0.9,False,False
LongConsideration662,6,6,12,11,0,Strong community,1,0.9166666666666666,0.08333333333333333,False,False
MenuZealousideal9058,7,21,28,33,0,Strong community,5,1.1785714285714286,0.17857142857142858,False,False
Muadeeb,10,7,17,15,0,Strong community,2,0.8823529411764706,0.11764705882352941,False,False
Remarkable-Set5434,13,29,42,48,0,Strong community,6,1.1428571428571428,0.14285714285714285,False,False
Rogue_Wisdom,5,2,7,7,0,Strong community,0,1.0,0.0,False,False
Sea_Entrepreneur6204,10,4,14,16,0,Strong community,2,1.1428571428571428,0.14285714285714285,False,False
Straight-Simple7705,4,3,7,4,0,Strong community,3,0.5714285714285714,0.42857142857142855,False,True
Tall-Attitude5836,6,5,11,11,0,Strong community,0,1.0,0.0,False,False
TipImpossible1343,11,15,26,32,0,Strong community,6,1.2307692307692308,0.23076923076923078,False,True
Total-Lecture2888,5,3,8,9,0,Strong community,1,1.125,0.125,False,False
Vegetable-College-17,4,3,7,7,0,Strong community,0,1.0,0.0,False,False
craterIII,4,2,6,3,1,Strong community,3,0.5,0.5,False,True
jbslaw1214,10,5,15,16,0,Strong community,1,1.0666666666666667,0.06666666666666667,False,False
lonecylinder,7,4,11,11,0,Strong community,0,1.0,0.0,False,False
okiujh,13,48,61,71,0,Strong community,10,1.1639344262295082,0.16393442622950818,True,False
phleshlight,7,5,12,3,44,Noisy community,9,0.25,0.75,False,False
snakeoilHero,8,4,12,7,0,Strong community,5,0.5833333333333334,0.4166666666666667,False,True
Low-Forever8802,4,7,11,17,0,Strong community,6,1.5454545454545454,0.5454545454545454,False,True
ChronicCactus,4,2,6,8,0,Strong community,2,1.3333333333333333,0.3333333333333333,False,False
Loves_octopus,11,6,17,7,1,Strong community,10,0.4117647058823529,0.5882352941176471,False,True
Low_Tooth230,2,5,7,4,53,Noisy community,3,0.5714285714285714,0.42857142857142855,False,False
GhostyUnleashed,2,1,3,3,53,Noisy community,0,1.0,0.0,False,False
Sensate613,2,2,4,5,53,Noisy community,1,1.25,0.25,False,False
GM_Pax,6,5,11,11,1,Strong community,0,1.0,0.0,False,False
IShitMyFuckingPants,3,5,8,9,1,Strong community,1,1.125,0.125,False,False
Slappadabike91,6,2,8,6,1,Strong community,2,0.75,0.25,False,False
Stagnu_Demorte,7,6,13,8,1,Strong community,5,0.6153846153846154,0.38461538461538464,False,True
MINGIONOFFICIAL,3,6,9,5,4,Strong community,4,0.5555555555555556,0.4444444444444444,False,True
kep_x124,2,18,20,21,4,Strong community,1,1.05,0.05,False,False
Madotsuki2,12,23,35,40,0,Strong community,5,1.1428571428571428,0.14285714285714285,False,False
Latin_Stallion7777,2,1,3,4,0,Strong community,1,1.3333333333333333,0.3333333333333333,False,False
SeeRecursion,16,15,31,29,0,Strong community,2,0.9354838709677419,0.06451612903225806,False,False
MajesticBread9147,21,26,47,48,0,Strong community,1,1.0212765957446808,0.02127659574468085,False,False
varnums1666,18,16,34,34,0,Strong community,0,1.0,0.0,False,False
Major_Tap4199,22,67,89,91,0,Strong community,2,1.0224719101123596,0.02247191011235955,True,False
FjortoftsAirplane,4,4,8,10,0,Strong community,2,1.25,0.25,False,False
ImNoLawyer,16,8,24,17,0,Strong community,7,0.7083333333333334,0.2916666666666667,False,True
Sorry-Joke-4325,14,10,24,22,0,Strong community,2,0.9166666666666666,0.08333333333333333,False,False
WatcherOfStarryAbyss,11,9,20,18,0,Strong community,2,0.9,0.1,False,False
cinnamon64329,9,8,17,4,23,Noisy community,13,0.23529411764705882,0.7647058823529411,False,False
solariam,8,4,12,6,11,Weak community,6,0.5,0.5,False,True
ManHasJam,17,111,128,127,0,Strong community,1,0.9921875,0.0078125,True,False
FreeGazaToday,9,3,12,12,0,Strong community,0,1.0,0.0,False,False
Gryffindorcommoner,10,9,19,14,2,Strong community,5,0.7368421052631579,0.2631578947368421,False,True
LankyEvening7548,6,5,11,11,0,Strong community,0,1.0,0.0,False,False
NotACommie24,16,10,26,26,0,Strong community,0,1.0,0.0,False,False
Standupaddict,4,2,6,5,2,Strong community,1,0.8333333333333334,0.16666666666666666,False,False
StockAdeptness9452,3,2,5,6,0,Strong community,1,1.2,0.2,False,False
TangoJavaTJ,18,7,25,25,0,Strong community,0,1.0,0.0,False,False
TankyRo,6,4,10,10,0,Strong community,0,1.0,0.0,False,False
answer_giver78,3,2,5,2,4,Strong community,3,0.4,0.6,False,True
apophis-pegasus,10,4,14,14,0,Strong community,0,1.0,0.0,False,False
fruitful_discussion,7,5,12,12,0,Strong community,0,1.0,0.0,False,False
hamletswords,8,4,12,14,0,Strong community,2,1.1666666666666667,0.16666666666666666,False,False
ilGeno,4,2,6,4,0,Strong community,2,0.6666666666666666,0.3333333333333333,False,False
khoawala,8,6,14,14,0,Strong community,0,1.0,0.0,False,False
marxist-teddybear,13,10,23,22,0,Strong community,1,0.9565217391304348,0.043478260869565216,False,False
nar_tapio_00,10,13,23,30,0,Strong community,7,1.3043478260869565,0.30434782608695654,False,True
nightim3,7,2,9,9,0,Strong community,0,1.0,0.0,False,False
rdsuxiszdix,5,5,10,8,0,Strong community,2,0.8,0.2,False,False
the_other_brand,6,4,10,10,0,Strong community,0,1.0,0.0,False,False
turtleduck,5,3,8,8,0,Strong community,0,1.0,0.0,False,False
garden_dragonfly,14,12,26,22,0,Strong community,4,0.8461538461538461,0.15384615384615385,False,False
Massive-Albatross823,3,9,12,7,4,Strong community,5,0.5833333333333334,0.4166666666666667,False,True
Feyle,5,4,9,7,43,Noisy community,2,0.7777777777777778,0.2222222222222222,False,False
PitifulEar3303,5,49,54,13,4,Strong community,41,0.24074074074074073,0.7592592592592593,False,True
MathProg999,8,17,25,31,0,Strong community,6,1.24,0.24,False,True
MattCrispMan117,5,9,14,9,4,Strong community,5,0.6428571428571429,0.35714285714285715,False,True
ChChChillian,3,2,5,3,4,Strong community,2,0.6,0.4,False,False
man-vs-spider,11,21,32,31,0,Strong community,1,0.96875,0.03125,False,False
MegaZeroX7,0,69,69,46,1,Strong community,23,0.6666666666666666,0.3333333333333333,False,False
Cheeseish,9,6,15,12,1,Strong community,3,0.8,0.2,False,False
Dogeata99,5,5,10,10,1,Strong community,0,1.0,0.0,False,False
StargazerRex,11,10,21,14,0,Strong community,7,0.6666666666666666,0.3333333333333333,False,True
WitnessRadiant650,9,5,14,13,1,Strong community,1,0.9285714285714286,0.07142857142857142,False,False
chronberries,20,10,30,10,1,Strong community,20,0.3333333333333333,0.6666666666666666,False,True
kylebertram,4,6,10,4,21,Noisy community,6,0.4,0.6,False,False
PeneshTheTurkey,7,6,13,13,0,Strong community,0,1.0,0.0,False,False
Meme_stonkputbuyer,5,10,15,15,0,Strong community,0,1.0,0.0,False,False
MercyfulFan,1,4,5,3,5,Strong community,2,0.6,0.4,False,False
JPDG,6,3,9,8,0,Strong community,1,0.8888888888888888,0.1111111111111111,False,False
Metro29993,6,51,57,58,0,Strong community,1,1.0175438596491229,0.017543859649122806,False,False
MickeyKae,9,10,19,28,0,Strong community,9,1.4736842105263157,0.47368421052631576,False,True
MichaelStone987,4,10,14,15,0,Strong community,1,1.0714285714285714,0.07142857142857142,False,False
MiddleList52,4,11,15,19,0,Strong community,4,1.2666666666666666,0.26666666666666666,False,True
Joubachi,6,1,7,6,1,Strong community,1,0.8571428571428571,0.14285714285714285,False,False
DeHarigeTuinkabouter,10,6,16,17,1,Strong community,1,1.0625,0.0625,False,False
Specific_Bass_5869,9,7,16,14,1,Strong community,2,0.875,0.125,False,False
bruhbelacc,4,3,7,7,1,Strong community,0,1.0,0.0,False,False
pistachio-pie,4,7,11,12,1,Strong community,1,1.0909090909090908,0.09090909090909091,False,False
stprnn,3,5,8,3,48,Noisy community,5,0.375,0.625,False,False
tomerFire,10,15,25,25,3,Strong community,0,1.0,0.0,False,False
MountainHigh31,10,3,13,12,0,Strong community,1,0.9230769230769231,0.07692307692307693,False,False
Zweilous123,14,27,41,56,0,Strong community,15,1.3658536585365855,0.36585365853658536,False,True
MinnLovesTheSceneryy,4,4,8,10,3,Strong community,2,1.25,0.25,False,False
KaliTheBlaze,7,4,11,12,3,Strong community,1,1.0909090909090908,0.09090909090909091,False,False
ptheresadactyl,8,6,14,15,3,Strong community,1,1.0714285714285714,0.07142857142857142,False,False
Mirantibus88,4,17,21,22,1,Strong community,1,1.0476190476190477,0.047619047619047616,False,False
DeaconSage,3,2,5,2,21,Noisy community,3,0.4,0.6,False,False
TheLordofthething,6,2,8,7,1,Strong community,1,0.875,0.125,False,False
TrustSweet,6,10,16,12,1,Strong community,4,0.75,0.25,False,True
MisterMittens64,4,7,11,14,2,Strong community,3,1.2727272727272727,0.2727272727272727,False,True
SoggyGrayDuck,9,6,15,17,2,Strong community,2,1.1333333333333333,0.13333333333333333,False,False
MobileShirt4924,4,15,19,14,1,Strong community,5,0.7368421052631579,0.2631578947368421,False,True
decafade9,7,4,11,3,18,Noisy community,8,0.2727272727272727,0.7272727272727273,False,False
MockingJ1776,8,16,24,30,3,Strong community,6,1.25,0.25,False,True
EmceeSuzy,17,10,27,28,3,Strong community,1,1.037037037037037,0.037037037037037035,False,False
MrBleuPotato,6,22,28,26,3,Strong community,2,0.9285714285714286,0.07142857142857142,False,False
1962Michael,4,3,7,4,19,Noisy community,3,0.5714285714285714,0.42857142857142855,False,False
Bluebunnywitch,8,10,18,12,9,Strong community,6,0.6666666666666666,0.3333333333333333,False,True
Mrkvitko,11,17,28,35,0,Strong community,7,1.25,0.25,False,True
Much-Honey-8607,3,12,15,19,3,Strong community,4,1.2666666666666666,0.26666666666666666,False,True
Mundane-Laugh8562,4,4,8,11,0,Strong community,3,1.375,0.375,False,True
Mundane_Topic4165,3,11,14,12,3,Strong community,2,0.8571428571428571,0.14285714285714285,False,False
Beruthiel999,8,7,15,2,46,Noisy community,13,0.13333333333333333,0.8666666666666667,False,False
Niceotropic,10,76,86,40,1,Strong community,46,0.46511627906976744,0.5348837209302325,False,True
Ok-Cheetah-9125,6,1,7,7,3,Strong community,0,1.0,0.0,False,False
MycologistThen8716,3,10,13,20,3,Strong community,7,1.5384615384615385,0.5384615384615384,False,True
Mysterious-Fact1887,4,8,12,14,3,Strong community,2,1.1666666666666667,0.16666666666666666,False,False
grayscale001,8,5,13,12,0,Strong community,1,0.9230769230769231,0.07692307692307693,False,False
Jackandahalfass,4,1,5,3,4,Strong community,2,0.6,0.4,False,False
doriangray42,4,1,5,2,15,Noisy community,3,0.4,0.6,False,False
Ragnaroknight,10,21,31,30,0,Strong community,1,0.967741935483871,0.03225806451612903,False,False
Neat_Attorney_5414,14,31,45,56,0,Strong community,11,1.2444444444444445,0.24444444444444444,False,True
Jealous-Factor7345,7,5,12,12,0,Strong community,0,1.0,0.0,False,False
SocksRocksDocks,7,3,10,8,0,Strong community,2,0.8,0.2,False,False
i_make_orange_rhyme,8,8,16,20,0,Strong community,4,1.25,0.25,False,True
mangongo,6,6,12,12,0,Strong community,0,1.0,0.0,False,False
BuzzBadpants,9,5,14,11,2,Strong community,3,0.7857142857142857,0.21428571428571427,False,False
Confident_Counter471,7,10,17,19,1,Strong community,2,1.1176470588235294,0.11764705882352941,False,False
Famous-Garlic3838,8,5,13,10,2,Strong community,3,0.7692307692307693,0.23076923076923078,False,True
GuestCartographer,13,2,15,12,2,Strong community,3,0.8,0.2,False,False
ItemEven6421,5,3,8,9,1,Strong community,1,1.125,0.125,False,False
cballowe,13,5,18,17,2,Strong community,1,0.9444444444444444,0.05555555555555555,False,False
cptngabozzo,6,3,9,6,0,Strong community,3,0.6666666666666666,0.3333333333333333,False,True
creativ3ace,10,11,21,27,1,Strong community,6,1.2857142857142858,0.2857142857142857,False,True
letsgooncemore,4,3,7,7,1,Strong community,0,1.0,0.0,False,False
Nillavuh,38,188,226,234,0,Strong community,8,1.0353982300884956,0.035398230088495575,True,False
Away_Simple_400,7,6,13,15,0,Strong community,2,1.1538461538461537,0.15384615384615385,False,False
Beautiful-Loss7663,9,6,15,14,0,Strong community,1,0.9333333333333333,0.06666666666666667,False,False
Final_Ebb_9091,5,5,10,11,0,Strong community,1,1.1,0.1,False,False
FlarkingSmoo,10,4,14,10,0,Strong community,4,0.7142857142857143,0.2857142857142857,False,True
JoesG527,7,5,12,13,0,Strong community,1,1.0833333333333333,0.08333333333333333,False,False
OccamsRabbit,11,8,19,7,2,Strong community,12,0.3684210526315789,0.631578947368421,False,True
Pasta4ever13,6,3,9,9,0,Strong community,0,1.0,0.0,False,False
SatisfactoryLoaf,11,5,16,15,0,Strong community,1,0.9375,0.0625,False,False
SirWhateversAlot,6,5,11,11,0,Strong community,0,1.0,0.0,False,False
WideAbbreviations6,8,7,15,11,0,Strong community,4,0.7333333333333333,0.26666666666666666,False,True
ethancknight,12,13,25,24,1,Strong community,1,0.96,0.04,False,False
nerojt,14,13,27,24,0,Strong community,3,0.8888888888888888,0.1111111111111111,False,False
pile_of_bees,9,6,15,15,0,Strong community,0,1.0,0.0,False,False
pppalexjack,5,3,8,8,0,Strong community,0,1.0,0.0,False,False
rlyjustanyname,9,5,14,13,0,Strong community,1,0.9285714285714286,0.07142857142857142,False,False
sccamp,6,3,9,10,0,Strong community,1,1.1111111111111112,0.1111111111111111,False,False
that_guy_ontheweb,15,13,28,26,0,Strong community,2,0.9285714285714286,0.07142857142857142,False,False
No-Chart-9387,2,42,44,35,1,Strong community,9,0.7954545454545454,0.20454545454545456,False,False
lebetepuante,3,4,7,8,1,Strong community,1,1.1428571428571428,0.14285714285714285,False,False
whatisupwithmyfood,12,33,45,50,1,Strong community,5,1.1111111111111112,0.1111111111111111,True,False
Objective_Air8976,9,5,14,13,3,Strong community,1,0.9285714285714286,0.07142857142857142,False,False
No-Management4833,2,7,9,11,3,Strong community,2,1.2222222222222223,0.2222222222222222,False,False
No-Squirrel3568,4,6,10,13,3,Strong community,3,1.3,0.3,False,True
Counther,4,2,6,7,3,Strong community,1,1.1666666666666667,0.16666666666666666,False,False
chessNotcheckers247,5,2,7,7,0,Strong community,0,1.0,0.0,False,False
No_Egg5179,3,18,21,23,1,Strong community,2,1.0952380952380953,0.09523809523809523,False,False
X4dow,7,2,9,8,1,Strong community,1,0.8888888888888888,0.1111111111111111,False,False
_AskMyMom_,6,3,9,9,1,Strong community,0,1.0,0.0,False,False
No_Gazelle9054,5,13,18,23,0,Strong community,5,1.2777777777777777,0.2777777777777778,False,True
No_Trust4114,1,13,14,12,3,Strong community,2,0.8571428571428571,0.14285714285714285,False,False
Novel_Pineapple_3576,3,48,51,43,1,Strong community,8,0.8431372549019608,0.1568627450980392,False,False
Alt_2Five,2,3,5,5,1,Strong community,0,1.0,0.0,False,False
Angylisis,13,8,21,21,0,Strong community,0,1.0,0.0,False,False
Foxlikebox,5,6,11,12,1,Strong community,1,1.0909090909090908,0.09090909090909091,False,False
Spotzie27,7,5,12,6,1,Strong community,6,0.5,0.5,False,True
Nubian_Cavalry,2,19,21,24,0,Strong community,3,1.1428571428571428,0.14285714285714285,False,False
soundmixer14,4,6,10,9,5,Strong community,1,0.9,0.1,False,False
NuclearMichy,6,32,38,34,3,Strong community,4,0.8947368421052632,0.10526315789473684,False,False
Chance_Job3980,6,4,10,5,26,Noisy community,5,0.5,0.5,False,False
Early-Light-864,5,6,11,9,3,Strong community,2,0.8181818181818182,0.18181818181818182,False,False
Lunar-Eclipse0204,5,1,6,6,3,Strong community,0,1.0,0.0,False,False
Revnorthwest,5,4,9,10,3,Strong community,1,1.1111111111111112,0.1111111111111111,False,False
SlinkyMalinky20,7,3,10,11,3,Strong community,1,1.1,0.1,False,False
SubstanceAway5947,3,37,40,35,3,Strong community,5,0.875,0.125,False,False
andromache97,8,6,14,13,3,Strong community,1,0.9285714285714286,0.07142857142857142,False,False
romanaribella,2,2,4,4,3,Strong community,0,1.0,0.0,False,False
Nullborne,18,28,46,62,0,Strong community,16,1.3478260869565217,0.34782608695652173,False,True
Numerous-Variety-298,8,15,23,28,3,Strong community,5,1.2173913043478262,0.21739130434782608,False,False
Numerous_Toe_1180,4,10,14,16,3,Strong community,2,1.1428571428571428,0.14285714285714285,False,False
Tough-Combination-37,3,2,5,7,3,Strong community,2,1.4,0.4,False,False
Nusselt,2,38,40,31,1,Strong community,9,0.775,0.225,False,True
HistoricalTowel1127,11,0,11,15,1,Strong community,4,1.3636363636363635,0.36363636363636365,False,False
Rupperrt,6,5,11,10,1,Strong community,1,0.9090909090909091,0.09090909090909091,False,False
ObjectiveMall,4,43,47,50,0,Strong community,3,1.0638297872340425,0.06382978723404255,False,False
Radicalnotion528,14,9,23,26,0,Strong community,3,1.1304347826086956,0.13043478260869565,False,False
12_0z_curls,24,21,45,43,2,Strong community,2,0.9555555555555556,0.044444444444444446,False,False
2057Champs__,11,8,19,19,2,Strong community,0,1.0,0.0,False,False
4BasedFrens,4,5,9,7,2,Strong community,2,0.7777777777777778,0.2222222222222222,False,False
AM_Bokke,25,19,44,41,2,Strong community,3,0.9318181818181818,0.06818181818181818,False,False
AStealthyPerson,3,2,5,5,2,Strong community,0,1.0,0.0,False,False
Ambiwlans,5,7,12,12,2,Strong community,0,1.0,0.0,False,False
AntarcticScaleWorm,13,11,24,22,2,Strong community,2,0.9166666666666666,0.08333333333333333,False,False
ArendtAnhaenger,8,10,18,18,2,Strong community,0,1.0,0.0,False,False
Arkmer,15,5,20,20,2,Strong community,0,1.0,0.0,False,False
AshleyMyers44,10,10,20,18,2,Strong community,2,0.9,0.1,False,False
BKGPrints,32,28,60,61,2,Strong community,1,1.0166666666666666,0.016666666666666666,True,False
BalboaCZ,4,3,7,7,2,Strong community,0,1.0,0.0,False,False
Black_XistenZ,10,13,23,22,2,Strong community,1,0.9565217391304348,0.043478260869565216,False,False
CremePsychological77,10,10,20,19,2,Strong community,1,0.95,0.05,False,False
DickNDiaz,9,10,19,18,2,Strong community,1,0.9473684210526315,0.05263157894736842,False,False
FawningDeer37,13,13,26,26,2,Strong community,0,1.0,0.0,False,False
FuguSandwich,18,7,25,24,2,Strong community,1,0.96,0.04,False,False
HiSno,10,6,16,17,2,Strong community,1,1.0625,0.0625,False,False
Honestly_Nobody,9,12,21,21,2,Strong community,0,1.0,0.0,False,False
Irish_Pineapple,9,7,16,16,2,Strong community,0,1.0,0.0,False,False
Jeffery95,3,3,6,6,2,Strong community,0,1.0,0.0,False,False
Jmoney1088,9,6,15,14,2,Strong community,1,0.9333333333333333,0.06666666666666667,False,False
JustAnotherJon,5,4,9,7,2,Strong community,2,0.7777777777777778,0.2222222222222222,False,False
KeyYak4008,7,9,16,17,2,Strong community,1,1.0625,0.0625,False,False
LiberalAspergers,6,3,9,7,2,Strong community,2,0.7777777777777778,0.2222222222222222,False,False
MagicWishMonkey,9,9,18,17,2,Strong community,1,0.9444444444444444,0.05555555555555555,False,False
Matt2_ASC,13,29,42,40,2,Strong community,2,0.9523809523809523,0.047619047619047616,False,False
MonaSherry,7,3,10,9,2,Strong community,1,0.9,0.1,False,False
New2NewJ,16,10,26,26,2,Strong community,0,1.0,0.0,False,False
Ok_Bandicoot_814,26,24,50,49,2,Strong community,1,0.98,0.02,False,False
Ok_Macaroon6155,12,8,20,20,2,Strong community,0,1.0,0.0,False,False
OneReportersOpinion,4,4,8,8,2,Strong community,0,1.0,0.0,False,False
PlantComprehensive77,14,9,23,3,33,Noisy community,20,0.13043478260869565,0.8695652173913043,False,False
Responsible-Yak9000,6,6,12,12,2,Strong community,0,1.0,0.0,False,False
RonaldTurner88,9,5,14,7,2,Strong community,7,0.5,0.5,False,True
Salty-Snowflake,9,5,14,14,2,Strong community,0,1.0,0.0,False,False
Selethorme,15,17,32,26,2,Strong community,6,0.8125,0.1875,False,False
Silent-Storms,10,6,16,16,2,Strong community,0,1.0,0.0,False,False
Snatchamo,16,15,31,31,2,Strong community,0,1.0,0.0,False,False
Sptsjunkie,38,29,67,65,2,Strong community,2,0.9701492537313433,0.029850746268656716,True,False
The3mbered0ne,10,59,69,75,2,Strong community,6,1.0869565217391304,0.08695652173913043,True,False
TorkBombs,15,5,20,20,2,Strong community,0,1.0,0.0,False,False
Vast_Road7888,8,9,17,17,2,Strong community,0,1.0,0.0,False,False
Virtual-Orchid3065,17,118,135,143,2,Strong community,8,1.0592592592592593,0.05925925925925926,True,False
Wermys,17,14,31,32,2,Strong community,1,1.032258064516129,0.03225806451612903,False,False
__zagat__,25,29,54,50,2,Strong community,4,0.9259259259259259,0.07407407407407407,False,False
datalicearcher,6,4,10,8,2,Strong community,2,0.8,0.2,False,False
dsfox,4,4,8,8,2,Strong community,0,1.0,0.0,False,False
gquax,18,7,25,22,2,Strong community,3,0.88,0.12,False,False
ironyinsideme,12,10,22,22,2,Strong community,0,1.0,0.0,False,False
kevbot918,9,6,15,15,2,Strong community,0,1.0,0.0,False,False
lewkiamurfarther,17,20,37,37,2,Strong community,0,1.0,0.0,False,False
mercfan3,21,9,30,27,2,Strong community,3,0.9,0.1,False,False
mongooser,9,3,12,12,2,Strong community,0,1.0,0.0,False,False
ninfan1977,8,5,13,12,2,Strong community,1,0.9230769230769231,0.07692307692307693,False,False
onlyontuesdays77,20,15,35,35,2,Strong community,0,1.0,0.0,False,False
quizbowler_1,4,1,5,5,2,Strong community,0,1.0,0.0,False,False
robby_arctor,7,6,13,13,2,Strong community,0,1.0,0.0,False,False
stripedvitamin,13,8,21,21,2,Strong community,0,1.0,0.0,False,False
t234k,16,10,26,26,2,Strong community,0,1.0,0.0,False,False
teilani_a,6,3,9,9,2,Strong community,0,1.0,0.0,False,False
telefawx,5,5,10,9,2,Strong community,1,0.9,0.1,False,False
the_original_Retro,17,54,71,72,2,Strong community,1,1.0140845070422535,0.014084507042253521,True,False
trace349,14,12,26,26,2,Strong community,0,1.0,0.0,False,False
umbren,4,5,9,9,2,Strong community,0,1.0,0.0,False,False
KDY_ISD,4,2,6,6,0,Strong community,0,1.0,0.0,False,False
Obvious-Routine3069,1,10,11,11,3,Strong community,0,1.0,0.0,False,False
Odd_Profession_2902,4,8,12,16,0,Strong community,4,1.3333333333333333,0.3333333333333333,False,True
PuzzleheadedShoe5829,78,366,444,440,0,Strong community,4,0.990990990990991,0.009009009009009009,True,False
alwaysright0,10,6,16,17,0,Strong community,1,1.0625,0.0625,False,False
Ok-Buy-4545,19,30,49,66,0,Strong community,17,1.346938775510204,0.3469387755102041,False,True
ArCSelkie37,9,7,16,15,0,Strong community,1,0.9375,0.0625,False,False
GrafZeppelin127,3,2,5,6,0,Strong community,1,1.2,0.2,False,False
Longjumping-Wash-610,5,3,8,6,1,Strong community,2,0.75,0.25,False,False
SoImaRedditUserNow,6,5,11,9,1,Strong community,2,0.8181818181818182,0.18181818181818182,False,False
a_dupuis18,4,3,7,3,28,Noisy community,4,0.42857142857142855,0.5714285714285714,False,False
Ok-Connection6656,8,45,53,53,0,Strong community,0,1.0,0.0,False,False
BigDaddySteve999,7,6,13,13,0,Strong community,0,1.0,0.0,False,False
JC_in_KC,6,3,9,10,0,Strong community,1,1.1111111111111112,0.1111111111111111,False,False
QuantumR4ge,7,8,15,14,0,Strong community,1,0.9333333333333333,0.06666666666666667,False,False
TheRemanence,7,5,12,10,0,Strong community,2,0.8333333333333334,0.16666666666666666,False,False
Ok-Mouse9337,9,19,28,35,0,Strong community,7,1.25,0.25,False,True
Ok-Swimming-8183,7,13,20,23,3,Strong community,3,1.15,0.15,False,False
OkParamedic4664,14,19,33,41,0,Strong community,8,1.2424242424242424,0.24242424242424243,False,True
polyvinylchl0rid,6,5,11,11,0,Strong community,0,1.0,0.0,False,False
OkPlankton2490,5,19,24,23,3,Strong community,1,0.9583333333333334,0.041666666666666664,False,False
Ok_Asparagus7214,3,28,31,33,3,Strong community,2,1.064516129032258,0.06451612903225806,False,False
level100mobboss,2,3,5,3,27,Noisy community,2,0.6,0.4,False,False
Ok_Bodybuilder_2384,25,103,128,144,0,Strong community,16,1.125,0.125,True,False
CommisarJurgen,4,2,6,7,0,Strong community,1,1.1666666666666667,0.16666666666666666,False,False
LynnSeattle,23,20,43,40,0,Strong community,3,0.9302325581395349,0.06976744186046512,False,False
Ornery_Ad_8349,6,4,10,11,0,Strong community,1,1.1,0.1,False,False
Stop_Maximum,11,14,25,37,0,Strong community,12,1.48,0.48,False,True
SweetExpression2745,8,4,12,12,0,Strong community,0,1.0,0.0,False,False
Opagea,4,4,8,6,0,Strong community,2,0.75,0.25,False,False
RigatoniPasta,10,39,49,52,0,Strong community,3,1.0612244897959184,0.061224489795918366,False,False
Saint_Scum,12,19,31,41,0,Strong community,10,1.3225806451612903,0.3225806451612903,False,True
Salt-Lingonberry-853,14,11,25,23,0,Strong community,2,0.92,0.08,False,False
Wintores,7,6,13,12,0,Strong community,1,0.9230769230769231,0.07692307692307693,False,False
pooter6969,14,6,20,15,0,Strong community,5,0.75,0.25,False,True
spinbutton,14,12,26,23,0,Strong community,3,0.8846153846153846,0.11538461538461539,False,False
windershinwishes,3,2,5,4,2,Strong community,1,0.8,0.2,False,False
Ok_Distribution7377,9,10,19,27,0,Strong community,8,1.4210526315789473,0.42105263157894735,False,True
Shineyy_8416,6,5,11,11,0,Strong community,0,1.0,0.0,False,False
jman12234,7,13,20,24,0,Strong community,4,1.2,0.2,False,False
OmniBLVK,12,21,33,44,0,Strong community,11,1.3333333333333333,0.3333333333333333,False,True
BakaDasai,6,5,11,12,0,Strong community,1,1.0909090909090908,0.09090909090909091,False,False
turndownforwomp,6,3,9,9,1,Strong community,0,1.0,0.0,False,False
Opening_Seesaw9816,1,10,11,14,3,Strong community,3,1.2727272727272727,0.2727272727272727,False,True
Scenarioing,7,4,11,12,3,Strong community,1,1.0909090909090908,0.09090909090909091,False,False
Opposite-Witness1416,5,9,14,15,3,Strong community,1,1.0714285714285714,0.07142857142857142,False,False
OrdinaryLeg7199,8,15,23,22,3,Strong community,1,0.9565217391304348,0.043478260869565216,False,False
ChampagneDividends,7,8,15,7,24,Noisy community,8,0.4666666666666667,0.5333333333333333,False,False
PM_ME_YOUR_TATERTITS,2,18,20,19,1,Strong community,1,0.95,0.05,False,False
POUUER,11,31,42,37,2,Strong community,5,0.8809523809523809,0.11904761904761904,False,False
Plastic_Kangaroo5720,3,3,6,3,2,Strong community,3,0.5,0.5,False,True
PacinoWig,11,60,71,73,0,Strong community,2,1.028169014084507,0.028169014084507043,True,False
ElReyResident,11,8,19,20,0,Strong community,1,1.0526315789473684,0.05263157894736842,False,False
MKing150,15,13,28,29,0,Strong community,1,1.0357142857142858,0.03571428571428571,False,False
SocratesWasSmart,11,5,16,17,0,Strong community,1,1.0625,0.0625,False,False
Pale_Consideration87,5,13,18,20,1,Strong community,2,1.1111111111111112,0.1111111111111111,False,False
Pandoratheyawningcat,4,9,13,21,3,Strong community,8,1.6153846153846154,0.6153846153846154,False,True
Dismal-Anybody-1951,11,11,22,18,0,Strong community,4,0.8181818181818182,0.18181818181818182,False,False
Garfish16,10,9,19,17,0,Strong community,2,0.8947368421052632,0.10526315789473684,False,False
Master_Blaster_02,5,6,11,12,0,Strong community,1,1.0909090909090908,0.09090909090909091,False,False
Maximum_Error3083,9,5,14,14,0,Strong community,0,1.0,0.0,False,False
Mobile_Trash8946,4,3,7,5,0,Strong community,2,0.7142857142857143,0.2857142857142857,False,False
ObjectiveAce,4,4,8,8,0,Strong community,0,1.0,0.0,False,False
Sad_Strawberry_5572,12,90,102,104,0,Strong community,2,1.0196078431372548,0.0196078431372549,True,False
TuggenDixon,16,8,24,26,0,Strong community,2,1.0833333333333333,0.08333333333333333,False,False
Ventira,4,3,7,2,45,Noisy community,5,0.2857142857142857,0.7142857142857143,False,False
carsonthecarsinogen,9,4,13,14,0,Strong community,1,1.0769230769230769,0.07692307692307693,False,False
hoarduck,8,11,19,25,0,Strong community,6,1.3157894736842106,0.3157894736842105,False,True
mushinmind,8,4,12,12,0,Strong community,0,1.0,0.0,False,False
peachfluffed,10,10,20,19,0,Strong community,1,0.95,0.05,False,False
ParakeetLover2024,24,74,98,99,0,Strong community,1,1.010204081632653,0.01020408163265306,True,False
DarkNo7318,15,5,20,19,0,Strong community,1,0.95,0.05,False,False
Fluffy-Mango-6607,9,6,15,14,0,Strong community,1,0.9333333333333333,0.06666666666666667,False,False
MaybePrudent3877,4,2,6,6,0,Strong community,0,1.0,0.0,False,False
ferbje,4,3,7,7,0,Strong community,0,1.0,0.0,False,False
whater39,12,10,22,4,31,Noisy community,18,0.18181818181818182,0.8181818181818182,False,False
Particular-Wish-1761,6,35,41,37,3,Strong community,4,0.9024390243902439,0.0975609756097561,False,False
Particular_Flyer,4,35,39,32,3,Strong community,7,0.8205128205128205,0.1794871794871795,False,False
Creepy_Push8629,5,3,8,6,14,Noisy community,2,0.75,0.25,False,False
HistoricalQuail,4,3,7,7,3,Strong community,0,1.0,0.0,False,False
acegirl1985,4,6,10,11,3,Strong community,1,1.1,0.1,False,False
snper101,5,4,9,6,3,Strong community,3,0.6666666666666666,0.3333333333333333,False,True
PerceptionSand,9,28,37,40,0,Strong community,3,1.0810810810810811,0.08108108108108109,False,False
Most-Ad4680,8,6,14,14,0,Strong community,0,1.0,0.0,False,False
Perfect-Caramel-3129,3,6,9,5,4,Strong community,4,0.5555555555555556,0.4444444444444444,False,True
Petkorazzi,4,17,21,21,0,Strong community,0,1.0,0.0,False,False
PharmPhrenzy,4,48,52,56,2,Strong community,4,1.0769230769230769,0.07692307692307693,False,False
Describing_Donkeys,12,8,20,21,2,Strong community,1,1.05,0.05,False,False
FrostyArctic47,10,6,16,16,2,Strong community,0,1.0,0.0,False,False
absolutefunkbucket,8,6,14,14,2,Strong community,0,1.0,0.0,False,False
ides205,6,5,11,12,2,Strong community,1,1.0909090909090908,0.09090909090909091,False,False
tlopez14,18,17,35,33,2,Strong community,2,0.9428571428571428,0.05714285714285714,False,False
OutSourcingJesus,5,1,6,2,12,Weak community,4,0.3333333333333333,0.6666666666666666,False,True
Rombom,7,3,10,7,4,Strong community,3,0.7,0.3,False,True
Pitiful_Mulberry_707,6,10,16,20,0,Strong community,4,1.25,0.25,False,True
PizzaKiller023,6,25,31,35,0,Strong community,4,1.1290322580645162,0.12903225806451613,False,False
TrebleTrouble-912,3,1,4,5,0,Strong community,1,1.25,0.25,False,False
PoisonAppleJeep,5,8,13,18,3,Strong community,5,1.3846153846153846,0.38461538461538464,False,True
LelandHeron,5,3,8,11,3,Strong community,3,1.375,0.375,False,True
PolarizingRay,4,7,11,17,0,Strong community,6,1.5454545454545454,0.5454545454545454,False,True
AevilokE,3,2,5,5,0,Strong community,0,1.0,0.0,False,False
Disastrous-Top2795,4,2,6,6,0,Strong community,0,1.0,0.0,False,False
GamblePuddy,7,13,20,16,0,Strong community,4,0.8,0.2,False,False
Ornithopter1,17,15,32,26,0,Strong community,6,0.8125,0.1875,False,False
PlaneWar203,8,5,13,14,0,Strong community,1,1.0769230769230769,0.07692307692307693,False,False
PresentationLost9811,14,25,39,46,0,Strong community,7,1.1794871794871795,0.1794871794871795,False,False
PumpkinBrioche,4,3,7,3,5,Strong community,4,0.42857142857142855,0.5714285714285714,False,True
entreacteplaylist,6,11,17,25,0,Strong community,8,1.4705882352941178,0.47058823529411764,False,True
kel584,5,4,9,10,0,Strong community,1,1.1111111111111112,0.1111111111111111,False,False
lunacysc,10,3,13,13,0,Strong community,0,1.0,0.0,False,False
roskybosky,4,7,11,6,10,Weak community,5,0.5454545454545454,0.45454545454545453,False,True
PowerfulComplaint189,0,12,12,11,3,Strong community,1,0.9166666666666666,0.08333333333333333,False,False
PowerfulHomework6770,6,25,31,36,0,Strong community,5,1.1612903225806452,0.16129032258064516,False,False
AG_GreenZerg,6,4,10,11,0,Strong community,1,1.1,0.1,False,False
ProgrammerHealthy359,8,4,12,13,0,Strong community,1,1.0833333333333333,0.08333333333333333,False,False
United_Librarian5491,6,6,12,11,0,Strong community,1,0.9166666666666666,0.08333333333333333,False,False
Powerful_Falcon_4006,0,15,15,10,4,Strong community,5,0.6666666666666666,0.3333333333333333,False,False
neodiogenes,6,4,10,7,4,Strong community,3,0.7,0.3,False,True
ven_geci,4,1,5,4,4,Strong community,1,0.8,0.2,False,False
Poxus-q,8,28,36,40,0,Strong community,4,1.1111111111111112,0.1111111111111111,False,False
Life-Income2986,5,5,10,12,0,Strong community,2,1.2,0.2,False,False
blind-octopus,15,13,28,28,0,Strong community,0,1.0,0.0,False,False
this-aint-Lisp,4,2,6,1,12,Weak community,5,0.16666666666666666,0.8333333333333334,False,True
Prestigious-Trust265,2,19,21,21,3,Strong community,0,1.0,0.0,False,False
BigBigBigTree,4,5,9,10,3,Strong community,1,1.1111111111111112,0.1111111111111111,False,False
RoyallyOakie,4,1,5,5,3,Strong community,0,1.0,0.0,False,False
PrizeMeans,2,64,66,47,1,Strong community,19,0.7121212121212122,0.2878787878787879,False,True
Cessna131,3,3,6,4,1,Strong community,2,0.6666666666666666,0.3333333333333333,False,False
HamBoneZippy,5,2,7,5,1,Strong community,2,0.7142857142857143,0.2857142857142857,False,False
Rolltide43,4,6,10,7,0,Strong community,3,0.7,0.3,False,True
TerrapinTribe,5,3,8,6,1,Strong community,2,0.75,0.25,False,False
WasV3,4,3,7,7,1,Strong community,0,1.0,0.0,False,False
ProbablyNotAThingToo,8,18,26,27,3,Strong community,1,1.0384615384615385,0.038461538461538464,False,False
Chance-Idea1090,2,2,4,5,3,Strong community,1,1.25,0.25,False,False
Professional-Scar840,2,38,40,38,3,Strong community,2,0.95,0.05,False,False
ProfessionalMath8873,7,14,21,25,0,Strong community,4,1.1904761904761905,0.19047619047619047,False,False
RX3874,11,7,18,21,0,Strong community,3,1.1666666666666667,0.16666666666666666,False,False
ProfessorHuge5773,4,14,18,22,3,Strong community,4,1.2222222222222223,0.2222222222222222,False,True
thechaoticstorm,4,2,6,7,3,Strong community,1,1.1666666666666667,0.16666666666666666,False,False
ProgrammerKey1380,4,18,22,21,1,Strong community,1,0.9545454545454546,0.045454545454545456,False,False
Placedapatow,5,3,8,6,1,Strong community,2,0.75,0.25,False,False
alc4pwned,6,5,11,12,1,Strong community,1,1.0909090909090908,0.09090909090909091,False,False
bfrancom17,3,1,4,5,1,Strong community,1,1.25,0.25,False,False
Proof_Caregiver_4234,13,19,32,44,0,Strong community,12,1.375,0.375,False,True
Proper-Republic1561,9,21,30,41,0,Strong community,11,1.3666666666666667,0.36666666666666664,False,True
Alien_invader44,8,7,15,17,0,Strong community,2,1.1333333333333333,0.13333333333333333,False,False
Frooctose,4,2,6,3,24,Noisy community,3,0.5,0.5,False,False
PsychLegalMind,9,201,210,200,2,Strong community,10,0.9523809523809523,0.047619047619047616,False,False
Budget_Llama_Shoes,9,6,15,13,2,Strong community,2,0.8666666666666667,0.13333333333333333,False,False
CerddwrRhyddid,11,9,20,15,2,Strong community,5,0.75,0.25,False,True
Dreadedvegas,6,2,8,8,2,Strong community,0,1.0,0.0,False,False
Emergency_Driver_487,6,5,11,11,2,Strong community,0,1.0,0.0,False,False
FormerOSRS,5,4,9,5,48,Noisy community,4,0.5555555555555556,0.4444444444444444,False,False
Forte845,21,22,43,34,0,Strong community,9,0.7906976744186046,0.20930232558139536,False,False
Gweena,4,3,7,7,2,Strong community,0,1.0,0.0,False,False
Orwells_Roses,6,8,14,14,2,Strong community,0,1.0,0.0,False,False
Reld720,9,6,15,15,2,Strong community,0,1.0,0.0,False,False
SammathNaur1600,7,4,11,11,2,Strong community,0,1.0,0.0,False,False
Sammonov,11,11,22,22,2,Strong community,0,1.0,0.0,False,False
Visco0825,10,95,105,107,2,Strong community,2,1.019047619047619,0.01904761904761905,True,False
baby_budda,16,4,20,20,2,Strong community,0,1.0,0.0,False,False
foulpudding,17,5,22,22,2,Strong community,0,1.0,0.0,False,False
jaywst22,5,4,9,9,2,Strong community,0,1.0,0.0,False,False
popeIeo,7,5,12,12,2,Strong community,0,1.0,0.0,False,False
powerboy20,3,1,4,4,2,Strong community,0,1.0,0.0,False,False
rhombecka,7,3,10,10,2,Strong community,0,1.0,0.0,False,False
thewNYC,9,2,11,9,2,Strong community,2,0.8181818181818182,0.18181818181818182,False,False
truthovertribe,13,11,24,22,2,Strong community,2,0.9166666666666666,0.08333333333333333,False,False
Psychological_Roof85,3,15,18,21,0,Strong community,3,1.1666666666666667,0.16666666666666666,False,False
Pure-Veterinarian979,1,17,18,19,1,Strong community,1,1.0555555555555556,0.05555555555555555,False,False
Pure_Chef_8438,5,62,67,48,3,Strong community,19,0.7164179104477612,0.2835820895522388,False,True
Born-Bid8892,6,4,10,8,3,Strong community,2,0.8,0.2,False,False
HomeworkMuch2990,3,1,4,3,3,Strong community,1,0.75,0.25,False,False
Inevitable_Bit_9871,4,3,7,6,10,Weak community,1,0.8571428571428571,0.14285714285714285,False,False
MyFeetLookLikeHands,6,5,11,4,3,Strong community,7,0.36363636363636365,0.6363636363636364,False,True
Ok-Ad-9820,4,4,8,4,30,Noisy community,4,0.5,0.5,False,False
ResponsibilityOk8099,7,8,15,10,3,Strong community,5,0.6666666666666666,0.3333333333333333,False,True
Shadou_Wolf,5,4,9,3,30,Noisy community,6,0.3333333333333333,0.6666666666666666,False,False
f0xbunny,4,2,6,5,30,Noisy community,1,0.8333333333333334,0.16666666666666666,False,False
lionelhutz-,2,3,5,5,3,Strong community,0,1.0,0.0,False,False
wunderduck,5,4,9,5,1,Strong community,4,0.5555555555555556,0.4444444444444444,False,True
AntonioVivaldi7,14,10,24,20,0,Strong community,4,0.8333333333333334,0.16666666666666666,False,False
Background_Sail9797,5,10,15,15,0,Strong community,0,1.0,0.0,False,False
BailysmmmCreamy,5,3,8,9,0,Strong community,1,1.125,0.125,False,False
BluesPatrol,5,5,10,10,0,Strong community,0,1.0,0.0,False,False
Bore-Geist9391,8,7,15,4,46,Noisy community,11,0.26666666666666666,0.7333333333333333,False,False
ChemicalRain5513,8,9,17,17,0,Strong community,0,1.0,0.0,False,False
GroundbreakingBag164,6,4,10,9,0,Strong community,1,0.9,0.1,False,False
Infinite_Sea_5425,3,2,5,2,47,Noisy community,3,0.4,0.6,False,False
Luchadorgreen,5,3,8,8,0,Strong community,0,1.0,0.0,False,False
ManliestBunny,2,1,3,3,0,Strong community,0,1.0,0.0,False,False
NonbinaryYolo,11,7,18,18,0,Strong community,0,1.0,0.0,False,False
PopTheRedPill,5,3,8,2,24,Noisy community,6,0.25,0.75,False,False
Proper_Fun_977,12,6,18,17,0,Strong community,1,0.9444444444444444,0.05555555555555555,False,False
Serafim91,7,8,15,15,0,Strong community,0,1.0,0.0,False,False
Sloooooooooww,10,13,23,26,0,Strong community,3,1.1304347826086956,0.13043478260869565,False,False
Tetris102,4,3,7,7,0,Strong community,0,1.0,0.0,False,False
Total_Explanation549,10,9,19,19,0,Strong community,0,1.0,0.0,False,False
YodaSimp,4,2,6,6,0,Strong community,0,1.0,0.0,False,False
Zakaru99,5,3,8,8,0,Strong community,0,1.0,0.0,False,False
faultydesign,10,3,13,9,0,Strong community,4,0.6923076923076923,0.3076923076923077,False,True
garaile64,17,33,50,65,0,Strong community,15,1.3,0.3,False,True
hunbot19,9,8,17,17,0,Strong community,0,1.0,0.0,False,False
imperfect9119,9,7,16,16,0,Strong community,0,1.0,0.0,False,False
stickemz,3,3,6,6,0,Strong community,0,1.0,0.0,False,False
terragutti,9,9,18,14,0,Strong community,4,0.7777777777777778,0.2222222222222222,False,True
username_31,7,6,13,14,0,Strong community,1,1.0769230769230769,0.07692307692307693,False,False
RLT2000,6,34,40,33,3,Strong community,7,0.825,0.175,False,False
BonusGlittering3328,4,3,7,7,3,Strong community,0,1.0,0.0,False,False
Kittymemesallday,4,3,7,7,3,Strong community,0,1.0,0.0,False,False
ShipComprehensive543,4,3,7,8,3,Strong community,1,1.1428571428571428,0.14285714285714285,False,False
Sufficient_Ad3175,5,5,10,11,3,Strong community,1,1.1,0.1,False,False
remedyman,6,6,12,10,1,Strong community,2,0.8333333333333334,0.16666666666666666,False,False
Radiant_Impress9741,2,6,8,11,3,Strong community,3,1.375,0.375,False,True
Hefty-Association-59,6,9,15,15,2,Strong community,0,1.0,0.0,False,False
Ralphy_1997,7,28,35,41,0,Strong community,6,1.1714285714285715,0.17142857142857143,False,False
Eclipsed830,7,3,10,9,0,Strong community,1,0.9,0.1,False,False
jweezy2045,6,5,11,12,0,Strong community,1,1.0909090909090908,0.09090909090909091,False,False
Rarely99,4,8,12,12,3,Strong community,0,1.0,0.0,False,False
riontach,7,4,11,10,3,Strong community,1,0.9090909090909091,0.09090909090909091,False,False
ReadingwithMe,9,28,37,38,0,Strong community,1,1.027027027027027,0.02702702702702703,False,False
LateQuantity8009,10,4,14,11,1,Strong community,3,0.7857142857142857,0.21428571428571427,False,False
Suspicious_Town_8680,7,12,19,23,0,Strong community,4,1.2105263157894737,0.21052631578947367,False,False
deutschmexican15,11,20,31,34,0,Strong community,3,1.096774193548387,0.0967741935483871,False,False
AnxietyObvious4018,11,7,18,16,0,Strong community,2,0.8888888888888888,0.1111111111111111,False,False
OddDisaster8173,4,4,8,10,0,Strong community,2,1.25,0.25,False,False
hallam81,16,7,23,20,2,Strong community,3,0.8695652173913043,0.13043478260869565,False,False
RealCar40,8,26,34,30,3,Strong community,4,0.8823529411764706,0.11764705882352941,False,False
CountFew6186,17,5,22,23,2,Strong community,1,1.0454545454545454,0.045454545454545456,False,False
ReasonableSir2804,1,5,6,3,5,Strong community,3,0.5,0.5,False,True
LolaAucoin,6,7,13,5,6,Weak community,8,0.38461538461538464,0.6153846153846154,False,True
RecommendationHot929,13,63,76,78,0,Strong community,2,1.0263157894736843,0.02631578947368421,True,False
RichRod91,6,4,10,11,0,Strong community,1,1.1,0.1,False,False
Vexillum211202,8,37,45,48,0,Strong community,3,1.0666666666666667,0.06666666666666667,False,False
Wigglebot23,3,3,6,7,0,Strong community,1,1.1666666666666667,0.16666666666666666,False,False
clforp,4,3,7,5,0,Strong community,2,0.7142857142857143,0.2857142857142857,False,False
JulianPaagman,3,2,5,2,1,Strong community,3,0.4,0.6,False,True
PumpkinSeed776,7,3,10,10,1,Strong community,0,1.0,0.0,False,False
Quiet_Fan_7008,11,6,17,7,1,Strong community,10,0.4117647058823529,0.5882352941176471,False,True
BeefWellingtonSpeedo,4,4,8,6,1,Strong community,2,0.75,0.25,False,False
Future_Telephone281,7,3,10,10,1,Strong community,0,1.0,0.0,False,False
benificialart,7,3,10,8,1,Strong community,2,0.8,0.2,False,False
Reibudaps4,4,12,16,20,0,Strong community,4,1.25,0.25,False,True
Genoscythe_,14,6,20,17,0,Strong community,3,0.85,0.15,False,False
RelationshipOne3837,2,7,9,11,3,Strong community,2,1.2222222222222223,0.2222222222222222,False,False
beanbubger,4,3,7,7,0,Strong community,0,1.0,0.0,False,False
sereniteenoww,10,7,17,17,0,Strong community,0,1.0,0.0,False,False
Remarkable-Steak3710,16,50,66,54,1,Strong community,12,0.8181818181818182,0.18181818181818182,True,False
---why-so-serious---,5,3,8,7,1,Strong community,1,0.875,0.125,False,False
Environmental-Age502,12,6,18,19,1,Strong community,1,1.0555555555555556,0.05555555555555555,False,False
StrokyBoi,3,2,5,3,0,Strong community,2,0.6,0.4,False,False
Thistime232,11,6,17,19,1,Strong community,2,1.1176470588235294,0.11764705882352941,False,False
megryanreynolds,3,4,7,2,63,Noisy community,5,0.2857142857142857,0.7142857142857143,False,False
Responsible-Bunch316,18,31,49,63,0,Strong community,14,1.2857142857142858,0.2857142857142857,False,True
L3onK1ng,8,6,14,14,0,Strong community,0,1.0,0.0,False,False
Overall-Ratio-1446,8,13,21,21,0,Strong community,0,1.0,0.0,False,False
Robinbod,1,4,5,4,1,Strong community,1,0.8,0.2,False,False
RockWheel480,2,7,9,9,1,Strong community,0,1.0,0.0,False,False
Rubicon_Lily,9,20,29,36,0,Strong community,7,1.2413793103448276,0.2413793103448276,False,True
Throwaway7131923,8,21,29,31,0,Strong community,2,1.0689655172413792,0.06896551724137931,False,False
knifeyspoony_champ,8,6,14,14,0,Strong community,0,1.0,0.0,False,False
Sad-Tradition8676,3,4,7,10,5,Strong community,3,1.4285714285714286,0.42857142857142855,False,True
HamasintheHouse,8,6,14,12,0,Strong community,2,0.8571428571428571,0.14285714285714285,False,False
Mr-Steve-O,4,1,5,6,0,Strong community,1,1.2,0.2,False,False
ShoesOfDoom,7,3,10,10,0,Strong community,0,1.0,0.0,False,False
UltimateJDX,3,3,6,6,0,Strong community,0,1.0,0.0,False,False
Saltlakecity126,1,36,37,37,3,Strong community,0,1.0,0.0,False,False
just_mark,2,1,3,3,3,Strong community,0,1.0,0.0,False,False
Samvel_2015,8,11,19,3,38,Noisy community,16,0.15789473684210525,0.8421052631578947,False,False
revengeappendage,10,6,16,19,0,Strong community,3,1.1875,0.1875,False,False
Satinel1,9,15,24,29,0,Strong community,5,1.2083333333333333,0.20833333333333334,False,False
Scary_Remote,1,28,29,31,1,Strong community,2,1.0689655172413792,0.06896551724137931,False,False
smellslikebadussy,9,4,13,2,11,Weak community,11,0.15384615384615385,0.8461538461538461,False,True
ScholarPrize1335,8,24,32,39,0,Strong community,7,1.21875,0.21875,False,False
Secret-Ball7570,11,23,34,39,0,Strong community,5,1.1470588235294117,0.14705882352941177,False,False
SeveralAd6447,7,24,31,36,0,Strong community,5,1.1612903225806452,0.16129032258064516,False,False
BeginningTooth3864,3,2,5,4,51,Noisy community,1,0.8,0.2,False,False
Shadow_dust_180,13,85,98,96,0,Strong community,2,0.9795918367346939,0.02040816326530612,True,False
IAmTheNightSoil,4,5,9,2,11,Weak community,7,0.2222222222222222,0.7777777777777778,False,True
RennietheAquarian,9,10,19,18,0,Strong community,1,0.9473684210526315,0.05263157894736842,False,False
ShandaLear555,2,5,7,7,3,Strong community,0,1.0,0.0,False,False
the_elephant_stan,4,3,7,7,3,Strong community,0,1.0,0.0,False,False
FuggleyBrew,6,5,11,11,0,Strong community,0,1.0,0.0,False,False
PrecisionHat,6,6,12,12,0,Strong community,0,1.0,0.0,False,False
polchiki,9,5,14,14,0,Strong community,0,1.0,0.0,False,False
ShrekOne2024,10,32,42,43,0,Strong community,1,1.0238095238095237,0.023809523809523808,False,False
Fluffy_Analysis_8300,3,3,6,6,0,Strong community,0,1.0,0.0,False,False
mikevago,10,11,21,22,0,Strong community,1,1.0476190476190477,0.047619047619047616,False,False
Side_of_fry,15,45,60,71,0,Strong community,11,1.1833333333333333,0.18333333333333332,True,False
3rdcousin3rdremoved,4,2,6,6,0,Strong community,0,1.0,0.0,False,False
Mundane-Mud2509,4,3,7,7,0,Strong community,0,1.0,0.0,False,False
Signal-Ad3414,3,6,9,12,3,Strong community,3,1.3333333333333333,0.3333333333333333,False,True
SignificantMess2546,3,20,23,19,3,Strong community,4,0.8260869565217391,0.17391304347826086,False,False
Simple-Camel-20,6,39,45,41,3,Strong community,4,0.9111111111111111,0.08888888888888889,False,False
nope-nope-nope-nop,11,9,20,17,2,Strong community,3,0.85,0.15,False,False
abrandis,4,1,5,3,1,Strong community,2,0.6,0.4,False,False
poser765,9,7,16,12,1,Strong community,4,0.75,0.25,False,True
tornado9015,5,3,8,6,1,Strong community,2,0.75,0.25,False,False
Sky_Sumisu,6,14,20,27,0,Strong community,7,1.35,0.35,False,True
SleeplessYellowSun,6,14,20,22,3,Strong community,2,1.1,0.1,False,False
SlideStreet6874,10,67,77,77,1,Strong community,0,1.0,0.0,True,False
Bilbo_Baghands,6,5,11,10,1,Strong community,1,0.9090909090909091,0.09090909090909091,False,False
QuerulousPanda,7,4,11,10,1,Strong community,1,0.9090909090909091,0.09090909090909091,False,False
dam_sharks_mother,6,5,11,2,63,Noisy community,9,0.18181818181818182,0.8181818181818182,False,False
nougat98,8,8,16,17,1,Strong community,1,1.0625,0.0625,False,False
wordwordnumberss,4,4,8,9,1,Strong community,1,1.125,0.125,False,False
SlothSleepingSoundly,7,42,49,41,1,Strong community,8,0.8367346938775511,0.16326530612244897,False,False
InevitableRhubarb232,2,1,3,2,57,Noisy community,1,0.6666666666666666,0.3333333333333333,False,False
ThisNameDoesntCount,9,43,52,60,1,Strong community,8,1.1538461538461537,0.15384615384615385,False,False
gudematcha,3,4,7,8,1,Strong community,1,1.1428571428571428,0.14285714285714285,False,False
Grumpy_Trucker_85,7,4,11,13,0,Strong community,2,1.1818181818181819,0.18181818181818182,False,False
SnooMemesjellies243,7,49,56,53,0,Strong community,3,0.9464285714285714,0.05357142857142857,False,False
BlackJackfruitCup,2,3,5,1,16,Noisy community,4,0.2,0.8,False,False
bwmat,9,6,15,15,0,Strong community,0,1.0,0.0,False,False
cell689,6,4,10,8,0,Strong community,2,0.8,0.2,False,False
Snoo_47323,10,42,52,54,0,Strong community,2,1.0384615384615385,0.038461538461538464,False,False
Snoopdigglet,18,27,45,58,0,Strong community,13,1.288888888888889,0.28888888888888886,False,True
SoCalGiraffe,1,18,19,18,3,Strong community,1,0.9473684210526315,0.05263157894736842,False,False
Solarmandude,5,35,40,39,1,Strong community,1,0.975,0.025,False,False
diarrhea_planet,5,7,12,1,21,Noisy community,11,0.08333333333333333,0.9166666666666666,False,False
Sorry_Necessary_1385,3,4,7,7,5,Strong community,0,1.0,0.0,False,False
Turbulent-Tomato,4,5,9,7,14,Noisy community,2,0.7777777777777778,0.2222222222222222,False,False
SouthernCheek2393,3,29,32,28,3,Strong community,4,0.875,0.125,False,False
InTheWakeOfStardustx,4,4,8,6,3,Strong community,2,0.75,0.25,False,False
lllollllllllll,4,5,9,9,3,Strong community,0,1.0,0.0,False,False
SpamEatingChikn,21,48,69,95,0,Strong community,26,1.3768115942028984,0.37681159420289856,False,True
SpecialDig8881,11,13,24,34,0,Strong community,10,1.4166666666666667,0.4166666666666667,False,True
SpyderJack,4,36,40,37,1,Strong community,3,0.925,0.075,False,False
Supersnow845,11,5,16,11,1,Strong community,5,0.6875,0.3125,False,True
mason3991,14,18,32,35,0,Strong community,3,1.09375,0.09375,False,False
SugarGlitterkiss,4,3,7,5,0,Strong community,2,0.7142857142857143,0.2857142857142857,False,False
iwatchcredits,10,20,30,35,0,Strong community,5,1.1666666666666667,0.16666666666666666,False,False
redditratman,9,5,14,14,0,Strong community,0,1.0,0.0,False,False
Still_Yam9108,12,16,28,27,0,Strong community,1,0.9642857142857143,0.03571428571428571,False,False
Straight_Budget_2216,6,17,23,25,3,Strong community,2,1.0869565217391304,0.08695652173913043,False,False
Ohtherewearethen,4,3,7,8,3,Strong community,1,1.1428571428571428,0.14285714285714285,False,False
TemptingPenguin369,9,3,12,13,3,Strong community,1,1.0833333333333333,0.08333333333333333,False,False
981_runner,7,5,12,9,0,Strong community,3,0.75,0.25,False,True
MamaDee1959,2,2,4,5,3,Strong community,1,1.25,0.25,False,False
Mayor__Defacto,3,2,5,2,52,Noisy community,3,0.4,0.6,False,False
ProfessionalDot8419,2,1,3,4,3,Strong community,1,1.3333333333333333,0.3333333333333333,False,False
Tall-Payment-8015,7,5,12,9,3,Strong community,3,0.75,0.25,False,True
peepmet,14,33,47,50,0,Strong community,3,1.0638297872340425,0.06382978723404255,False,False
Successful_Guide5845,11,19,30,29,0,Strong community,1,0.9666666666666667,0.03333333333333333,False,False
misersoze,5,2,7,7,0,Strong community,0,1.0,0.0,False,False
Sudden-Whole8613,2,14,16,16,1,Strong community,0,1.0,0.0,False,False
Someth1ngOther,11,8,19,15,1,Strong community,4,0.7894736842105263,0.21052631578947367,False,False
Sudden_Water1604,6,13,19,24,3,Strong community,5,1.263157894736842,0.2631578947368421,False,True
Sufficient_Twist_688,3,14,17,11,26,Noisy community,6,0.6470588235294118,0.35294117647058826,False,False
Epsilon_and_Delta,4,1,5,4,26,Noisy community,1,0.8,0.2,False,False
GaryOldManBalls,2,2,4,5,26,Noisy community,1,1.25,0.25,False,False
Suitable-Captain-640,2,6,8,7,5,Strong community,1,0.875,0.125,False,False
More_Mind6869,8,7,15,7,10,Weak community,8,0.4666666666666667,0.5333333333333333,False,True
minahkyu,2,2,4,5,5,Strong community,1,1.25,0.25,False,False
smallerthantears,4,2,6,7,5,Strong community,1,1.1666666666666667,0.16666666666666666,False,False
Suspicious_State_318,41,64,105,129,0,Strong community,24,1.2285714285714286,0.22857142857142856,False,True
anondaddio,4,4,8,7,0,Strong community,1,0.875,0.125,False,False
Swimming-Bowler-6614,4,8,12,12,3,Strong community,0,1.0,0.0,False,False
Grand_Fun6113,11,10,21,20,0,Strong community,1,0.9523809523809523,0.047619047619047616,False,False
Super_Eagle1198,5,6,11,12,0,Strong community,1,1.0909090909090908,0.09090909090909091,False,False
cynedyr,4,2,6,6,0,Strong community,0,1.0,0.0,False,False
TAtoolate,17,44,61,66,3,Strong community,5,1.0819672131147542,0.08196721311475409,True,False
d3t0x1ct0x1c1ty,4,8,12,13,3,Strong community,1,1.0833333333333333,0.08333333333333333,False,False
TackoftheEndless,3,6,9,13,0,Strong community,4,1.4444444444444444,0.4444444444444444,False,True
Tausendberg,7,12,19,24,1,Strong community,5,1.263157894736842,0.2631578947368421,False,True
BattlefieldVet666,8,10,18,17,1,Strong community,1,0.9444444444444444,0.05555555555555555,False,False
Technical-Amount-278,3,12,15,22,1,Strong community,7,1.4666666666666666,0.4666666666666667,False,True
Technical-Mortgage85,7,25,32,40,0,Strong community,8,1.25,0.25,False,True
Kurama1917,4,3,7,7,0,Strong community,0,1.0,0.0,False,False
1-objective-opinion,5,4,9,7,0,Strong community,2,0.7777777777777778,0.2222222222222222,False,False
Accomplished_Tour481,11,8,19,15,2,Strong community,4,0.7894736842105263,0.21052631578947367,False,False
BealOrNoBeal,7,3,10,10,0,Strong community,0,1.0,0.0,False,False
Fredouille77,8,10,18,16,0,Strong community,2,0.8888888888888888,0.1111111111111111,False,False
GodkingAustin,6,5,11,11,0,Strong community,0,1.0,0.0,False,False
Important_Suspect681,3,3,6,6,0,Strong community,0,1.0,0.0,False,False
Riptiidex,5,3,8,6,0,Strong community,2,0.75,0.25,False,False
perpetualjive,4,2,6,6,0,Strong community,0,1.0,0.0,False,False
ThatPatelGuy,9,27,36,39,0,Strong community,3,1.0833333333333333,0.08333333333333333,False,False
VisibleLoan7460,10,11,21,27,0,Strong community,6,1.2857142857142858,0.2857142857142857,False,True
ecopandalover,3,3,6,7,0,Strong community,1,1.1666666666666667,0.16666666666666666,False,False
Due_Masterpiece_3601,4,1,5,2,27,Noisy community,3,0.4,0.6,False,False
prosthetic_memory,12,7,19,5,6,Weak community,14,0.2631578947368421,0.7368421052631579,False,True
The-zKR0N0S,11,38,49,60,0,Strong community,11,1.2244897959183674,0.22448979591836735,False,True
ArtOfBBQ,9,5,14,14,0,Strong community,0,1.0,0.0,False,False
OmniTalentedArtist,7,7,14,15,0,Strong community,1,1.0714285714285714,0.07142857142857142,False,False
Waterwoo,9,15,24,24,2,Strong community,0,1.0,0.0,False,False
TheAverage_American,8,21,29,32,0,Strong community,3,1.103448275862069,0.10344827586206896,False,False
Practical-Big7550,8,5,13,13,0,Strong community,0,1.0,0.0,False,False
TheBreakUp2013,1,5,6,3,5,Strong community,3,0.5,0.5,False,True
hastings1033,3,1,4,5,5,Strong community,1,1.25,0.25,False,False
Hemingwavy,5,4,9,7,0,Strong community,2,0.7777777777777778,0.2222222222222222,False,False
RedHead-Eng25,6,3,9,10,0,Strong community,1,1.1111111111111112,0.1111111111111111,False,False
fps916,3,2,5,3,0,Strong community,2,0.6,0.4,False,False
wingsnut25,9,5,14,9,2,Strong community,5,0.6428571428571429,0.35714285714285715,False,True
TheMagnuson,4,6,10,7,42,Noisy community,3,0.7,0.3,False,False
Ok-Simple5493,1,1,2,3,42,Noisy community,1,1.5,0.5,False,False
aaeme,4,3,7,3,42,Noisy community,4,0.42857142857142855,0.5714285714285714,False,False
TheMenio,1,2,3,5,4,Strong community,2,1.6666666666666667,0.6666666666666666,False,False
Kaisha001,6,3,9,9,0,Strong community,0,1.0,0.0,False,False
Ouitya,6,7,13,13,0,Strong community,0,1.0,0.0,False,False
TheSpaceCoresDad,9,21,30,33,0,Strong community,3,1.1,0.1,False,False
TheStrovik,7,39,46,51,0,Strong community,5,1.108695652173913,0.10869565217391304,False,False
TheUnaturalTree,30,260,290,291,0,Strong community,1,1.0034482758620689,0.0034482758620689655,True,False
BarnabyJones2024,9,5,14,14,0,Strong community,0,1.0,0.0,False,False
Electronic_Fly1592,3,1,4,5,0,Strong community,1,1.25,0.25,False,False
HendriXP88,5,5,10,10,0,Strong community,0,1.0,0.0,False,False
IronAgePrude,3,2,5,5,0,Strong community,0,1.0,0.0,False,False
Joyride0012,4,5,9,9,0,Strong community,0,1.0,0.0,False,False
NathanialRominoDrake,9,11,20,17,0,Strong community,3,0.85,0.15,False,False
WhiteGold_Welder,6,4,10,8,0,Strong community,2,0.8,0.2,False,False
defixiones,4,6,10,8,0,Strong community,2,0.8,0.2,False,False
schartlord,8,7,15,15,0,Strong community,0,1.0,0.0,False,False
schnuffs,8,3,11,11,0,Strong community,0,1.0,0.0,False,False
sergeantSadface,7,6,13,15,0,Strong community,2,1.1538461538461537,0.15384615384615385,False,False
ObiWanChronobi,9,5,14,15,2,Strong community,1,1.0714285714285714,0.07142857142857142,False,False
SpicyButterBoy,6,5,11,11,2,Strong community,0,1.0,0.0,False,False
gburgwardt,7,6,13,13,2,Strong community,0,1.0,0.0,False,False
The_Naked_Buddhist,5,10,15,14,0,Strong community,1,0.9333333333333333,0.06666666666666667,False,False
The_Petrichor_,5,9,14,15,0,Strong community,1,1.0714285714285714,0.07142857142857142,False,False
Thin_Match_602,3,5,8,2,19,Noisy community,6,0.25,0.75,False,False
Throawayhaibhai,10,96,106,100,0,Strong community,6,0.9433962264150944,0.05660377358490566,True,False
AlkatrazzPrime,5,4,9,6,39,Noisy community,3,0.6666666666666666,0.3333333333333333,False,False
PM_ME_A_PM_PLEASE_PM,6,5,11,11,0,Strong community,0,1.0,0.0,False,False
UNisopod,5,5,10,8,0,Strong community,2,0.8,0.2,False,False
Mkwdr,11,6,17,16,0,Strong community,1,0.9411764705882353,0.058823529411764705,False,False
Wd91,6,4,10,9,1,Strong community,1,0.9,0.1,False,False
Throwra3630,6,14,20,28,3,Strong community,8,1.4,0.4,False,True
Amarules,2,2,4,5,3,Strong community,1,1.25,0.25,False,False
That-Establishment24,4,3,7,7,3,Strong community,0,1.0,0.0,False,False
iilinga,4,4,8,9,3,Strong community,1,1.125,0.125,False,False
AgitatorsAnonymous,8,9,17,15,2,Strong community,2,0.8823529411764706,0.11764705882352941,False,False
BobQuixote,5,4,9,9,2,Strong community,0,1.0,0.0,False,False
Fracture-Point-,7,8,15,15,2,Strong community,0,1.0,0.0,False,False
InFearn0,8,6,14,14,2,Strong community,0,1.0,0.0,False,False
MisterMysterios,7,5,12,11,2,Strong community,1,0.9166666666666666,0.08333333333333333,False,False
Padonogan,5,4,9,9,2,Strong community,0,1.0,0.0,False,False
SafeThrowaway691,5,7,12,10,2,Strong community,2,0.8333333333333334,0.16666666666666666,False,False
Ssshizzzzziit,6,5,11,11,2,Strong community,0,1.0,0.0,False,False
Sufficient_Steak_839,7,4,11,11,2,Strong community,0,1.0,0.0,False,False
The-Insolent-Sage,9,10,19,19,2,Strong community,0,1.0,0.0,False,False
_NoPants,10,6,16,15,2,Strong community,1,0.9375,0.0625,False,False
cptjeff,6,4,10,10,2,Strong community,0,1.0,0.0,False,False
escapefromelba,9,5,14,13,2,Strong community,1,0.9285714285714286,0.07142857142857142,False,False
jarchack,15,7,22,22,2,Strong community,0,1.0,0.0,False,False
josh34583,9,7,16,14,2,Strong community,2,0.875,0.125,False,False
kenlubin,7,11,18,17,2,Strong community,1,0.9444444444444444,0.05555555555555555,False,False
norealpersoninvolved,12,8,20,20,2,Strong community,0,1.0,0.0,False,False
other_virginia_guy,4,2,6,6,2,Strong community,0,1.0,0.0,False,False
preselectlee,4,2,6,6,2,Strong community,0,1.0,0.0,False,False
shamrock01,8,2,10,11,2,Strong community,1,1.1,0.1,False,False
TimmyTurnersShake,0,4,4,5,3,Strong community,1,1.25,0.25,False,False
Sparrowphone,5,4,9,10,0,Strong community,1,1.1111111111111112,0.1111111111111111,False,False
TipeyToh,11,51,62,54,1,Strong community,8,0.8709677419354839,0.12903225806451613,True,False
BamaBlcksnek,4,6,10,3,46,Noisy community,7,0.3,0.7,False,False
ToasterII,11,21,32,37,0,Strong community,5,1.15625,0.15625,False,False
TomatilloSmart1372,8,15,23,36,0,Strong community,13,1.565217391304348,0.5652173913043478,False,True
Torachan881993,2,14,16,16,3,Strong community,0,1.0,0.0,False,False
Total_Escape_9778,10,47,57,53,0,Strong community,4,0.9298245614035088,0.07017543859649122,False,False
TradeU4Whopper,3,9,12,15,1,Strong community,3,1.25,0.25,False,True
Traditional_Fish_504,7,38,45,49,0,Strong community,4,1.0888888888888888,0.08888888888888889,False,False
TravisNotScott,3,5,8,11,0,Strong community,3,1.375,0.375,False,True
Tried6TimesYT,13,22,35,45,0,Strong community,10,1.2857142857142858,0.2857142857142857,False,True
TristonK,13,109,122,124,0,Strong community,2,1.0163934426229508,0.01639344262295082,True,False
Ok-Pea1916,13,3,16,15,0,Strong community,1,0.9375,0.0625,False,False
YNABDisciple,9,5,14,5,15,Noisy community,9,0.35714285714285715,0.6428571428571429,False,False
jedisushi72,5,5,10,8,0,Strong community,2,0.8,0.2,False,False
razamatazzz,16,38,54,67,0,Strong community,13,1.2407407407407407,0.24074074074074073,False,True
soozerain,68,324,392,399,0,Strong community,7,1.0178571428571428,0.017857142857142856,True,False
sxaez,5,4,9,9,0,Strong community,0,1.0,0.0,False,False
Trouble843,2,5,7,7,14,Noisy community,0,1.0,0.0,False,False
Egelac,3,2,5,6,14,Noisy community,1,1.2,0.2,False,False
True_Campaign_8504,3,44,47,47,1,Strong community,0,1.0,0.0,False,False
Due-Cup1115,5,3,8,9,1,Strong community,1,1.125,0.125,False,False
Unable-Concept-6272,6,29,35,40,1,Strong community,5,1.1428571428571428,0.14285714285714285,False,False
UnableToParallelPark,8,16,24,27,0,Strong community,3,1.125,0.125,False,False
Unique-Horror-9244,6,10,16,16,1,Strong community,0,1.0,0.0,False,False
Unusual-Context-5231,7,14,21,27,0,Strong community,6,1.2857142857142858,0.2857142857142857,False,True
Unusual_Custard4195,3,6,9,6,4,Strong community,3,0.6666666666666666,0.3333333333333333,False,True
GrizznessOnly,11,6,17,14,0,Strong community,3,0.8235294117647058,0.17647058823529413,False,False
Zobi101,11,38,49,53,0,Strong community,4,1.0816326530612246,0.08163265306122448,False,False
chunkyvomitsoup,8,6,14,6,11,Weak community,8,0.42857142857142855,0.5714285714285714,False,True
melph49,7,8,15,17,0,Strong community,2,1.1333333333333333,0.13333333333333333,False,False
VacheL99,2,26,28,24,1,Strong community,4,0.8571428571428571,0.14285714285714285,False,False
Nick0Taylor0,4,5,9,9,1,Strong community,0,1.0,0.0,False,False
VictorianAuthor,7,7,14,20,0,Strong community,6,1.4285714285714286,0.42857142857142855,False,True
Cranyx,6,4,10,10,2,Strong community,0,1.0,0.0,False,False
CreamofTazz,9,10,19,21,2,Strong community,2,1.105263157894737,0.10526315789473684,False,False
FredUpWithIt,4,3,7,7,2,Strong community,0,1.0,0.0,False,False
ZeBigD23,13,7,20,20,2,Strong community,0,1.0,0.0,False,False
VirtualExercise2958,6,18,24,30,0,Strong community,6,1.25,0.25,False,True
jaminfine,10,23,33,40,0,Strong community,7,1.2121212121212122,0.21212121212121213,False,False
VirtualJackfruit8765,2,17,19,16,1,Strong community,3,0.8421052631578947,0.15789473684210525,False,False
GrilledStuffedDragon,2,2,4,5,1,Strong community,1,1.25,0.25,False,False
AdmiralSaturyn,34,24,58,56,2,Strong community,2,0.9655172413793104,0.034482758620689655,True,False
DefaultProphet,5,2,7,7,2,Strong community,0,1.0,0.0,False,False
judge_mercer,9,4,13,13,2,Strong community,0,1.0,0.0,False,False
najumobi,8,192,200,189,2,Strong community,11,0.945,0.055,False,False
nyckidd,10,4,14,14,2,Strong community,0,1.0,0.0,False,False
Vivid-Ad3831,5,6,11,17,0,Strong community,6,1.5454545454545454,0.5454545454545454,False,True
Warm_Anxiety_7379,15,118,133,129,0,Strong community,4,0.9699248120300752,0.03007518796992481,True,False
Easy_Masterpiece_605,8,3,11,9,0,Strong community,2,0.8181818181818182,0.18181818181818182,False,False
Hazeygazey,2,3,5,2,15,Noisy community,3,0.4,0.6,False,False
IsNotACleverMan,4,5,9,7,0,Strong community,2,0.7777777777777778,0.2222222222222222,False,False
Large-Flamingo-5128,4,4,8,8,0,Strong community,0,1.0,0.0,False,False
TheGhostofJoeGibbs,5,3,8,4,31,Noisy community,4,0.5,0.5,False,False
Vredddff,6,4,10,8,0,Strong community,2,0.8,0.2,False,False
dontreallyknoww2341,6,20,26,31,0,Strong community,5,1.1923076923076923,0.19230769230769232,False,False
iMac_Hunt,8,25,33,39,0,Strong community,6,1.1818181818181819,0.18181818181818182,False,False
michaelcanav,5,2,7,8,0,Strong community,1,1.1428571428571428,0.14285714285714285,False,False
outestiers,8,8,16,11,0,Strong community,5,0.6875,0.3125,False,True
redditClowning4Life,7,3,10,4,31,Noisy community,6,0.4,0.6,False,False
3slimesinatrenchcoat,13,8,21,19,0,Strong community,2,0.9047619047619048,0.09523809523809523,False,False
needless_booty,6,5,11,9,0,Strong community,2,0.8181818181818182,0.18181818181818182,False,False
Watchfella,13,29,42,55,0,Strong community,13,1.3095238095238095,0.30952380952380953,False,True
Blood_Casino,9,11,20,19,2,Strong community,1,0.95,0.05,False,False
Marston_vc,8,5,13,13,2,Strong community,0,1.0,0.0,False,False
ThatsARatHat,5,5,10,10,2,Strong community,0,1.0,0.0,False,False
yangstyle,8,6,14,14,2,Strong community,0,1.0,0.0,False,False
WeekendFantastic2941,1,7,8,5,4,Strong community,3,0.625,0.375,False,True
WhereztheBleepnLight,5,19,24,26,0,Strong community,2,1.0833333333333333,0.08333333333333333,False,False
Winfred_Chesternut,6,24,30,28,0,Strong community,2,0.9333333333333333,0.06666666666666667,False,False
WonderWallaby28,39,76,115,123,0,Strong community,8,1.0695652173913044,0.06956521739130435,True,False
Wonderful-Food1274,17,37,54,63,0,Strong community,9,1.1666666666666667,0.16666666666666666,True,False
kidcudi115,4,3,7,4,0,Strong community,3,0.5714285714285714,0.42857142857142855,False,True
Wonderful-Island7224,7,28,35,31,1,Strong community,4,0.8857142857142857,0.11428571428571428,False,False
WonderfulMemory3697,9,35,44,47,2,Strong community,3,1.0681818181818181,0.06818181818181818,False,False
Wooden_Guest_6911,13,184,197,182,0,Strong community,15,0.9238578680203046,0.07614213197969544,True,False
Affectionate-Oil3019,3,2,5,5,0,Strong community,0,1.0,0.0,False,False
Anxious_Light_1808,4,2,6,6,0,Strong community,0,1.0,0.0,False,False
Caraxus,10,12,22,22,0,Strong community,0,1.0,0.0,False,False
Elegant-Ad2748,12,17,29,26,0,Strong community,3,0.896551724137931,0.10344827586206896,False,False
Golden_Femekian,19,17,36,34,0,Strong community,2,0.9444444444444444,0.05555555555555555,False,False
Pontifex_Maximus__,5,2,7,2,18,Noisy community,5,0.2857142857142857,0.7142857142857143,False,False
PunishedDemiurge,8,7,15,15,0,Strong community,0,1.0,0.0,False,False
RandHomman,6,5,11,11,0,Strong community,0,1.0,0.0,False,False
The_FriendliestGiant,15,7,22,20,0,Strong community,2,0.9090909090909091,0.09090909090909091,False,False
TiaLiaH,5,4,9,8,0,Strong community,1,0.8888888888888888,0.1111111111111111,False,False
angellareddit,8,9,17,16,0,Strong community,1,0.9411764705882353,0.058823529411764705,False,False
catch-ma-drift,12,12,24,24,0,Strong community,0,1.0,0.0,False,False
demonic_sensation,5,12,17,17,0,Strong community,0,1.0,0.0,False,False
mars1200,9,8,17,16,0,Strong community,1,0.9411764705882353,0.058823529411764705,False,False
merciiofpatience,4,3,7,7,0,Strong community,0,1.0,0.0,False,False
silence-calm,13,10,23,23,0,Strong community,0,1.0,0.0,False,False
velvetalocasia,3,2,5,5,0,Strong community,0,1.0,0.0,False,False
Wooden_Nature_8735,9,15,24,32,0,Strong community,8,1.3333333333333333,0.3333333333333333,False,True
Worried_Eye_1457,2,9,11,14,3,Strong community,3,1.2727272727272727,0.2727272727272727,False,True
Xiphactinus14,10,46,56,55,0,Strong community,1,0.9821428571428571,0.017857142857142856,False,False
Saltwater_Thief,4,3,7,7,0,Strong community,0,1.0,0.0,False,False
___Cyanide___,13,16,29,38,0,Strong community,9,1.3103448275862069,0.3103448275862069,False,True
YugiohXYZ,10,96,106,107,0,Strong community,1,1.009433962264151,0.009433962264150943,True,False
Funksloyd,2,3,5,6,0,Strong community,1,1.2,0.2,False,False
Rassendyll207,3,5,8,8,0,Strong community,0,1.0,0.0,False,False
ZLCZMartello,10,18,28,30,0,Strong community,2,1.0714285714285714,0.07142857142857142,False,False
ZOLforALL,6,9,15,19,0,Strong community,4,1.2666666666666666,0.26666666666666666,False,True
ZacherDaCracker2,9,15,24,27,0,Strong community,3,1.125,0.125,False,False
Zealousideal_Bee_639,7,16,23,28,0,Strong community,5,1.2173913043478262,0.21739130434782608,False,False
Zeppelinman,6,20,26,5,15,Noisy community,21,0.19230769230769232,0.8076923076923077,False,False
GreenBeardTheCanuck,3,3,6,3,15,Noisy community,3,0.5,0.5,False,False
ZestycloseMall3398,3,5,8,9,0,Strong community,1,1.125,0.125,False,False
_END_OF_MESSAGE_,4,13,17,19,1,Strong community,2,1.1176470588235294,0.11764705882352941,False,False
_Serial_Lain_,2,11,13,16,1,Strong community,3,1.2307692307692308,0.23076923076923078,False,True
_SilentGhost_10237,12,200,212,207,2,Strong community,5,0.9764150943396226,0.02358490566037736,True,False
Affectionate_Top340,7,5,12,13,2,Strong community,1,1.0833333333333333,0.08333333333333333,False,False
Dmagnum,7,3,10,10,2,Strong community,0,1.0,0.0,False,False
Evil_B2,7,5,12,13,2,Strong community,1,1.0833333333333333,0.08333333333333333,False,False
NonsensePlanet,8,3,11,4,33,Noisy community,7,0.36363636363636365,0.6363636363636364,False,False
Slicelker,11,6,17,16,2,Strong community,1,0.9411764705882353,0.058823529411764705,False,False
THExLASTxDON,5,3,8,8,2,Strong community,0,1.0,0.0,False,False
Zestyclose-Cat-1093,6,10,16,3,39,Noisy community,13,0.1875,0.8125,False,False
firewatch959,5,8,13,13,2,Strong community,0,1.0,0.0,False,False
vhu9644,3,2,5,3,2,Strong community,2,0.6,0.4,False,False
xtra819,4,7,11,12,2,Strong community,1,1.0909090909090908,0.09090909090909091,False,False
___wint,4,19,23,26,0,Strong community,3,1.1304347826086956,0.13043478260869565,False,False
eazy_eesh,5,6,11,17,0,Strong community,6,1.5454545454545454,0.5454545454545454,False,True
_pickle_me_this_,2,6,8,7,1,Strong community,1,0.875,0.125,False,False
Mulliganasty,4,3,7,9,1,Strong community,2,1.2857142857142858,0.2857142857142857,False,False
a1ham,2,8,10,8,1,Strong community,2,0.8,0.2,False,False
a_dlta,0,5,5,5,3,Strong community,0,1.0,0.0,False,False
abstract_claims,11,80,91,81,0,Strong community,10,0.8901098901098901,0.10989010989010989,True,False
ace_probably,9,26,35,44,0,Strong community,9,1.2571428571428571,0.2571428571428571,False,True
refboy4,7,5,12,7,0,Strong community,5,0.5833333333333334,0.4166666666666667,False,True
mnoodleman,5,4,9,10,0,Strong community,1,1.1111111111111112,0.1111111111111111,False,False
adoptedpictures,1,23,24,22,3,Strong community,2,0.9166666666666666,0.08333333333333333,False,False
ai_kev0,10,12,22,33,0,Strong community,11,1.5,0.5,False,True
yvesmpeg,7,3,10,10,0,Strong community,0,1.0,0.0,False,False
CelebrationInitial76,3,3,6,2,4,Strong community,4,0.3333333333333333,0.6666666666666666,False,True
alexsanderfr,7,15,22,25,0,Strong community,3,1.1363636363636365,0.13636363636363635,False,False
allthingsgrowknow,6,33,39,39,0,Strong community,0,1.0,0.0,False,False
xEginch,5,8,13,9,0,Strong community,4,0.6923076923076923,0.3076923076923077,False,True
aloo-ka-paratha,18,93,111,122,0,Strong community,11,1.0990990990990992,0.0990990990990991,True,False
ArcaneScribbler,4,1,5,2,8,Weak community,3,0.4,0.6,False,True
Icy_Variation3,3,2,5,6,0,Strong community,1,1.2,0.2,False,False
Overlook-237,3,3,6,6,0,Strong community,0,1.0,0.0,False,False
traplord69420666,5,2,7,7,0,Strong community,0,1.0,0.0,False,False
xilefogayole3,8,14,22,29,0,Strong community,7,1.3181818181818181,0.3181818181818182,False,True
EntropicSpecies,4,2,6,5,8,Weak community,1,0.8333333333333334,0.16666666666666666,False,False
amtcannon,4,10,14,20,3,Strong community,6,1.4285714285714286,0.42857142857142855,False,True
ScopeFixer101,6,6,12,14,3,Strong community,2,1.1666666666666667,0.16666666666666666,False,False
ananeedshelps,3,17,20,22,0,Strong community,2,1.1,0.1,False,False
pump1ng_,5,11,16,16,0,Strong community,0,1.0,0.0,False,False
anonomycosis,1,5,6,6,1,Strong community,0,1.0,0.0,False,False
asah,7,19,26,32,0,Strong community,6,1.2307692307692308,0.23076923076923078,False,True
asklepios7,8,12,20,23,0,Strong community,3,1.15,0.15,False,False
attlerexLSPDFR,5,14,19,25,0,Strong community,6,1.3157894736842106,0.3157894736842105,False,True
azqwa,7,14,21,24,0,Strong community,3,1.1428571428571428,0.14285714285714285,False,False
b_rokal,7,11,18,21,0,Strong community,3,1.1666666666666667,0.16666666666666666,False,False
ballblaster6969,3,17,20,20,3,Strong community,0,1.0,0.0,False,False
believe_the_lie4831,6,17,23,24,1,Strong community,1,1.0434782608695652,0.043478260869565216,False,False
TheGlassWolf123455,4,2,6,6,1,Strong community,0,1.0,0.0,False,False
quiblitz,6,30,36,32,1,Strong community,4,0.8888888888888888,0.1111111111111111,False,False
beyondhelp7854,14,42,56,67,0,Strong community,11,1.1964285714285714,0.19642857142857142,True,False
Junior-Towel-202,4,3,7,3,6,Weak community,4,0.42857142857142855,0.5714285714285714,False,True
blueorangan,5,18,23,25,0,Strong community,2,1.0869565217391304,0.08695652173913043,False,False
Brilliant_Effort9095,4,3,7,7,0,Strong community,0,1.0,0.0,False,False
Chemical_Big_5118,5,2,7,7,0,Strong community,0,1.0,0.0,False,False
Cubeazoid,2,1,3,2,29,Noisy community,1,0.6666666666666666,0.3333333333333333,False,False
Molestrios45,5,6,11,9,0,Strong community,2,0.8181818181818182,0.18181818181818182,False,False
Relay_Slide,4,4,8,8,0,Strong community,0,1.0,0.0,False,False
UbiquitousPanacea,6,9,15,15,0,Strong community,0,1.0,0.0,False,False
Yetanotherdeafguy,9,5,14,13,0,Strong community,1,0.9285714285714286,0.07142857142857142,False,False
Zorlai,4,2,6,7,0,Strong community,1,1.1666666666666667,0.16666666666666666,False,False
adnaj26,5,3,8,2,32,Noisy community,6,0.25,0.75,False,False
mh985,6,6,12,4,32,Noisy community,8,0.3333333333333333,0.6666666666666666,False,False
solarnoobUSA,4,2,6,6,0,Strong community,0,1.0,0.0,False,False
TheRealestBiz,4,3,7,8,1,Strong community,1,1.1428571428571428,0.14285714285714285,False,False
bri_breazy,4,9,13,11,1,Strong community,2,0.8461538461538461,0.15384615384615385,False,False
bumblethistle,0,7,7,7,3,Strong community,0,1.0,0.0,False,False
buncha_bees,2,2,4,5,54,Noisy community,1,1.25,0.25,False,False
According_Test4787,1,1,2,3,54,Noisy community,1,1.5,0.5,False,False
manicthinking,1,3,4,2,54,Noisy community,2,0.5,0.5,False,False
burner_macburnerson,0,5,5,4,5,Strong community,1,0.8,0.2,False,False
c_mad788,12,24,36,42,0,Strong community,6,1.1666666666666667,0.16666666666666666,False,False
vortexmak,3,32,35,35,1,Strong community,0,1.0,0.0,False,False
wizrslizr,5,2,7,6,21,Noisy community,1,0.8571428571428571,0.14285714285714285,False,False
Alone_Step_6304,15,12,27,23,0,Strong community,4,0.8518518518518519,0.14814814814814814,False,False
BrandonLart,5,5,10,8,0,Strong community,2,0.8,0.2,False,False
Glittering_Hunt6896,8,4,12,13,0,Strong community,1,1.0833333333333333,0.08333333333333333,False,False
Puzzleheaded_Gas1829,5,1,6,6,0,Strong community,0,1.0,0.0,False,False
TheFuns,6,3,9,9,0,Strong community,0,1.0,0.0,False,False
chezdor,2,7,9,8,4,Strong community,1,0.8888888888888888,0.1111111111111111,False,False
MobiusCube,5,4,9,6,4,Strong community,3,0.6666666666666666,0.3333333333333333,False,True
cipetab,10,15,25,29,0,Strong community,4,1.16,0.16,False,False
colepercy120,39,118,157,150,0,Strong community,7,0.9554140127388535,0.044585987261146494,True,False
rigormorty,7,4,11,11,2,Strong community,0,1.0,0.0,False,False
coolcat245678900,3,5,8,6,8,Weak community,2,0.75,0.25,False,False
crazyredneck21798,4,12,16,13,3,Strong community,3,0.8125,0.1875,False,False
dealsorheals,7,14,21,23,0,Strong community,2,1.0952380952380953,0.09523809523809523,False,False
IcyRecommendation781,4,4,8,6,0,Strong community,2,0.75,0.25,False,False
delilah1906,6,18,24,21,3,Strong community,3,0.875,0.125,False,False
randolorian612,4,4,8,7,23,Noisy community,1,0.875,0.125,False,False
demongoku,3,20,23,24,0,Strong community,1,1.0434782608695652,0.043478260869565216,False,False
FinalSealBearerr,10,8,18,16,0,Strong community,2,0.8888888888888888,0.1111111111111111,False,False
dreamingatdusk,10,20,30,30,3,Strong community,0,1.0,0.0,True,False
CaramelRottenApple,2,3,5,5,3,Strong community,0,1.0,0.0,False,False
Feeling-Object9383,3,2,5,5,3,Strong community,0,1.0,0.0,False,False
Roadside_Prophet,11,5,16,14,2,Strong community,2,0.875,0.125,False,False
boldandbratsche,3,5,8,8,2,Strong community,0,1.0,0.0,False,False
el_farmerino,3,4,7,5,0,Strong community,2,0.7142857142857143,0.2857142857142857,False,False
postdiluvium,6,2,8,7,2,Strong community,1,0.875,0.125,False,False
JustinRandoh,4,4,8,8,0,Strong community,0,1.0,0.0,False,False
TailorAppropriate999,4,4,8,5,11,Weak community,3,0.625,0.375,False,True
johnapuna,7,5,12,11,0,Strong community,1,0.9166666666666666,0.08333333333333333,False,False
ozzscur,4,8,12,10,0,Strong community,2,0.8333333333333334,0.16666666666666666,False,False
secret__scientist,12,21,33,42,0,Strong community,9,1.2727272727272727,0.2727272727272727,False,True
dusty_trendhawk,1,15,16,15,3,Strong community,1,0.9375,0.0625,False,False
emanonn159,26,176,202,179,0,Strong community,23,0.8861386138613861,0.11386138613861387,True,False
AleroRatking,4,3,7,7,0,Strong community,0,1.0,0.0,False,False
CrimsonBolt33,7,5,12,11,0,Strong community,1,0.9166666666666666,0.08333333333333333,False,False
Ottomatik80,4,3,7,6,0,Strong community,1,0.8571428571428571,0.14285714285714285,False,False
fart439,1,8,9,3,36,Noisy community,6,0.3333333333333333,0.6666666666666666,False,False
ArielTheKidd,2,2,4,1,36,Noisy community,3,0.25,0.75,False,False
Symbiotic_flux,2,1,3,1,36,Noisy community,2,0.3333333333333333,0.6666666666666666,False,False
follower_of_yohma,9,60,69,71,0,Strong community,2,1.0289855072463767,0.028985507246376812,False,False
forcedfan,9,27,36,40,1,Strong community,4,1.1111111111111112,0.1111111111111111,False,False
funnyIlaugh,4,16,20,22,0,Strong community,2,1.1,0.1,False,False
TechPriestCaudecus,3,2,5,3,0,Strong community,2,0.6,0.4,False,False
bk1285,4,1,5,5,0,Strong community,0,1.0,0.0,False,False
loyalsolider95,14,63,77,80,0,Strong community,3,1.0389610389610389,0.03896103896103896,True,False
overts,5,4,9,7,0,Strong community,2,0.7777777777777778,0.2222222222222222,False,False
Osr0,14,13,27,28,0,Strong community,1,1.037037037037037,0.037037037037037035,False,False
gaslighting_isntreal,1,18,19,17,1,Strong community,2,0.8947368421052632,0.10526315789473684,False,False
Life-Crab-2098,4,3,7,5,1,Strong community,2,0.7142857142857143,0.2857142857142857,False,False
gbags-98,4,11,15,21,0,Strong community,6,1.4,0.4,False,True
getswole2020,2,18,20,19,1,Strong community,1,0.95,0.05,False,False
gmastertr21,3,6,9,15,1,Strong community,6,1.6666666666666667,0.6666666666666666,False,True
fatloui,3,5,8,6,1,Strong community,2,0.75,0.25,False,False
goingforNGA,7,14,21,25,0,Strong community,4,1.1904761904761905,0.19047619047619047,False,False
grandquiano,4,16,20,20,3,Strong community,0,1.0,0.0,False,False
WabbitCZEN,4,1,5,6,3,Strong community,1,1.2,0.2,False,False
hamburgersocks,6,11,17,24,0,Strong community,7,1.411764705882353,0.4117647058823529,False,True
haunted_champagne,10,18,28,30,0,Strong community,2,1.0714285714285714,0.07142857142857142,False,False
herpaderp_maplesyrup,13,20,33,43,0,Strong community,10,1.303030303030303,0.30303030303030304,False,True
huadpe,14,28,42,45,0,Strong community,3,1.0714285714285714,0.07142857142857142,False,False
hundredandoneeyes,8,9,17,22,0,Strong community,5,1.2941176470588236,0.29411764705882354,False,True
idster,3,6,9,3,64,Noisy community,6,0.3333333333333333,0.6666666666666666,False,False
ifitisntconnor,19,81,100,97,0,Strong community,3,0.97,0.03,True,False
ihaten_blank_er,6,13,19,20,0,Strong community,1,1.0526315789473684,0.05263157894736842,False,False
Ion_Unbound,6,6,12,12,2,Strong community,0,1.0,0.0,False,False
imsecretlyafox,7,10,17,23,1,Strong community,6,1.3529411764705883,0.35294117647058826,False,True
ivycomb,1,10,11,12,1,Strong community,1,1.0909090909090908,0.09090909090909091,False,False
jackietea123,8,30,38,43,0,Strong community,5,1.131578947368421,0.13157894736842105,False,False
jo__ba,3,6,9,11,0,Strong community,2,1.2222222222222223,0.2222222222222222,False,False
jrandall1017,13,25,38,48,2,Strong community,10,1.263157894736842,0.2631578947368421,False,True
juicyjeffersonjones,5,17,22,26,0,Strong community,4,1.1818181818181819,0.18181818181818182,False,False
kevdautie,5,5,10,10,0,Strong community,0,1.0,0.0,False,False
just57572,9,17,26,36,0,Strong community,10,1.3846153846153846,0.38461538461538464,False,True
kasebrotchen,2,4,6,3,43,Noisy community,3,0.5,0.5,False,False
lavenderrskies,7,20,27,32,0,Strong community,5,1.1851851851851851,0.18518518518518517,False,False
lawliet_loml,3,3,6,6,23,Noisy community,0,1.0,0.0,False,False
leewilliam236,6,18,24,26,0,Strong community,2,1.0833333333333333,0.08333333333333333,False,False
Vix_Satis,5,4,9,5,14,Noisy community,4,0.5555555555555556,0.4444444444444444,False,False
luckyguessmate,0,5,5,4,1,Strong community,1,0.8,0.2,False,False
maliknetwork,16,38,54,57,0,Strong community,3,1.0555555555555556,0.05555555555555555,False,False
Competitive_Let_9644,3,3,6,7,0,Strong community,1,1.1666666666666667,0.16666666666666666,False,False
markekt,1,2,3,4,5,Strong community,1,1.3333333333333333,0.3333333333333333,False,False
Archaeologist15,6,3,9,9,0,Strong community,0,1.0,0.0,False,False
sarges_12gauge,3,2,5,5,0,Strong community,0,1.0,0.0,False,False
matheus71998,7,10,17,23,0,Strong community,6,1.3529411764705883,0.35294117647058826,False,True
microdweb,10,27,37,46,0,Strong community,9,1.2432432432432432,0.24324324324324326,False,True
MissIncredulous,8,8,16,16,0,Strong community,0,1.0,0.0,False,False
Suspicious_Tank_61,6,4,10,10,0,Strong community,0,1.0,0.0,False,False
misty_mustard,5,13,18,28,0,Strong community,10,1.5555555555555556,0.5555555555555556,False,True
miyomaku,6,13,19,26,0,Strong community,7,1.368421052631579,0.3684210526315789,False,True
momentforlife92,32,151,183,174,0,Strong community,9,0.9508196721311475,0.04918032786885246,True,False
trustnobody01,27,166,193,180,0,Strong community,13,0.9326424870466321,0.06735751295336788,True,False
mvigs,4,13,17,18,2,Strong community,1,1.0588235294117647,0.058823529411764705,False,False
Comfortable_Fill9081,4,4,8,7,2,Strong community,1,0.875,0.125,False,False
Prestigious_Load1699,8,8,16,16,2,Strong community,0,1.0,0.0,False,False
Prior_Coyote_4376,11,8,19,19,2,Strong community,0,1.0,0.0,False,False
UncleMeat11,8,9,17,17,2,Strong community,0,1.0,0.0,False,False
beardsac,7,4,11,11,2,Strong community,0,1.0,0.0,False,False
nerpa_floppybara,13,44,57,57,0,Strong community,0,1.0,0.0,False,False
neves783,8,15,23,32,0,Strong community,9,1.391304347826087,0.391304347826087,False,True
nexxwav,7,105,112,115,2,Strong community,3,1.0267857142857142,0.026785714285714284,False,False
DarthJarJarJar,6,4,10,10,2,Strong community,0,1.0,0.0,False,False
Hosj_Karp,9,5,14,12,0,Strong community,2,0.8571428571428571,0.14285714285714285,False,False
KyleDutcher,3,3,6,7,2,Strong community,1,1.1666666666666667,0.16666666666666666,False,False
TheyGaveMeThisTrain,9,7,16,13,2,Strong community,3,0.8125,0.1875,False,False
oceanadakmak,5,9,14,16,0,Strong community,2,1.1428571428571428,0.14285714285714285,False,False
odious_as_fuck,7,8,15,22,0,Strong community,7,1.4666666666666666,0.4666666666666667,False,True
jrgkgb,4,2,6,2,65,Noisy community,4,0.3333333333333333,0.6666666666666666,False,False
trentluv,7,4,11,11,0,Strong community,0,1.0,0.0,False,False
omega4444,1,2,3,3,64,Noisy community,0,1.0,0.0,False,False
phileconomicus,6,16,22,32,0,Strong community,10,1.4545454545454546,0.45454545454545453,False,True
vbob99,3,3,6,2,24,Noisy community,4,0.3333333333333333,0.6666666666666666,False,False
plcanonica,3,27,30,29,1,Strong community,1,0.9666666666666667,0.03333333333333333,False,False
mechadragon469,10,4,14,13,1,Strong community,1,0.9285714285714286,0.07142857142857142,False,False
ptothedubs,7,30,37,35,3,Strong community,2,0.9459459459459459,0.05405405405405406,False,False
random_indian_boi,16,85,101,102,0,Strong community,1,1.00990099009901,0.009900990099009901,True,False
Zrakoplovvliegtuig,4,4,8,8,0,Strong community,0,1.0,0.0,False,False
poco,5,4,9,10,0,Strong community,1,1.1111111111111112,0.1111111111111111,False,False
rapaciousdrinker,1,2,3,5,1,Strong community,2,1.6666666666666667,0.6666666666666666,False,False
rdh_mobile,10,17,27,31,0,Strong community,4,1.1481481481481481,0.14814814814814814,False,False
reactionary_for_life,4,11,15,16,0,Strong community,1,1.0666666666666667,0.06666666666666667,False,False
roracle1982,10,11,21,29,1,Strong community,8,1.380952380952381,0.38095238095238093,False,True
roses4angeI,8,9,17,25,0,Strong community,8,1.4705882352941178,0.47058823529411764,False,True
rosesgrowinmygarden,12,26,38,55,0,Strong community,17,1.4473684210526316,0.4473684210526316,False,True
nss68,2,2,4,5,0,Strong community,1,1.25,0.25,False,False
sammybabyyy23,1,3,4,7,3,Strong community,3,1.75,0.75,False,True
satanicpastorswife,3,5,8,11,0,Strong community,3,1.375,0.375,False,True
savior_of_the_poor,4,14,18,17,1,Strong community,1,0.9444444444444444,0.05555555555555555,False,False
PeepSkate,3,2,5,5,0,Strong community,0,1.0,0.0,False,False
Seeker_Of_Toiletries,3,3,6,6,0,Strong community,0,1.0,0.0,False,False
ow_bpx,3,2,5,3,0,Strong community,2,0.6,0.4,False,False
sehalynn,7,24,31,41,0,Strong community,10,1.3225806451612903,0.3225806451612903,False,True
sheldon4ever,1,17,18,19,3,Strong community,1,1.0555555555555556,0.05555555555555555,False,False
shery97,5,11,16,19,0,Strong community,3,1.1875,0.1875,False,False
shitflicker31,11,21,32,46,0,Strong community,14,1.4375,0.4375,False,True
shutterpawsnomnom,6,18,24,22,3,Strong community,2,0.9166666666666666,0.08333333333333333,False,False
keenan123,4,4,8,9,2,Strong community,1,1.125,0.125,False,False
slowopop,3,5,8,10,1,Strong community,2,1.25,0.25,False,False
CantaloupeLazy792,4,4,8,8,0,Strong community,0,1.0,0.0,False,False
Feisty_Camera_7774,8,9,17,16,0,Strong community,1,0.9411764705882353,0.058823529411764705,False,False
saveonly1,6,6,12,10,0,Strong community,2,0.8333333333333334,0.16666666666666666,False,False
sstiel,2,2,4,3,4,Strong community,1,0.75,0.25,False,False
strawberry2801,8,79,87,20,6,Weak community,67,0.22988505747126436,0.7701149425287356,False,True
Aletheia-Nyx,3,2,5,3,6,Weak community,2,0.6,0.4,False,False
AwkwardChuckle,3,4,7,6,6,Weak community,1,0.8571428571428571,0.14285714285714285,False,False
DriftinFool,5,4,9,3,6,Weak community,6,0.3333333333333333,0.6666666666666666,False,True
Jaded_Cheesecake_993,3,3,6,4,6,Weak community,2,0.6666666666666666,0.3333333333333333,False,False
MonkeManWPG,7,10,17,13,6,Weak community,4,0.7647058823529411,0.23529411764705882,False,True
dah_wowow,3,3,6,6,6,Weak community,0,1.0,0.0,False,False
koleke415,4,3,7,7,6,Weak community,0,1.0,0.0,False,False
sukepemoripijutk,2,7,9,10,3,Strong community,1,1.1111111111111112,0.1111111111111111,False,False
taycanprincess,2,16,18,20,3,Strong community,2,1.1111111111111112,0.1111111111111111,False,False
the-alamo,1,11,12,12,1,Strong community,0,1.0,0.0,False,False
Gauntlet_of_Might,3,3,6,6,2,Strong community,0,1.0,0.0,False,False
theredqueentheory,1,3,4,4,5,Strong community,0,1.0,0.0,False,False
thesumofallvice,34,117,151,170,0,Strong community,19,1.1258278145695364,0.12582781456953643,True,False
CanoodlingCockatoo,5,5,10,4,4,Strong community,6,0.4,0.6,False,True
thomasmaster912,2,8,10,12,0,Strong community,2,1.2,0.2,False,False
tinfoil_cake,3,14,17,13,1,Strong community,4,0.7647058823529411,0.23529411764705882,False,True
tonylstewart,6,13,19,24,0,Strong community,5,1.263157894736842,0.2631578947368421,False,True
tounge-fingers,4,13,17,14,3,Strong community,3,0.8235294117647058,0.17647058823529413,False,False
trumppardons,3,7,10,6,18,Noisy community,4,0.6,0.4,False,False
MakeItMoreFuckinLame,8,8,16,11,0,Strong community,5,0.6875,0.3125,False,True
Spiderlander,10,7,17,17,0,Strong community,0,1.0,0.0,False,False
dachuggs,3,3,6,6,0,Strong community,0,1.0,0.0,False,False
tudum42,12,20,32,41,0,Strong community,9,1.28125,0.28125,False,True
turtdurt,4,17,21,19,3,Strong community,2,0.9047619047619048,0.09523809523809523,False,False
fleeter17,3,2,5,2,65,Noisy community,3,0.4,0.6,False,False
wannabeAIdev,8,38,46,53,0,Strong community,7,1.1521739130434783,0.15217391304347827,False,False
yamdreaming,5,14,19,23,3,Strong community,4,1.2105263157894737,0.21052631578947367,False,False
yazurd2,2,8,10,13,3,Strong community,3,1.3,0.3,False,True
youngsurpriseperson,23,53,76,91,0,Strong community,15,1.1973684210526316,0.19736842105263158,True,False
splojjy,2,4,6,1,19,Noisy community,5,0.16666666666666666,0.8333333333333334,False,False
-raeyne-,3,3,6,4,23,Noisy community,2,0.6666666666666666,0.3333333333333333,False,False
dragonsofliberty,3,2,5,2,23,Noisy community,3,0.4,0.6,False,False
4N_Immigrant,4,4,8,8,1,Strong community,0,1.0,0.0,False,False
Bread-Stick1,2,3,5,5,19,Noisy community,0,1.0,0.0,False,False
TheCowboyIsAnIndian,4,5,9,5,4,Strong community,4,0.5555555555555556,0.4444444444444444,False,True
ucotcvyvov,4,2,6,3,4,Strong community,3,0.5,0.5,False,True
AVeryBadMon,3,3,6,6,2,Strong community,0,1.0,0.0,False,False
Ac1De9Cy0Sif6S,2,3,5,5,2,Strong community,0,1.0,0.0,False,False
sadgloop,3,3,6,1,11,Weak community,5,0.16666666666666666,0.8333333333333334,False,True
Wrong-Half-6628,4,2,6,3,37,Noisy community,3,0.5,0.5,False,False
Heeeeyyouguuuuys,8,8,16,16,0,Strong community,0,1.0,0.0,False,False
CaptainoftheVessel,6,6,12,12,2,Strong community,0,1.0,0.0,False,False
Enough_Fudge3167,6,2,8,7,0,Strong community,1,0.875,0.125,False,False
i-have-a-kuato,11,3,14,13,0,Strong community,1,0.9285714285714286,0.07142857142857142,False,False
Rupeshknn,6,7,13,13,0,Strong community,0,1.0,0.0,False,False
Agitated_Elephant469,4,4,8,6,2,Strong community,2,0.75,0.25,False,False
Past_Scholar3723,3,5,8,2,39,Noisy community,6,0.25,0.75,False,False
JediMasterSifo-Dias,4,4,8,8,3,Strong community,0,1.0,0.0,False,False
KittyQueen63,5,4,9,2,15,Noisy community,7,0.2222222222222222,0.7777777777777778,False,False
teflondung,4,4,8,2,10,Weak community,6,0.25,0.75,False,True
SeductiveSunday,5,6,11,11,0,Strong community,0,1.0,0.0,False,False
TLunchFTW,4,3,7,4,45,Noisy community,3,0.5714285714285714,0.42857142857142855,False,False
BJPark,7,3,10,10,2,Strong community,0,1.0,0.0,False,False
NigroqueSimillima,3,3,6,6,2,Strong community,0,1.0,0.0,False,False
No_Passion_9819,2,4,6,6,2,Strong community,0,1.0,0.0,False,False
BadHabitOmni,4,4,8,8,2,Strong community,0,1.0,0.0,False,False
BajaBlastFromThePast,3,5,8,8,1,Strong community,0,1.0,0.0,False,False
lavandermary,5,1,6,1,46,Noisy community,5,0.16666666666666666,0.8333333333333334,False,False
Basic-Definition8870,3,6,9,1,38,Noisy community,8,0.1111111111111111,0.8888888888888888,False,False
BayesConspirator356,5,5,10,10,0,Strong community,0,1.0,0.0,False,False
Benjamin_Starscape,3,2,5,2,38,Noisy community,3,0.4,0.6,False,False
JustThisIsIt,3,4,7,2,58,Noisy community,5,0.2857142857142857,0.7142857142857143,False,False
unkorrupted,9,9,18,18,2,Strong community,0,1.0,0.0,False,False
ian9921,3,5,8,8,3,Strong community,0,1.0,0.0,False,False
Clementine_90,5,7,12,7,9,Strong community,5,0.5833333333333334,0.4166666666666667,False,True
TinyNiceWolf,4,2,6,5,9,Strong community,1,0.8333333333333334,0.16666666666666666,False,False
StopStealingMyShit,4,4,8,8,2,Strong community,0,1.0,0.0,False,False
Ok-Position8731,4,2,6,4,3,Strong community,2,0.6666666666666666,0.3333333333333333,False,False
Gullible_Career1469,6,2,8,7,0,Strong community,1,0.875,0.125,False,False
Material-Web-9640,3,7,10,3,37,Noisy community,7,0.3,0.7,False,False
Professional_Fix4593,4,3,7,3,45,Noisy community,4,0.42857142857142855,0.5714285714285714,False,False
BurtMSnakehole,2,3,5,5,12,Weak community,0,1.0,0.0,False,False
Dependent-Canary-514,3,2,5,5,12,Weak community,0,1.0,0.0,False,False
mikefick21,2,7,9,6,12,Weak community,3,0.6666666666666666,0.3333333333333333,False,True
Calm-Purchase-8044,3,2,5,1,60,Noisy community,4,0.2,0.8,False,False
Ill-Cantaloupe-6947,8,4,12,9,9,Strong community,3,0.75,0.25,False,True
Pristine_Job_7677,3,4,7,7,9,Strong community,0,1.0,0.0,False,False
CatnissEvergreed,1,1,2,2,61,Noisy community,0,1.0,0.0,False,False
KnotBeanie,4,2,6,6,1,Strong community,0,1.0,0.0,False,False
Choano,3,2,5,5,4,Strong community,0,1.0,0.0,False,False
Fattydog,4,2,6,5,4,Strong community,1,0.8333333333333334,0.16666666666666666,False,False
rktscience1971,5,4,9,9,1,Strong community,0,1.0,0.0,False,False
Classic_Bet1942,1,1,2,2,0,Strong community,0,1.0,0.0,False,False
Publius82,4,5,9,9,2,Strong community,0,1.0,0.0,False,False
Statman12,4,4,8,8,2,Strong community,0,1.0,0.0,False,False
Correct_Cupcake_5493,5,2,7,1,10,Weak community,6,0.14285714285714285,0.8571428571428571,False,True
ZZ9ZA,4,5,9,9,3,Strong community,0,1.0,0.0,False,False
seasev,4,4,8,8,1,Strong community,0,1.0,0.0,False,False
Your_As_Stupid_As_Me,3,2,5,5,1,Strong community,0,1.0,0.0,False,False
Intelligent-Sound-85,5,3,8,6,2,Strong community,2,0.75,0.25,False,False
uvula_chandelier,5,11,16,15,2,Strong community,1,0.9375,0.0625,False,False
TrickyTrailMix,6,6,12,11,0,Strong community,1,0.9166666666666666,0.08333333333333333,False,False
DazzlingLanguage5774,1,3,4,2,4,Strong community,2,0.5,0.5,False,False
Top-Cupcake4775,4,3,7,2,4,Strong community,5,0.2857142857142857,0.7142857142857143,False,True
Outrageous_Cod_8961,3,2,5,5,0,Strong community,0,1.0,0.0,False,False
Far_Physics3200,2,6,8,5,12,Weak community,3,0.625,0.375,False,True
DjScenester,2,2,4,4,14,Noisy community,0,1.0,0.0,False,False
Far_Information_9613,3,3,6,6,14,Noisy community,0,1.0,0.0,False,False
Doununda,4,3,7,5,3,Strong community,2,0.7142857142857143,0.2857142857142857,False,False
Mirved,3,2,5,4,28,Noisy community,1,0.8,0.2,False,False
pm_me_your_passw0d,4,4,8,2,35,Noisy community,6,0.25,0.75,False,False
Repeatitpete,7,4,11,11,2,Strong community,0,1.0,0.0,False,False
Express-Translator24,3,2,5,4,1,Strong community,1,0.8,0.2,False,False
constructioncranes,4,3,7,5,12,Weak community,2,0.7142857142857143,0.2857142857142857,False,False
Hughmanatea,4,2,6,3,21,Noisy community,3,0.5,0.5,False,False
FinnsAwake2187,2,2,4,1,55,Noisy community,3,0.25,0.75,False,False
Temporary_Cicada031,2,1,3,3,55,Noisy community,0,1.0,0.0,False,False
Fit_Cut_4238,5,8,13,12,2,Strong community,1,0.9230769230769231,0.07692307692307693,False,False
GodMan7777,2,2,4,4,10,Weak community,0,1.0,0.0,False,False
lamstradamus,3,3,6,6,1,Strong community,0,1.0,0.0,False,False
easthighwildcatfan1,3,3,6,6,1,Strong community,0,1.0,0.0,False,False
Hexdrix,6,7,13,7,3,Strong community,6,0.5384615384615384,0.46153846153846156,False,True
Jeklah,1,1,2,2,55,Noisy community,0,1.0,0.0,False,False
Ok-Session2581,1,3,4,4,0,Strong community,0,1.0,0.0,False,False
MangoPug15,1,2,3,3,1,Strong community,0,1.0,0.0,False,False
shivux,2,3,5,3,10,Weak community,2,0.6,0.4,False,False
Waterworld1880,2,4,6,6,0,Strong community,0,1.0,0.0,False,False
Natural-Potential-80,2,3,5,5,3,Strong community,0,1.0,0.0,False,False
itravella,2,2,4,4,3,Strong community,0,1.0,0.0,False,False
SignificantLock1037,2,4,6,6,1,Strong community,0,1.0,0.0,False,False
WheelyWheelyTired,3,3,6,6,2,Strong community,0,1.0,0.0,False,False
Ok-Significance2978,1,3,4,4,4,Strong community,0,1.0,0.0,False,False
TheRealTurinTurambar,4,2,6,6,1,Strong community,0,1.0,0.0,False,False
munche,3,4,7,3,4,Strong community,4,0.42857142857142855,0.5714285714285714,False,True
TheButtDog,2,3,5,2,34,Noisy community,3,0.4,0.6,False,False
lemickeynorings,3,4,7,7,2,Strong community,0,1.0,0.0,False,False
onthelongrun,0,5,5,1,13,Noisy community,4,0.2,0.8,False,False
