id,engagement,num_posts,num_comments,indegree,outdegree,degree,eccentricity,authority
-Dead-Eye-Duncan-,92,1,2,1,15,16,13,0.000203
10ebbor10,25,0,34,28,8,36,14,0.00543
3superfrank,24,0,38,25,5,30,14,0.007836
Angel1571,40,0,42,26,13,39,13,0.009803
Crew_1996,14,0,15,8,5,13,14,0.000562
DeltaBot,22,0,1045,285,33,318,12,0.059681
Destinyciello,276,0,253,58,36,94,14,0.009468
LucidMetal,119,0,119,51,18,69,12,0.009215
Salsa_and_Light2,30,0,49,12,11,23,14,0.001665
Temporary-Stay-8436,18,0,26,12,4,16,14,0.00303
Thumatingra,180,0,122,83,13,96,13,0.009675
Wombattington,17,0,17,6,4,10,15,0.00161
ZizzianYouthMinister,31,0,37,23,1,24,14,0.005455
gingerbreademperor,15,0,21,12,1,13,15,0.005244
superswellcewlguy,12,0,10,7,4,11,13,0.001423
tidalbeing,14,0,27,15,1,16,15,0.001999
-Tomato36,12,1,0,0,1,1,12,0
ScarletNotThatOne,90,0,137,114,3,117,11,0.000303
-w1tch,46,1,2,2,8,10,13,0.000433
CallMeCorona1,23,0,35,35,4,39,14,0.004658
Imadevilsadvocater,123,0,224,99,45,144,13,0.026763
Nrdman,307,0,352,81,17,98,14,0.010967
RedMarsRepublic,32,0,40,24,4,28,14,0.002912
jatjqtjat,39,0,88,62,7,69,13,0.011523
vote4bort,73,0,78,19,5,24,14,0.002509
123emarkley,43,1,0,0,3,3,11,0
South_Industry_1953,62,0,124,74,6,80,10,0.000137
SuccessfulAd4606,12,0,27,23,3,26,12,0.000364
lihzee,36,0,26,22,1,23,13,0.000015
12bEngie,381,2,36,10,56,66,12,0.004391
10thAmdAbsolutist,222,0,391,108,73,181,13,0.020629
BarleyWineIsTheBest,53,0,80,23,12,35,14,0.005391
Commercial-Print-,25,0,27,9,4,13,14,0.001261
Conscious-Function-2,34,0,35,24,4,28,14,0.007561
DoesMatter2,11,0,16,10,5,15,14,0.001493
False_Appointment_24,44,0,30,26,6,32,14,0.002309
FarConstruction4877,22,0,37,21,1,22,14,0.003799
GermanPayroll,36,0,23,28,7,35,13,0.00483
HexspaReloaded,108,1,20,14,19,33,11,0.003094
ImmortalAgentEta,21,0,19,9,3,12,15,0.002841
Inferno_Zyrack,19,0,22,18,8,26,14,0.003807
LisleAdam12,32,0,48,21,15,36,14,0.006254
MantisBuffs,1486,1,7,5,97,102,13,0.000834
Mental-Cupcake9750,13,0,19,8,0,8,0,0.003143
Morthra,152,0,171,106,59,165,13,0.019943
Mvpbeserker,12,0,19,11,7,18,14,0.004514
NaturalCarob5611,53,0,67,50,11,61,13,0.008105
Nofanta,24,0,29,16,0,16,0,0.007702
Phage0070,29,0,43,21,6,27,14,0.004231
Potential_Wish4943,66,0,45,33,12,45,14,0.006487
Ramguy2014,26,0,28,9,5,14,14,0.00291
RiverCityWoodwork,48,0,31,27,5,32,15,0.006219
Sure_Acanthaceae_348,14,0,25,17,3,20,14,0.006211
TPSreportmkay,133,0,108,32,7,39,14,0.008545
Vitruviansquid1,31,1,4,3,6,9,13,0.000433
WanderingSpearIt,60,0,62,24,3,27,14,0.003024
Wooden-Ad-3382,44,0,46,17,8,25,14,0.002463
ZorgZeFrenchGuy,15,0,15,14,5,19,15,0.005526
a_rabid_anti_dentite,20,0,12,6,2,8,13,0.001081
azuredota,27,0,22,8,5,13,13,0.001181
caseybvdc74,225,4,12,7,28,35,13,0.000857
darthmcdarthface,55,0,50,22,7,29,14,0.006151
hillswalker87,28,0,35,17,12,29,13,0.004763
ihatepasswords1234,55,0,79,26,18,44,14,0.007288
jbslaw1214,46,0,34,8,5,13,15,0.001278
lifeisabowlofbs,235,1,72,43,37,80,13,0.012691
nogooduse,51,1,20,12,6,18,13,0.015551
nrcx,15,0,25,9,6,15,14,0.000929
ozneoknarf,15,0,16,7,2,9,13,0.003096
saintsithney,14,0,15,9,5,14,14,0.001779
thebossmin,15,0,31,30,4,34,13,0.018171
212312383,171,3,25,18,28,46,12,0.007544
Beneficial-Diet-9897,14,0,30,14,3,17,13,0.003209
DrNogoodNewman,31,0,30,14,4,18,14,0.001997
Foulis68,44,0,48,17,7,24,14,0.005789
Happy-Viper,22,0,29,8,5,13,14,0.003042
Hypekyuu,20,0,42,27,6,33,14,0.00721
Inner_Butterfly1991,36,0,41,24,8,32,14,0.006324
Jaded_Jerry,28,0,22,29,0,29,0,0.010192
Madrigall,25,0,29,18,4,22,14,0.00336
Regalian,17,0,24,10,1,11,15,0.00148
Roadshell,85,0,78,36,10,46,14,0.007341
RulesBeDamned,27,0,38,44,7,51,15,0.011286
TheSauceeBoss,77,0,78,30,13,43,13,0.006838
ZoomZoomDiva,69,0,98,39,16,55,14,0.005856
azarash,11,0,12,7,3,10,14,0.001223
curiouslyjake,60,0,69,41,9,50,13,0.010128
davidml1023,65,0,54,24,10,34,15,0.004439
premiumPLUM,39,0,49,20,1,21,15,0.003798
the_1st_inductionist,37,0,65,35,4,39,15,0.006823
233w341,203,1,5,3,11,14,13,0.000432
Apprehensive_Song490,16,0,25,19,4,23,14,0.002883
Jew_of_house_Levi,38,0,31,10,5,15,14,0.001873
No-Cauliflower8890,56,0,55,12,4,16,14,0.003483
Ok-Round-1473,32,0,39,18,4,22,14,0.001817
PimplupXD,16,0,12,8,2,10,14,0.000512
XenoRyet,105,0,105,69,7,76,13,0.011745
canned_spaghetti85,14,0,30,22,3,25,15,0.005544
iamintheforest,65,0,73,49,8,57,14,0.007086
jman12234,323,3,8,2,40,42,13,0.000116
3OAM,86,1,0,0,12,12,13,0
00Oo0o0OooO0,40,0,17,16,1,17,15,0.001502
Appropriate_Owl_91,21,0,33,9,6,15,15,0.001217
Birb-Brain-Syn,43,0,26,14,4,18,14,0.002183
Electronic_Mango1,11,0,20,8,2,10,13,0.009709
Giblette101,64,0,95,51,36,87,13,0.012762
MagnanimosDesolation,45,0,51,20,6,26,13,0.004289
Murky-Magician9475,106,0,117,32,18,50,13,0.005246
Xralius,21,0,23,7,2,9,14,0.00108
anewleaf1234,211,0,283,101,33,134,12,0.019033
huntsville_nerd,15,0,27,16,5,21,14,0.002299
stewmander,27,0,26,15,11,26,13,0.004047
4-5Million,53,1,1,1,8,9,14,0.000101
Kakamile,89,0,107,51,18,69,13,0.010205
PM_ME_YOUR_NICE_EYES,88,0,93,52,5,57,14,0.009851
YardageSardage,32,0,48,30,2,32,13,0.002981
arrgobon32,68,0,36,23,2,25,15,0.002153
4Throw2My0Ass6Away9,216,1,0,0,7,7,14,0
--o,17,0,31,13,12,25,14,0.003932
AssistantAcademic,47,0,7,4,0,4,0,0.000039
Ayjayz,20,0,25,14,5,19,14,0.003897
Rainbwned,166,0,141,60,13,73,13,0.008381
sir_mrej,32,0,33,29,6,35,17,0.001129
thatoneguy54,16,0,19,12,4,16,14,0.007507
xienwolf,18,0,28,17,0,17,0,0.000421
4eUgh,254,1,0,0,25,25,14,0
Angylisis,73,0,69,25,12,37,13,0.005149
Appropriate_Fly_6711,22,0,34,18,3,21,14,0.00412
AspirationAtWork,52,0,72,17,7,24,14,0.003535
Blairians,25,0,38,30,3,33,13,0.006055
Eric1491625,20,0,6,10,1,11,16,0.002161
ILikeToJustReadHere,13,0,21,11,2,13,15,0.001587
Letters_to_Dionysus,20,0,39,33,6,39,14,0.007482
MasticatingElephant,14,0,5,9,1,10,15,0.000132
MooseRyder,14,0,16,11,4,15,14,0.00152
NotACommie24,35,0,31,11,6,17,13,0.002252
Ok-Trade-5937,114,1,22,8,16,24,14,0.000488
Relevant_Actuary2205,63,0,76,35,9,44,13,0.007618
ScalesOfAnubis19,82,0,95,28,15,43,14,0.0068
SlurpingDischarge,54,0,59,12,7,19,14,0.00058
ThrowRAboredinAZ77,22,0,21,8,5,13,14,0.000897
Total-Habit-7337,46,0,45,2,1,3,15,0.00008
Unfair_Explanation53,19,0,15,6,4,10,15,0.000859
annabananaberry,50,0,46,13,8,21,14,0.001666
itsnotcomplicated1,38,0,37,19,6,25,14,0.006033
majesticSkyZombie,53,0,111,53,21,74,14,0.005503
rolyfuckingdiscopoly,13,0,16,16,2,18,13,0.001772
5560Joe,89,1,8,3,19,22,13,0.009008
8to24,121,0,89,66,24,90,13,0.088358
Bodoblock,62,0,42,32,13,45,12,0.030683
Factory-town,147,0,224,85,53,138,13,0.120612
Hartastic,24,0,51,33,22,55,13,0.058238
ManBearScientist,58,0,80,52,22,74,14,0.087138
RocketRelm,32,0,31,34,17,51,13,0.050441
Sapriste,27,0,47,37,11,48,14,0.053513
Tadpoleonicwars,31,0,39,16,4,20,14,0.030531
WISCOrear,11,0,15,20,4,24,14,0.035834
baxterstate,90,0,146,91,15,106,13,0.132935
gonz4dieg,20,0,18,14,8,22,13,0.033187
harrumphstan,23,0,31,23,11,34,14,0.043133
ja_dubs,12,0,14,13,6,19,14,0.005419
kinkgirlwriter,25,0,44,34,10,44,13,0.070026
mrjcall,88,0,116,69,18,87,13,0.115232
shamrock01,15,0,12,10,2,12,14,0.01804
siberianmi,34,0,25,19,7,26,14,0.029855
tosser1579,42,0,43,30,6,36,14,0.035197
5_phx_felines,222,1,0,0,8,8,12,0
ConflictGullible392,44,0,83,63,2,65,12,0.00017
Crazyditz,14,0,2,2,0,2,0,0
Fearless_Spring5611,28,0,26,23,1,24,15,0.000071
Kathrynlena,13,0,17,7,1,8,1,0.000063
Money-Possibility606,26,0,13,9,1,10,2,0.00005
Worth-Season3645,24,0,46,40,1,41,13,0.000168
haleorshine,22,0,5,3,3,6,15,0.000019
nothurtjustamy,152,1,3,2,12,14,11,0.000016
5ma5her7,100,1,0,0,22,22,13,0
Alive-Necessary2119,40,0,62,22,13,35,13,0.006652
Calaveras-Metal,12,0,25,19,6,25,12,0.005715
Careless_Cicada9123,13,0,11,9,2,11,14,0.002026
Darkagent1,19,0,23,13,6,19,14,0.003346
Falernum,48,0,67,45,7,52,13,0.006916
Healthy_Shine_8587,2513,4,24,13,198,211,12,0.002091
Hothera,12,0,26,17,7,24,14,0.005751
HowDoIEvenEnglish,11,0,23,18,10,28,13,0.029015
ItsGrum14,32,0,29,17,9,26,14,0.004146
PreviousCurrentThing,43,0,53,41,26,67,14,0.024767
TemperatureThese7909,96,0,63,67,4,71,14,0.010601
TheMissingPremise,47,1,13,9,14,23,13,0.001603
Thoth_the_5th_of_Tho,57,0,57,42,16,58,12,0.007406
draculabakula,16,0,15,9,4,13,13,0.001835
fascistp0tato,126,1,27,7,20,27,13,0.001398
motherthrowee,14,0,26,20,1,21,15,0.002667
neotericnewt,56,0,67,24,14,38,14,0.008238
sullythered,12,0,25,10,7,17,14,0.003719
teateawea,14,0,15,11,6,17,14,0.001802
trickmirrorball,17,0,22,17,2,19,13,0.006543
69CallMeGod69,51,1,0,0,2,2,15,0
Feyle,56,0,72,19,6,25,14,0.000274
InvestigatorOk7015,20,0,25,20,3,23,16,0.000894
81forest,232,1,10,6,19,25,13,0.001178
Cactuswhack1,78,0,31,22,4,26,14,0.002747
FerdinandTheGiant,46,0,62,23,15,38,13,0.004255
IT_ServiceDesk,86,0,66,33,6,39,13,0.005912
KaiBahamut,45,0,72,26,20,46,14,0.00622
Mysterious_Cum,11,0,11,2,0,2,0,0.000729
ProfessionalLurkerJr,13,0,20,13,9,22,13,0.002221
SmokeySFW,14,0,20,10,1,11,14,0.002338
SupervisorSCADA,21,0,34,10,3,13,14,0.001421
TheMan5991,23,0,28,8,3,11,14,0.001186
YouJustNeurotic,39,0,55,35,6,41,13,0.006775
deftonite,21,0,20,15,4,19,14,0.002904
flairsupply,54,0,73,46,6,52,14,0.010066
vsv2021,19,0,21,12,5,17,14,0.010264
878895Nj,75,1,0,0,15,15,14,0
BKGPrints,247,0,245,35,25,60,14,0.031009
Flapjack_Jenkins,18,1,4,4,6,10,14,0.006006
InNominePasta,25,0,22,21,10,31,14,0.034264
IntrepidAd2478,30,0,32,25,16,41,14,0.034114
JDogg126,48,0,45,40,16,56,14,0.04807
Kuramhan,74,0,64,46,25,71,14,0.088852
MaineHippo83,114,0,112,68,31,99,13,0.082436
MonarchLawyer,19,0,17,18,2,20,15,0.021232
Tliish,18,0,47,32,10,42,14,0.055213
hymie0,15,0,11,12,4,16,14,0.014074
just_helping,114,0,175,76,55,131,13,0.126913
notpoleonbonaparte,11,0,15,15,2,17,15,0.018808
sunshine_is_hot,123,0,105,46,16,62,14,0.040676
theAltRightCornholio,12,0,27,21,9,30,14,0.027103
8NaanJeremy,264,2,32,12,27,39,13,0.002121
47ca05e6209a317a8fb3,25,0,17,16,2,18,13,0.002358
ButterscotchNo1546,63,0,62,9,6,15,14,0.001287
Downtown-Campaign536,14,0,17,15,1,16,16,0.004169
Dry_Bumblebee1111,160,0,152,81,5,86,13,0.016098
Fabulous-Suspect-72,111,0,155,54,20,74,14,0.008466
Potential_Being_7226,11,0,10,7,4,11,14,0.000601
Significant_Stand_17,11,0,20,8,1,9,15,0.001347
Slime__queen,25,0,26,10,4,14,14,0.001416
heroyoudontdeserve,27,0,45,22,11,33,14,0.004656
misanthpope,22,0,33,18,9,27,14,0.004221
sh00l33,11,0,42,40,8,48,14,0.007896
yyzjertl,165,0,126,49,9,58,14,0.008378
zxxQQz,17,0,24,25,16,41,13,0.003874
A12ms,35,1,0,0,1,1,1,0
Spare_Ad5009,19,0,47,41,0,41,0,0.000205
AAChyornyj,24,1,0,0,7,7,14,0
ClockOfTheLongNow,711,0,776,204,145,349,13,0.188253
CunnyWizard,47,0,62,24,8,32,13,0.00721
piotrlipert,42,1,6,5,6,11,13,0.00259
poprostumort,40,0,37,22,6,28,13,0.004074
AC1D-TITAN,38,1,0,0,6,6,13,0
0nlyhalfjewish,17,0,31,16,2,18,16,0.001058
Anomander,96,0,138,71,10,81,15,0.002801
JorgiEagle,12,0,10,3,1,4,1,0.000195
herejusttoannoyyou,22,1,12,6,4,10,16,0.000042
sllewgh,139,0,147,40,11,51,12,0.019124
xena_lawless,18,0,21,11,2,13,15,0.011035
AMO3883,84,1,0,0,1,1,15,0
According-Tea-3014,13,0,19,5,1,6,14,0.000147
AQ5SQ,16,1,0,0,2,2,15,0
shitposts_over_9000,49,0,106,64,8,72,14,0.002584
yelbesed,15,1,9,4,1,5,16,0.000021
ARandomCoolDude7,25,1,0,0,3,3,14,0
Fauropitotto,40,0,54,29,4,33,15,0.000392
InfernalOrgasm,149,1,157,69,14,83,13,0.001167
A_Child_of_Adam,222,3,0,0,21,21,14,0
AlternativeDue1958,29,0,32,14,6,20,15,0.003221
DAmieba,11,0,5,6,1,7,15,0.001499
DoeCommaJohn,88,0,33,38,5,43,14,0.005103
Hefty-Reaction-3028,23,0,20,16,7,23,14,0.003518
Jakyland,15,0,23,21,1,22,14,0.00483
Lanracie,21,0,43,29,4,33,14,0.057364
ReactionAble7945,62,0,77,35,2,37,16,0.00261
Rhundan,182,0,190,95,9,104,14,0.013714
RoundCollection4196,28,0,42,27,4,31,14,0.001355
WileyApplebottom,12,0,17,8,2,10,15,0.001113
XhazakXhazak,37,0,26,15,3,18,15,0.003664
YouLearnedNothing,42,0,47,27,9,36,14,0.00761
aurora-s,15,0,18,14,1,15,14,0.002458
coleman57,13,0,18,12,2,14,15,0.000878
yogfthagen,13,0,15,9,3,12,14,0.00287
Abject_Artichoke3820,72,1,0,0,8,8,11,0
LiveKindly01,72,0,82,31,8,39,10,0.000085
Specialist-Owl2660,17,0,28,11,0,11,0,0.000011
StAlvis,116,0,80,68,5,73,11,0.000204
moo-chu,12,0,25,18,2,20,12,0.000071
pottersquash,108,0,120,67,5,72,12,0.000287
AbyssWankerArtorias,40,1,1,1,15,16,11,0.000061
Full-Professional246,162,0,175,78,37,115,13,0.011577
Grunt08,57,0,42,24,7,31,14,0.002598
LivingGhost371,42,0,15,27,4,31,14,0.005886
Lylieth,82,0,104,45,8,53,14,0.005311
Oishiio42,58,0,36,14,8,22,12,0.001126
ProRuckus,47,0,71,36,4,40,14,0.006479
Rationally-Skeptical,32,0,30,10,4,14,14,0.001042
TheTyger,29,0,37,22,10,32,10,0.002853
heidismiles,28,0,33,24,8,32,13,0.002933
oversoul00,38,0,41,13,7,20,15,0.001653
scarab456,22,0,35,19,1,20,15,0.003364
AcanthaceaeJust2993,111,1,0,0,7,7,11,0
Alternative-Redditer,15,0,39,22,7,29,11,0.000155
BlondDee1970,11,0,26,20,0,20,0,0.000023
Snarky75,16,0,10,8,0,8,0,0.000057
Somebody_81,14,0,32,23,5,28,11,0.000064
TheDarkHelmet1985,24,0,47,31,5,36,11,0.000192
Trevena_Ice,25,0,25,22,2,24,1,0.000032
idoc-k18,43,0,8,12,1,13,1,0.000017
AcanthisittaKey5756,49,1,0,0,1,1,1,0
Top-Entertainer2546,11,0,17,15,0,15,0,0.000155
Acceptable-Tiger807,114,1,0,0,12,12,11,0
Actual-Swordfish1513,21,0,7,4,0,4,0,0.000004
Donutsmell,15,0,20,17,0,17,0,0.000038
MrsWeasley9,65,1,18,11,16,27,13,0.000942
No_Conversation_5661,17,0,19,8,1,9,17,0.000045
Ok-Raspberry7884,11,0,11,10,2,12,12,0.000015
Select-Promotion-404,17,0,9,8,3,11,15,0.000053
ThisWillAgeWell,50,0,50,26,1,27,13,0.000026
W0nderingMe,16,0,22,10,1,11,15,0.00012
chaserscarlet,13,0,4,3,1,4,1,0.000019
shelwood46,15,0,37,31,6,37,12,0.000144
Accurate-Broccoli-77,22,2,0,0,6,6,14,0
233C,18,0,16,11,3,14,13,0.005112
Canuck_Voyageur,39,2,28,25,3,28,15,0.000636
Choano,37,0,13,13,4,17,14,0.000643
RiskyBrothers,12,0,13,9,1,10,18,0.000445
SRIrwinkill,12,0,31,19,4,23,14,0.000407
actuallychrisgillen,16,0,20,9,0,9,0,0.00017
Accurate_Grab_2781,42,1,0,0,14,14,14,0
-dag-,20,0,23,17,7,24,14,0.033475
Cluefuljewel,22,0,37,26,7,33,14,0.05525
DanforthWhitcomb_,137,0,182,84,51,135,13,0.10111
Eminence_grizzly,12,0,13,10,2,12,15,0.029026
GoldenInfrared,15,0,25,20,7,27,14,0.017785
ScoobiusMaximus,26,0,27,20,5,25,14,0.043015
YetAnotherGuy2,19,0,24,16,4,20,13,0.020906
bl1y,354,0,509,146,109,255,13,0.153552
bones_bones1,19,0,21,20,1,21,15,0.042725
cakeandale,38,0,18,23,7,30,14,0.038918
discourse_friendly,135,0,190,96,41,137,13,0.11298
rookieoo,28,0,34,26,11,37,13,0.034882
Active-String-6136,22,1,0,0,3,3,12,0
ImpossibleReason2204,69,0,65,21,4,25,12,0.000062
Actual_Basil_1062,17,1,1,1,2,3,11,0.000005
Swimming-City-5001,102,0,105,78,4,82,10,0.00013
oliviamrow,14,0,13,10,0,10,0,0.000007
ActuatorOutside5256,191,1,0,0,21,21,12,0
CocoSavege,44,0,57,36,12,48,13,0.009762
GentleKijuSpeaks,19,0,27,11,1,12,15,0.0009
Glory2Hypnotoad,16,0,30,24,3,27,13,0.00563
Hellioning,29,0,54,44,0,44,0,0.009114
HolyToast,99,0,113,40,14,54,12,0.004506
LettuceFuture8840,55,0,73,46,26,72,13,0.065527
Noodlesh89,39,0,62,29,9,38,13,0.004428
ThePhilVv,31,0,36,19,13,32,11,0.001203
TheVioletBarry,55,0,77,31,4,35,12,0.00423
c0i9z,22,0,31,18,5,23,14,0.003601
mjwza,17,0,15,12,2,14,15,0.001437
AdEasy6864,573,1,0,0,24,24,10,0
Allaboutbird,49,0,47,33,5,38,10,0.000132
Bitter-Paramedic-531,13,0,16,12,1,13,13,0.000077
Calm_Marsupial3123,28,0,25,5,2,7,12,0.000021
CheezeLoueez08,43,0,39,9,6,15,12,0.000044
Kitastrophe8503,47,0,36,21,3,24,11,0.00002
LavishnessGeneral,11,0,10,4,1,5,13,0.00001
No-Potential-7242,25,0,30,20,0,20,0,0.000035
OrindaSarnia,28,0,24,7,1,8,13,0.000031
Oyster5436,14,0,18,12,2,14,12,0.000046
Possible-Tangelo9344,19,0,30,20,2,22,12,0.000117
SnooChipmunks770,12,0,40,12,2,14,12,0.000075
SuspiciousCod1090,12,0,25,18,0,18,0,0.000039
barfbat,14,0,20,10,4,14,11,0.000061
ike7177,14,0,17,4,0,4,0,0.000004
smol9749been,19,0,16,13,5,18,11,0.00006
starchy2ber,48,0,8,7,1,8,2,0.000028
AdMiserable7940,73,1,0,0,12,12,13,0
Baselines_shift,14,0,29,19,9,28,14,0.028671
CerddwrRhyddid,17,0,23,14,4,18,12,0.024824
ERedfieldh,13,0,41,33,9,42,14,0.060632
I405CA,231,0,215,126,36,162,13,0.16474
JKlerk,121,0,189,93,37,130,13,0.139639
Jeffery95,13,0,12,5,4,9,15,0.010495
SlowMotionSprint,15,0,34,29,12,41,14,0.053933
The_B_Wolf,58,0,63,38,10,48,14,0.036032
VodkaBeatsCube,202,0,239,69,40,109,13,0.114658
billpalto,45,0,74,53,7,60,13,0.103981
AdNo7052,53,1,0,0,13,13,14,0
Ana_Na_Moose,21,0,36,27,6,33,14,0.042945
Da_Vader,16,0,7,8,1,9,15,0.011672
Ill-Description3096,108,0,127,62,33,95,13,0.045041
Polyodontus,118,0,144,56,39,95,13,0.057846
Rastiln,41,0,38,35,13,48,13,0.033899
Specific-Hand3439,11,0,17,11,0,11,0,0.019922
ValenTom,103,1,1,1,22,23,13,0.000371
YnotBbrave,52,0,58,47,21,68,14,0.05781
datalicearcher,35,0,38,14,5,19,14,0.027958
jarchack,35,0,26,20,7,27,14,0.02905
satyrday12,40,0,57,46,20,66,13,0.072442
wiithepiiple,14,0,9,11,3,14,13,0.011952
Additional_924,35,1,0,0,1,1,12,0
Sorry_I_Guess,16,0,43,23,5,28,11,0.000175
AdhesivenessUnfair21,23,1,0,0,3,3,15,0
Fine-Sherbert-140,13,0,12,8,0,8,0,0.000025
Uubilicious_The_Wise,31,0,34,19,2,21,14,0.000053
Adorable_Standard_25,369,3,2,2,50,52,13,0.006301
Ashmedai,59,0,78,53,34,87,13,0.103199
BUSY_EATING_ASS,16,0,10,9,4,13,13,0.0188
Balanced_Outlook,109,1,67,32,26,58,13,0.049684
Banes_Addiction,19,0,19,22,7,29,14,0.045473
BluesSuedeClues,1610,6,279,117,189,306,12,0.142115
CelestialFury,21,0,27,11,4,15,13,0.026941
Dr_CleanBones,34,0,49,25,16,41,13,0.037139
Far_Realm_Sage,25,0,27,23,2,25,15,0.057388
Frank_JWilson,29,0,33,25,10,35,13,0.035458
Funklestein,66,0,70,32,13,45,14,0.063484
JohnSpartan2025,427,2,10,9,60,69,13,0.032519
Leather-Map-8138,37,0,68,47,11,58,13,0.091254
Mist_Rising,56,0,87,45,36,81,13,0.067127
Mrgoodtrips64,29,0,34,25,13,38,13,0.044355
Mztmarie93,24,0,42,36,22,58,13,0.051037
Nothing_Better_3_Do,134,0,109,61,27,88,13,0.090503
PM_me_Henrika,11,0,15,12,5,17,14,0.0226
Petrichordates,108,0,98,62,37,99,13,0.079043
RCA2CE,163,0,196,83,27,110,12,0.127969
Sageblue32,29,0,64,33,22,55,13,0.068139
Splenda,18,0,35,26,8,34,14,0.055065
TaxLawKingGA,17,0,18,18,9,27,14,0.031379
TheNavigatrix,135,1,23,13,28,41,14,0.023257
Xanto97,40,0,26,15,6,21,14,0.011862
Xytak,15,0,18,15,9,24,14,0.019397
Zagden,66,0,48,34,18,52,14,0.067126
anti-torque,22,0,66,34,25,59,13,0.069336
countrykev,22,0,39,27,12,39,14,0.035293
daretoeatapeach,14,0,25,11,10,21,13,0.008135
eh_steve_420,22,0,66,38,26,64,13,0.067782
frisbeejesus,34,0,31,30,12,42,13,0.054737
kingjoey52a,60,0,49,53,10,63,13,0.055049
rcglinsk,11,0,12,10,4,14,13,0.024933
slayer_of_idiots,143,0,113,56,16,72,13,0.07557
urnever2old2change,24,0,29,16,7,23,12,0.011228
weealex,13,0,15,16,5,21,13,0.039089
zaoldyeck,162,0,178,63,51,114,13,0.06205
Advanced-Prototype,82,1,0,0,10,10,14,0
PreparationAdvanced9,13,0,13,9,6,15,14,0.007866
Zadow,12,0,14,12,8,20,14,0.009236
chamrockblarneystone,29,0,52,29,25,54,14,0.052711
das_war_ein_Befehl,27,0,29,24,11,35,14,0.040745
jetpacksforall,70,0,102,49,34,83,13,0.086614
peetnice,11,0,16,14,6,20,13,0.021015
Adventurous-Ad5999,83,1,0,0,14,14,13,0
Biptoslipdi,68,0,73,20,6,26,14,0.00507
GotAJeepNeedAJeep,72,0,53,19,7,26,14,0.003161
Natural-Arugula,33,0,51,42,14,56,13,0.010452
PuckSenior,57,0,74,27,6,33,13,0.005469
eggs-benedryl,16,0,27,18,1,19,15,0.002017
lametown_poopypants,14,0,9,6,1,7,15,0.003058
onetwo3four5,12,0,9,6,1,7,15,0.000394
Affectionate-Call762,46,1,0,0,1,1,15,0
HauntedReader,64,0,56,15,3,18,14,0.002362
Affectionate_Turn882,25,1,0,0,5,5,11,0
Competitive_Tale_799,13,0,28,18,2,20,13,0.000023
Mmm_lemon_cakes,14,0,15,6,1,7,16,0.000075
AfricanAmericanTsar,91,1,0,0,19,19,13,0
Alive_Ice7937,12,0,9,4,1,5,16,0.000219
Appropriate_Mixer,18,0,14,12,5,17,14,0.003162
CremasterReflex,15,0,21,5,2,7,13,0.000814
Duckfoot2021,22,0,32,22,9,31,14,0.02678
Galious,13,0,18,8,1,9,14,0.00178
GiveMeBackMySoup,25,0,30,20,10,30,13,0.005626
Hard_Corsair,15,0,13,5,3,8,13,0.000506
Kerostasis,75,0,67,42,11,53,13,0.00601
ReOsIr10,37,0,32,16,3,19,15,0.004036
SnooOpinions8790,53,1,4,6,5,11,13,0.001266
Z7-852,318,1,266,55,28,83,13,0.007502
darwin2500,18,0,28,21,6,27,15,0.003474
ethical_arsonist,23,0,34,12,1,13,14,0.003327
hacksoncode,62,0,87,45,11,56,13,0.015485
horshack_test,45,0,68,17,3,20,13,0.002399
shadofx,16,0,18,6,2,8,17,0.00199
AgUnityDD,540,1,0,0,42,42,14,0
Acrobatic_Ear6773,11,0,10,8,4,12,14,0.000731
AleristheSeeker,47,0,48,19,6,25,13,0.002185
BrooklynSmash,22,0,19,23,12,35,13,0.006081
Dare_Ask_67,271,3,15,13,41,54,13,0.004111
Falsequivalence,12,0,11,7,3,10,14,0.001707
Flor1daman08,102,0,138,38,29,67,13,0.046571
Jaymoacp,22,0,12,10,5,15,14,0.001704
MaxwellKillMill,19,0,24,10,3,13,14,0.004827
Middle_Ad8183,19,0,19,12,9,21,14,0.014153
NoInsurance8250,11,0,17,12,4,16,15,0.004601
P4ULUS,17,0,22,8,2,10,14,0.003057
Qubit_Or_Not_To_Bit_,59,0,60,40,30,70,13,0.018064
RegressToTheMean,53,0,30,20,13,33,14,0.012336
Rusty-Shackleford000,61,0,69,16,10,26,14,0.004597
SandyVaj,45,0,3,6,1,7,15,0.000333
Severe-Illustrator87,16,0,16,3,0,3,0,0.001041
Socialimbad1991,16,0,24,19,7,26,14,0.009401
Utterlybored,25,0,31,26,8,34,14,0.043247
ashmortar,19,0,15,10,7,17,14,0.001526
atred,19,0,25,16,6,22,14,0.015738
crashfrog05,149,0,111,31,13,44,13,0.005017
dmburl,13,0,3,2,1,3,16,0.000436
dukeimre,13,0,26,19,5,24,14,0.006792
elCharderino,16,0,10,9,1,10,15,0.005703
grumblingduke,11,0,8,2,1,3,14,0.000402
mapadofu,16,0,21,11,2,13,14,0.002776
sapphireminds,58,0,55,16,8,24,14,0.002891
strikerdude10,21,0,23,17,2,19,14,0.003018
weedywet,17,0,18,15,2,17,14,0.005132
Aggravating-Two7858,81,1,0,0,10,10,12,0
Elegant_Bluebird_460,12,0,17,9,0,9,0,0.000029
FuturelessSociety,615,1,96,42,48,90,11,0.007889
No-Assignment5538,33,0,53,29,2,31,12,0.000134
West_House_2085,23,0,61,40,4,44,13,0.000193
Wise_Session_5370,12,0,52,41,1,42,1,0.000214
Agile-Project3310,48,1,0,0,2,2,11,0
KaliTheBlaze,24,0,32,15,4,19,14,0.000008
Agitated-Ad6744,56,1,0,0,7,7,14,0
Eric848448,48,0,44,32,10,42,13,0.051875
Hapankaali,42,0,49,24,11,35,14,0.054647
InquiringAmerican,11,0,10,5,1,6,14,0.012211
RKU69,53,0,52,28,21,49,13,0.042345
Agitated-Policy8304,61,1,0,0,3,3,11,0
Dizzy_Needleworker_3,21,0,32,14,4,18,14,0.000109
Agitated_Musician_31,14,1,0,0,2,2,13,0
CertainGoon,12,0,11,5,1,6,12,0.000001
ProfessorDistinct835,11,0,15,11,0,11,0,0.000045
AintASaintLouis,62,1,0,0,14,14,13,0
Cultist_O,24,0,29,17,6,23,14,0.001588
NeoConzz,547,1,1,1,43,44,13,0.000086
PaxNova,24,0,35,32,7,39,14,0.005488
delimeats_9678,31,0,34,15,5,20,13,0.001365
le_fez,11,0,11,11,0,11,0,0.001179
robdingo36,12,0,2,5,1,6,13,0.000502
Alarmed_Giraffe_5284,1466,1,0,0,32,32,10,0
AussieBelgian,21,0,2,5,1,6,12,0.000014
Effective-Birthday57,11,0,16,8,2,10,13,0.000036
EmceeSuzy,74,0,47,21,3,24,11,0.000027
Expensive_Yam_2222,19,0,25,5,3,8,12,0.000003
ImportantOnion9937,11,0,21,18,2,20,12,0.000062
Ok_Ad_2437,24,0,2,1,0,1,0,0.000002
OrganicContest4957,19,0,8,8,1,9,14,0.000183
PacificWesterns,35,0,4,4,1,5,14,0.000002
PeelingMirthday,13,0,12,8,1,9,13,0.000006
ScaryButterscotch474,14,0,41,32,1,33,1,0.000173
SykesLightning,12,0,14,4,1,5,13,0.000026
TheSanityInspector,11,0,3,2,0,2,0,0.000002
Time-Tie-231,32,0,36,21,1,22,13,0.000208
West_Hat7270,41,1,22,13,2,15,12,0.000046
WillowGirlMom,22,0,26,2,3,5,13,0.000002
adventuresofViolet,49,0,36,32,2,34,12,0.00011
agoldgold,50,0,12,9,4,13,12,0.000081
amrjs,62,0,52,6,5,11,11,0.000005
i_was_a_person_once,17,0,24,7,6,13,12,0.000019
jennalynne1,11,0,1,3,1,4,15,0.000002
k23_k23,14,0,71,58,0,58,0,0.000104
lemon_charlie,25,0,38,15,9,24,11,0.000174
littlebitfunny21,23,0,48,29,8,37,11,0.000121
spid3rham90,21,0,34,17,4,21,14,0.00005
tcdaf7929,47,0,44,7,5,12,10,0.000142
terrika_has_spoken,15,0,20,12,2,14,12,0.00006
Alcatraz4567,70,1,0,0,4,4,12,0
DarkMarxSoul,18,0,23,6,1,7,13,0.000045
EchoingSimplicity,17,0,17,3,2,5,12,0.000024
firematt422,23,0,34,24,5,29,11,0.001142
Aleksadnar,159,1,0,0,33,33,13,0
-SOFA-KING-VOTE-,69,0,75,25,11,36,13,0.02477
BitterFuture,116,0,176,52,41,93,13,0.07357
BothDiscussion9832,33,0,44,33,20,53,12,0.055331
CptPatches,34,1,20,16,8,24,14,0.037436
Dull_Conversation669,11,0,22,24,4,28,13,0.045189
GarbledComms,14,0,14,15,5,20,14,0.022076
IniNew,43,0,43,26,13,39,13,0.059892
Leopold_Darkworth,20,0,24,22,9,31,14,0.044557
Ok_Macaroon6155,30,0,34,17,7,24,14,0.034325
StanDaMan1,13,0,15,12,8,20,13,0.025629
Wave_File,30,0,30,25,10,35,13,0.032106
Y0___0Y,64,0,38,38,11,49,14,0.052277
almightywhacko,27,0,33,26,6,32,14,0.066755
blaqsupaman,17,0,12,14,10,24,14,0.013826
onlyontuesdays77,51,0,56,21,14,35,13,0.039784
rhombecka,13,0,11,10,4,14,14,0.021712
swagonflyyyy,40,0,47,29,12,41,13,0.052206
the_calibre_cat,55,0,106,42,31,73,13,0.07602
Alert-Jacket415,20,1,0,0,1,1,1,0
Aletheisthenes,396,1,0,0,41,41,13,0
AdhesivenessCivil581,18,0,11,16,4,20,13,0.037351
BadHabitOmni,17,0,21,5,4,9,14,0.007541
Brickscratcher,31,0,60,21,17,38,13,0.036306
DarkSoulCarlos,11,0,14,3,1,4,14,0.005629
Fargason,78,0,84,24,16,40,13,0.031235
Fragrant-Luck-8063,26,0,34,22,12,34,14,0.044036
GrowFreeFood,23,0,39,20,12,32,14,0.02985
I-Here-555,61,0,57,38,23,61,13,0.065216
Interrophish,51,0,123,48,35,83,14,0.088759
JQuilty,25,0,29,14,8,22,13,0.033964
Kman17,87,0,61,50,7,57,14,0.033706
New2NewJ,14,0,19,17,9,26,14,0.035899
Sarmq,17,0,28,13,4,17,14,0.025175
Tiny_Ad_3650,370,2,2,1,57,58,13,0.001539
TreeLicker51,90,1,1,1,14,15,13,0.001539
UncleMeat11,17,0,27,15,9,24,14,0.02298
absolutefunkbucket,20,0,38,9,6,15,14,0.012762
bleahdeebleah,11,0,18,16,8,24,13,0.022703
friedgoldfishsticks,37,0,58,26,13,39,14,0.038628
gregaustex,33,0,23,25,5,30,14,0.045977
novagenesis,40,0,60,27,16,43,14,0.036282
sailorbrendan,14,0,13,8,2,10,16,0.003952
stripedvitamin,12,0,14,10,5,15,13,0.018539
trace349,18,0,25,15,14,29,14,0.035576
AlexFerrana,71,1,0,0,5,5,13,0
Obvious_Chapter2082,62,0,49,25,13,38,14,0.021263
Orphan_Guy_Incognito,60,0,69,37,24,61,12,0.011828
Tengoatuzui,36,0,45,21,8,29,13,0.005526
Toverhead,87,0,83,52,10,62,13,0.013208
AlexZedKawa02,197,1,0,0,21,21,12,0
Cheshire_Khajiit,36,0,44,27,10,37,14,0.01105
CrazyCoKids,360,1,16,6,35,41,11,0.002079
FairDinkumMate,844,1,12,10,82,92,12,0.001259
Quankers,21,0,27,11,5,16,15,0.005826
TrumpetDuster,20,0,14,4,1,5,16,0.000434
X-calibreX,29,0,39,11,8,19,14,0.003493
comment_i_had_to,18,0,29,15,3,18,14,0.004137
hi_imjoey,17,0,11,7,0,7,0,0.001072
irespectwomenlol,20,0,10,11,4,15,13,0.001658
moderatelymeticulous,105,2,13,8,17,25,13,0.002575
nefarious_planet,31,0,18,13,4,17,12,0.001599
uisce_beatha1,12,0,18,6,1,7,14,0.002894
ygmc8413,58,0,57,18,9,27,14,0.002086
Alex_Danko,2551,1,0,0,132,132,11,0
---AI---,24,0,30,12,9,21,13,0.001329
Acceptable-Remove792,18,0,20,8,2,10,16,0.003112
AdministrativeSet419,23,0,10,10,3,13,14,0.001885
Anon28301,13,0,15,6,5,11,14,0.000749
Apathetic_Villainess,17,0,18,4,4,8,12,0.000624
Apprehensive_Run238,51,0,36,6,4,10,15,0.000466
Apprehensive_Set_105,16,0,16,4,4,8,13,0.000459
ArguteTrickster,34,0,40,8,6,14,14,0.001326
Arthesia,51,0,15,16,1,17,14,0.003558
Automatic_Tackle_406,20,0,27,11,10,21,12,0.003298
BaguetteFetish,34,0,33,19,16,35,14,0.005051
Biffs_bunny,45,0,34,13,9,22,13,0.000994
BigMax,17,0,15,7,1,8,1,0.002857
Bilabong127,15,0,13,8,3,11,14,0.001677
Bootmacher,60,0,53,12,5,17,14,0.003097
BrazilBound25,14,0,13,9,6,15,14,0.001523
Chairman_of_the_Pool,14,0,4,8,2,10,15,0.00083
Charlie4s,39,0,57,34,9,43,14,0.00564
Constellation-88,48,0,61,22,11,33,11,0.006136
ConsultJimMoriarty,61,0,50,22,9,31,12,0.002388
DaddyRocka,15,0,21,10,9,19,13,0.002748
DotCottonCandy,24,0,16,6,3,9,12,0.000691
FaithfulPichu,13,0,15,4,4,8,15,0.000964
FrgTurdeson,40,0,65,30,12,42,13,0.012737
H8r,12,0,7,2,2,4,13,0.000463
HighLadyOfTheMeta,28,0,7,7,2,9,14,0.000759
Horselady234,14,0,18,15,8,23,13,0.006528
Ihsan2024,12,0,13,5,4,9,14,0.002322
Imaginary-Orchid552,43,0,42,33,20,53,13,0.010768
InfamousDeer,22,0,14,17,6,23,12,0.00228
Infinite_Collar_7610,11,0,13,2,2,4,15,0.000443
Infinite_Wheel_8948,21,0,28,14,11,25,14,0.004362
IwantyoualltoBEDAVE,11,0,24,4,2,6,15,0.001029
Jakobites,15,0,17,9,3,12,14,0.002039
JawtisticShark,18,0,26,20,6,26,14,0.004562
Kaiisim,23,0,10,11,1,12,14,0.002238
Key_Cheetah7982,61,0,116,31,38,69,13,0.008047
LACityBabe,13,0,1,5,0,5,0,0.000602
Mad_Maddin,16,0,24,15,12,27,13,0.003603
Mammoth_Western_2381,15,0,7,14,0,14,0,0.002889
ManufacturerVivid164,14,0,19,9,4,13,14,0.002629
Maximumoverdrive76,31,0,31,13,10,23,13,0.003636
Mean_Lawfulness_9781,11,0,14,5,3,8,13,0.002705
MeanderingDuck,16,0,26,13,8,21,13,0.002121
MeanestGoose,13,0,10,9,0,9,0,0.001962
MelissaMiranti,22,0,24,4,4,8,13,0.000933
Melodic_Contract8155,134,1,4,2,18,20,13,0.00046
Na7vy,48,1,3,1,15,16,13,0.000439
NefariousnessMost660,12,0,23,9,6,15,13,0.002433
Nsfwacct1872564,16,0,21,8,8,16,13,0.001927
Ok-Anteater_6635x,17,0,15,10,5,15,14,0.001659
Only_Raccoon9397,15,0,18,6,3,9,15,0.001686
PassionGlobal,12,0,20,12,4,16,14,0.003471
Philstar_nz,20,0,35,16,7,23,13,0.003785
PinkestMango,12,0,8,5,3,8,13,0.000694
Pip-Pipes,13,0,13,4,2,6,14,0.001464
PrimeWolf101,14,0,12,4,2,6,15,0.000977
Puzzleheaded_Mix4160,27,0,24,7,4,11,14,0.000686
QueueOfPancakes,11,0,18,5,5,10,16,0.000674
Rawlott1620,26,0,25,11,9,20,13,0.001698
Rivercitybruin,39,0,65,51,11,62,14,0.072558
Robie_John,21,0,32,14,8,22,14,0.004564
Rollingforest757,12,0,27,7,9,16,14,0.000582
SatisfactionActive86,15,0,7,10,2,12,15,0.002031
SheWhoLovesSilence,16,0,12,5,4,9,13,0.00133
Shot-Vacation2469,14,0,24,8,11,19,14,0.001438
Solondthewookiee,29,0,36,14,6,20,12,0.003418
Stereo_Jungle_Child,56,0,41,37,5,42,13,0.007378
StonedTrucker,13,0,8,6,3,9,14,0.0017
Technical-Revenue-48,15,0,16,8,4,12,13,0.000955
Teddy_The_Bear_,39,0,43,23,7,30,14,0.004136
Telaranrhioddreams,11,0,15,9,2,11,14,0.002132
The_Amazing_Emu,21,0,20,2,1,3,15,0.000454
ToSAhri,32,0,37,19,11,30,13,0.004215
Top-Bootylover,11,0,13,4,2,6,13,0.000901
Uhhyt231,64,0,83,27,3,30,14,0.005635
WarbleDarble,94,0,130,36,34,70,14,0.033833
allbusiness512,20,0,15,5,3,8,14,0.001119
bizarre_coincidence,13,0,14,8,3,11,14,0.002306
cbbclick,11,0,9,3,3,6,12,0.000624
cstar1996,26,0,30,11,8,19,14,0.002086
dbandroid,11,0,14,6,3,9,14,0.000881
energirl,12,0,16,6,5,11,14,0.002307
ferdaw95,19,0,26,15,8,23,12,0.004548
gorkt,12,0,11,5,2,7,12,0.001656
jimmyxtang,23,0,17,5,4,9,14,0.000493
jinjuwaka,17,0,21,8,8,16,13,0.002879
joittine,25,0,38,16,9,25,13,0.003692
jrssister,23,0,27,6,2,8,10,0.000632
kimariesingsMD,24,0,39,14,8,22,13,0.002014
koolaid-girl-40,48,0,45,15,5,20,14,0.004792
lee1026,93,0,118,47,23,70,14,0.013735
mallardramp,13,0,27,12,7,19,12,0.006206
mangababe,12,0,18,12,7,19,13,0.004605
natelion445,19,0,31,13,6,19,13,0.003519
octocatty,39,0,42,5,3,8,15,0.000871
ofBlufftonTown,21,0,27,13,9,22,14,0.002388
oremfrien,16,0,20,10,7,17,13,0.00138
pawnman99,15,0,24,11,10,21,13,0.002637
punta_del_diablo,12,0,14,6,3,9,15,0.000846
real-bebsi,19,0,24,7,7,14,14,0.000651
serene_brutality,12,0,21,19,2,21,15,0.0047
sewerbeauty,12,0,9,5,1,6,14,0.000748
silverionmox,124,0,145,33,26,59,11,0.025257
stoneimp,16,0,18,13,7,20,14,0.010927
stormy2587,11,0,11,6,3,9,14,0.001546
swallowmoths,15,0,13,9,4,13,13,0.003246
the_brightest_prize,22,0,31,10,4,14,13,0.001971
thinsoldier,15,0,26,19,10,29,13,0.006467
tittyswan,16,0,22,9,5,14,15,0.002869
trthorson,24,0,11,5,1,6,15,0.000514
youwillbechallenged,21,0,26,23,9,32,13,0.020957
Alex_markou,81,1,0,0,5,5,15,0
Jackandahalfass,18,0,26,17,1,18,15,0.000236
Mono_Clear,34,0,37,12,3,15,14,0.001317
QubitEncoder,12,0,13,2,0,2,0,0.000069
SendMeYourDPics,18,0,31,24,0,24,0,0.000784
AlexandrTheTolerable,335,1,14,9,44,53,13,0.021679
Alive_Shoulder3573,59,0,80,18,15,33,14,0.027719
BRAINSPLATTER16,15,0,26,8,5,13,14,0.010007
Delta-9-,35,0,55,30,20,50,14,0.057219
FrozenSeas,23,0,19,20,9,29,14,0.040557
Hyndis,22,0,28,17,11,28,14,0.0391
IleGrandePagliaccio,31,0,31,9,4,13,14,0.01707
Jen0BIous,15,0,29,12,1,13,15,0.018722
KurtisRambo19,12,0,12,6,3,9,14,0.017953
Moccus,75,0,95,49,36,85,13,0.071866
Objective_Aside1858,3487,6,160,93,290,383,12,0.078647
TheMikeyMac13,73,0,65,35,13,48,14,0.050001
UnfoldedHeart,63,0,99,66,32,98,13,0.098414
WinterOwn3515,13,0,7,11,0,11,0,0.01065
XXXCincinnatusXXX,25,0,24,12,5,17,14,0.021899
clios_daughter,18,0,21,9,5,14,13,0.005724
damndirtyape,591,2,6,5,74,79,13,0.010313
ezrs158,13,0,8,15,7,22,14,0.024108
mskmagic,31,0,37,17,7,24,13,0.026329
neosituation_unknown,24,0,16,16,0,16,0,0.020675
notawildandcrazyguy,12,0,8,10,3,13,14,0.018608
skyfishgoo,13,0,34,22,4,26,14,0.046417
sunfishtommy,25,1,17,16,10,26,14,0.038421
theyfellforthedecoy,51,0,58,43,21,64,14,0.080907
Alive-Isopod-1194,67,1,0,0,5,5,13,0
Dukklings,18,0,38,25,3,28,12,0.00014
PushPopNostalgia,17,0,27,18,3,21,15,0.002267
All_Hale_sqwidward,13,1,0,0,2,2,15,0
TotalityoftheSelf,32,0,31,13,8,21,14,0.003233
Xanith420,50,0,39,12,6,18,14,0.00139
AlmanacPony,23,1,0,0,2,2,16,0
ChChChillian,29,0,40,19,5,24,15,0.000663
venuswasaflytrap,19,0,28,13,2,15,18,0.000199
Alone-Window136,13,1,0,0,1,1,13,0
Alp2018,25,1,0,0,4,4,12,0
KatzAKat,11,0,14,11,0,11,0,0.000059
WabbitCZEN,11,0,12,12,4,16,12,0.000032
AlpineSuccess-Edu,901,1,0,0,103,103,13,0
ApeAF,14,0,11,9,5,14,14,0.00676
Apprehensive-Let3348,15,0,25,12,5,17,14,0.003578
Arstanishe,30,0,28,23,8,31,14,0.005135
ArthurSouthville,228,1,2,2,28,30,13,0.000619
Candid_Beat8390,13,0,28,19,8,27,14,0.003857
CaptCynicalPants,129,0,93,50,18,68,14,0.008815
Celebrinborn,46,0,27,23,9,32,14,0.006341
CosmicLovepats,18,0,24,10,1,11,15,0.004156
DTF_Truck,14,0,17,8,3,11,15,0.004683
DataTouch12,39,0,37,5,2,7,15,0.001152
Doc_ET,19,0,25,18,9,27,13,0.004785
DrRealName,15,0,19,11,4,15,14,0.005058
DungeonJailer,15,0,20,16,6,22,13,0.006645
EdenSire0,36,0,54,20,7,27,13,0.004817
EmptyDrawer2023,40,0,35,18,7,25,14,0.005642
False-War9753,11,0,5,9,2,11,14,0.00181
Fit-Order-9468,54,0,61,16,5,21,14,0.008774
HadeanBlands,248,0,231,57,29,86,13,0.008291
HombreDeMoleculos,13,0,22,9,8,17,14,0.003747
Jake0024,49,0,79,30,13,43,14,0.018802
KlausVonChiliPowder,35,0,31,22,12,34,14,0.006334
Korimito,27,0,38,11,4,15,14,0.003808
LIONS_old_logo,21,0,26,11,5,16,15,0.003659
LanaDelHeeey,64,0,49,27,13,40,13,0.019196
Leon_Thomas,23,0,26,10,2,12,14,0.003044
Lethkhar,22,0,31,20,9,29,14,0.005158
LumpBizquik,17,0,28,13,15,28,14,0.003114
MorganWick,25,0,44,30,15,45,13,0.040853
Mrs_Crii,57,0,48,28,14,42,14,0.008509
NittanyOrange,20,0,16,9,2,11,15,0.001712
NotMyBestMistake,77,0,71,37,10,47,13,0.005434
Ok_Soft_4575,42,0,51,16,8,24,14,0.002849
Ok_Swimming4427,19,0,24,13,3,16,12,0.004271
Ornery-Ticket834,26,0,59,38,14,52,14,0.055324
Ornery_Gate_6847,36,0,9,13,4,17,14,0.001129
PapaverOneirium,49,0,53,23,21,44,14,0.003776
ProDavid_,253,0,277,95,22,117,13,0.013226
Proud-Sandwich8516,15,0,15,7,6,13,14,0.002428
Randomousity,40,0,72,25,23,48,14,0.005955
RealJohnBobJoe,46,0,48,16,2,18,15,0.003758
Rhomya,12,0,14,9,5,14,14,0.001872
RickRussellTX,34,0,45,30,3,33,14,0.003303
Secret-Put-4525,18,0,23,14,6,20,14,0.003304
SirWillae,12,0,13,13,0,13,0,0.003924
Sky-Trash,12,0,16,13,9,22,14,0.00562
SlipperWheels,82,0,82,20,8,28,14,0.004086
Supercollider9001,33,0,29,14,5,19,14,0.010216
Talik1978,91,0,95,26,11,37,14,0.008076
TheDrakkar12,836,1,18,13,80,93,13,0.003587
Trauma_Hawks,21,0,19,9,6,15,14,0.001678
Warchief_Ripnugget,12,0,23,14,8,22,14,0.004254
What_the_8,19,0,18,13,7,20,14,0.003462
bemused_alligators,16,0,15,15,4,19,13,0.004828
blyzo,30,0,30,23,8,31,14,0.020641
bugsmaru,16,0,13,13,5,18,14,0.003809
cbf1232,31,0,38,12,10,22,14,0.002614
epelle9,16,0,27,12,4,16,14,0.002165
fossil_freak68,94,0,107,23,12,35,13,0.00248
idontknowhow2reddit,90,0,28,19,2,21,14,0.003494
jabbanobada,12,0,16,6,2,8,14,0.001577
ninja-gecko,41,0,43,21,7,28,13,0.003769
ornery_curmudgeon,32,0,36,14,12,26,13,0.003804
poorestprince,17,0,35,24,0,24,0,0.004319
princess-barnacle,541,1,1,1,50,51,13,0.000514
qchisq,11,0,8,10,1,11,14,0.016559
rjtnrva,13,0,18,13,5,18,13,0.001937
stockinheritance,111,1,59,34,25,59,12,0.007232
suitupyo,23,0,19,12,3,15,14,0.017045
themcos,62,0,72,38,6,44,14,0.007097
torytho,12,0,29,23,0,23,0,0.008217
unordinarilyboring,17,0,31,20,4,24,14,0.005379
wetshatz,41,0,37,8,7,15,13,0.005392
wulfgar_beornegar,27,0,35,10,8,18,14,0.017019
Alternative-ta-663,68,1,0,0,6,6,12,0
Candid-Narwhal-3215,17,0,23,9,0,9,0,0.00003
Kami_Sang,33,0,30,29,4,33,11,0.000138
thechaoticstorm,27,0,27,19,0,19,0,0.000114
AltonBurk,15,1,2,2,1,3,14,0.000004
Altruistic_Froyo_174,49,1,0,0,3,3,16,0
Wurm42,20,0,5,11,0,11,0,0.010847
Altruistic_Rain_1300,20,1,0,0,3,3,14,0
Dittoheadforever,17,0,27,24,0,24,0,0.000057
Amazing-Buy-1181,194,1,0,0,19,19,13,0
Agitated-Quit-6148,25,0,33,11,8,19,14,0.001707
Exact-Joke-2562,12,0,21,14,4,18,13,0.002518
KJongsDongUnYourFace,25,0,14,9,4,13,13,0.000369
Negative_Jaguar_4138,16,0,23,12,6,18,13,0.002347
One-Independent8303,86,0,81,22,6,28,14,0.004221
Our_GloriousLeader,12,0,11,7,1,8,1,0.001067
RiceGold3688,12,0,10,11,3,14,15,0.00255
Sir-Viette,18,0,9,10,1,11,15,0.001699
Tangentkoala,12,0,13,9,2,11,14,0.002324
Throwaway5432154322,24,0,31,8,7,15,14,0.007596
comeon456,97,0,52,28,6,34,13,0.003561
iL0veLittleGirl,211,0,143,56,25,81,14,0.006768
s_wipe,35,0,35,19,3,22,15,0.00336
sincsinckp,12,0,35,23,5,28,14,0.004727
AmazingAffect5025,21,1,0,0,3,3,14,0
Anaelepse,162,1,0,0,34,34,14,0
AndlenaRaines,18,0,10,13,4,17,14,0.014587
BrainDamage2029,33,0,23,30,14,44,14,0.033805
HardlyDecent,27,0,38,39,8,47,13,0.066286
Hautamaki,15,0,10,10,5,15,14,0.018121
KeyYak4008,19,0,49,14,10,24,14,0.033142
KingKnotts,61,0,63,17,17,34,14,0.021565
MrChow1917,19,0,20,13,6,19,14,0.011351
MrMrLavaLava,13,0,22,13,7,20,14,0.025732
Riokaii,29,0,49,33,14,47,13,0.081383
SchuminWeb,16,0,32,21,14,35,14,0.049748
Select_Insurance2000,11,0,14,14,4,18,14,0.018382
WavesAndSaves,662,2,73,60,97,157,13,0.080924
YogurtclosetOwn4786,20,0,18,12,4,16,15,0.019083
demihope,26,0,18,15,6,21,14,0.025948
indescipherabled,14,0,22,11,9,20,14,0.022818
kormer,21,0,24,14,7,21,13,0.031002
mikeber55,13,0,15,15,4,19,14,0.011835
punninglinguist,30,0,14,19,1,20,15,0.019983
reasonably_plausible,19,0,25,25,7,32,13,0.043466
yo2sense,23,0,28,12,9,21,14,0.026811
AncienTleeOnez,72,1,20,14,23,37,13,0.026291
ButGravityAlwaysWins,13,0,6,7,1,8,15,0.002451
Roadside_Prophet,17,0,12,13,6,19,13,0.011208
RockinRobin-69,12,0,8,6,4,10,14,0.014492
Rook_lol,18,0,10,11,4,15,14,0.017648
Sands43,31,0,7,14,1,15,16,0.030093
TheOvy,21,0,25,20,3,23,13,0.044714
ThePensiveE,20,0,29,24,7,31,14,0.048586
__zagat__,42,0,68,30,26,56,12,0.059494
infiniteninjas,13,0,14,5,2,7,14,0.009179
Ang3l_st0ckingz,75,1,1,1,7,8,14,0.000201
CreatineAddiction,19,0,29,8,2,10,15,0.001
LaquaviusRawDogg,51,1,23,12,12,24,13,0.00229
LowRevolution6175,13,0,14,12,5,17,15,0.004061
PandaMime_421,21,0,26,22,9,31,13,0.00296
Anonymous__Paul,13,1,0,0,3,3,16,0
CandylandCanada,30,0,53,37,2,39,15,0.000039
RoyallyOakie,23,0,26,24,0,24,0,0.000056
Anth0nyGolo,18,1,0,0,4,4,14,0
PhaseFull6026,97,1,9,6,7,13,14,0.000029
neodiogenes,38,0,65,34,6,40,14,0.000855
Any-Law-5703,13,1,0,0,1,1,1,0
Any-Prize3748,66,1,0,0,10,10,13,0
Adequate_Images,19,0,25,9,2,11,13,0.001948
Green__lightning,70,0,75,47,9,56,13,0.008185
HugsForUpvotes,20,0,23,18,5,23,13,0.005284
Any_Fig_603,560,1,3,2,56,58,13,0.000315
ADP_God,14,0,5,9,2,11,15,0.000995
Basic_Cockroach_9545,105,1,22,13,21,34,13,0.001504
Boring_Clothes5233,72,1,15,16,8,24,13,0.007046
BoyHytrek,17,0,23,20,6,26,13,0.005125
ClickclickClever,14,0,15,12,6,18,15,0.001671
CnC-223,38,0,54,24,9,33,14,0.00701
Co-flyer,12,0,23,16,2,18,15,0.005009
Downtown-Act-590,184,1,30,24,24,48,13,0.004099
DowntownManThrow,768,2,42,17,46,63,13,0.001988
DrWaffle1848,15,0,17,4,0,4,0,0.001042
Fando1234,37,1,9,7,10,17,13,0.000826
Forsaken-House8685,59,0,75,53,13,66,13,0.017958
Known_Week_158,22,0,11,18,3,21,15,0.009745
Mental-Combination26,15,0,15,10,4,14,14,0.001366
Minute-Employ-4964,11,0,11,5,3,8,15,0.000691
Mother_Sand_6336,23,0,36,14,6,20,14,0.009076
Muninwing,32,0,28,16,11,27,14,0.004132
Ok-Hunt7450,19,0,30,13,5,18,13,0.002242
Ok-Temporary-8243,15,0,24,14,4,18,14,0.003005
Pinkydoodle2,16,0,22,10,6,16,14,0.0028
PopTough6317,26,0,27,17,6,23,14,0.004363
Responsible_Dream282,14,0,18,9,5,14,13,0.002262
Shepard_Normandy,16,0,26,10,2,12,15,0.000847
Streambotnt,11,0,12,10,5,15,14,0.001913
SwagginOnADragon69,17,0,23,16,4,20,13,0.005112
TheFoxer1,11,0,14,4,2,6,17,0.001448
The_World_May_Never,53,0,46,15,9,24,14,0.00187
TurbulentArcher1253,104,0,120,22,11,33,14,0.003774
Warm_Shoulder3606,17,0,10,7,1,8,16,0.002161
bigboobswhatchile,11,0,10,9,5,14,14,0.00259
carsonthecarsinogen,12,0,14,5,3,8,15,0.001577
chickensause123,16,0,18,2,0,2,0,0.001067
ferbje,33,0,33,6,6,12,14,0.000949
hunbot19,12,0,16,10,6,16,13,0.002713
revengeappendage,71,0,57,27,5,32,14,0.004321
sanguinemathghamhain,12,0,27,17,6,23,14,0.006845
satyvakta,41,0,50,32,6,38,14,0.005941
trabajoderoger,18,0,25,8,6,14,14,0.000959
Any_Try4570,205,1,0,0,8,8,14,0
CaptainONaps,17,0,22,13,1,14,16,0.001217
Cerulean_IsFancyBlue,11,0,11,7,2,9,15,0.000612
JonnyAU,12,0,13,8,3,11,15,0.000225
Odd-Zombie-5972,16,0,11,3,1,4,15,0.000024
Zaphod1620,20,0,7,9,1,10,16,0.000618
deskbeetle,11,0,5,4,1,5,16,0.000107
mormagils,42,0,48,27,10,37,13,0.024772
Aphrodivy,59,1,0,0,3,3,16,0
heavensdumptruck,49,2,1,1,4,5,15,0.000005
ApostleOfSnarkul,30,1,0,0,5,5,13,0
FetusDrive,48,0,59,20,13,33,14,0.005387
skdeelk,22,0,22,14,2,16,14,0.002478
Apple_Bear712,45,1,0,0,2,2,11,0
SherbertFeisty3313,135,1,6,4,6,10,12,0.000004
Apple_Product_Lover,75,1,0,0,4,4,15,0
Assume_Utopia,25,0,13,9,0,9,0,0.000095
behemuthm,13,0,8,9,1,10,15,0.013398
catdude142,26,0,39,20,5,25,16,0.000148
AppropriateDark3217,231,1,0,0,7,7,11,0
Playful-Mastodon9251,17,0,11,9,0,9,0,0.000124
ThenSociety734,12,0,6,4,0,4,0,0.000023
Appropriate_Yak_8948,243,1,0,0,3,3,15,0
Aria_the_Artificer,34,1,1,1,11,12,14,0.001395
Done327,17,0,16,18,3,21,14,0.038191
Happy_Tip_2091,14,0,15,7,1,8,14,0.014505
NoExcuses1984,24,0,43,35,15,50,13,0.047891
nighthawk_md,16,0,5,8,2,10,13,0.012573
wha-haa,32,0,47,32,20,52,14,0.06101
Arkhamman367,119,1,1,1,12,13,13,0.000617
MrGraeme,17,0,22,11,4,15,13,0.002746
StillLikesTurtles,16,0,29,21,4,25,12,0.004653
StobbstheTiger,35,0,30,19,9,28,13,0.00313
Successful-Shopping8,23,0,39,11,2,13,14,0.001403
TarumK,12,0,25,14,9,23,14,0.005911
iryanct7,69,0,51,44,11,55,13,0.010717
xxam925,15,0,9,4,1,5,14,0.001682
AroooonTV,313,1,0,0,20,20,13,0
Anonymous_1q,166,0,125,48,23,71,13,0.006721
Awesomeuser90,1539,17,14,9,138,147,12,0.009612
FourCardStraight,25,0,16,11,2,13,13,0.000829
GalaXion24,20,0,43,38,18,56,14,0.017402
Gexm13,20,0,23,19,8,27,14,0.004549
ImReverse_Giraffe,27,0,33,10,8,18,14,0.002569
MercurianAspirations,32,0,18,14,2,16,14,0.003212
PuffyPanda200,18,0,12,12,6,18,14,0.004161
ghotier,236,0,217,41,30,71,13,0.006379
libra00,43,0,50,19,7,26,14,0.005113
revankk,14,0,23,11,6,17,13,0.002729
wibbly-water,31,0,38,21,3,24,15,0.004629
Belisarius9818,21,0,28,11,4,15,14,0.002169
BillionaireBuster93,23,0,54,32,28,60,13,0.011977
Bottlecapzombi,23,0,27,9,5,14,13,0.002427
EyePharTed_,18,0,30,13,8,21,14,0.004296
Impossible-Cod-323,14,0,15,3,2,5,14,0.0008
Km15u,26,0,31,14,3,17,14,0.002137
Message_10,16,0,18,14,3,17,14,0.004706
RemoteCompetitive688,46,0,51,17,6,23,13,0.00664
SmarterThanCornPop,51,0,44,19,7,26,13,0.00332
Super_Eagle1198,15,0,17,8,3,11,14,0.002274
abacuz4,32,0,42,22,14,36,13,0.005166
callmejay,16,0,24,20,8,28,13,0.009574
ArticunoWolfy7724,45,1,4,3,8,11,13,0.000366
Meii345,21,0,19,10,5,15,14,0.003321
Artistic-Pumpkin2868,14,1,0,0,1,1,12,0
Reasonable-Bad-769,36,0,41,23,2,25,11,0.000072
Asear2,760,1,0,0,14,14,11,0
Ambitious-Border-906,15,0,3,3,0,3,0,0.000004
Doc4216,15,0,9,4,0,4,0,0.000014
OkManufacturer767,12,0,36,26,2,28,11,0.00071
Sad-Country-9873,15,0,22,15,2,17,11,0.000136
Witty-Stock-4913,15,0,9,6,4,10,15,0.00003
Yourmum0505,15,1,1,1,2,3,11,0.000001
imamage_fightme,13,0,6,5,0,5,0,0.00002
oop_norf,21,0,31,24,4,28,13,0.00004
Ashamed-External-330,383,2,0,0,39,39,13,0
Alesus2-0,35,0,35,30,4,34,14,0.002852
Business-Stretch2208,126,1,20,11,15,26,13,0.001218
Frylock304,131,1,47,15,22,37,14,0.003813
Garfish16,61,0,59,14,9,23,13,0.002036
GumboSamson,25,0,25,10,5,15,14,0.001804
HeroBrine0907,93,1,18,10,21,31,13,0.001693
KrabbyMccrab,20,0,21,12,2,14,14,0.002957
Mysterious_Ship_7297,12,0,7,10,1,11,15,0.002434
Pleasant-Extreme7696,11,0,7,10,4,14,13,0.000661
Royal_Negotiation_91,83,0,67,30,11,41,13,0.006103
Subtleiaint,136,1,16,10,13,23,13,0.001725
Temporary-Truth2048,14,0,18,9,1,10,14,0.002236
Tydeeeee,30,0,33,9,1,10,14,0.001287
cantantantelope,11,0,18,19,5,24,14,0.003629
explain_that_shit,14,0,11,12,7,19,14,0.003861
faux-fox-paws,170,0,96,26,19,45,12,0.001153
fourmesinatrenchcoat,38,0,15,5,2,7,14,0.00029
mmmsplendid,54,0,45,12,6,18,13,0.001999
muyamable,30,0,16,17,2,19,14,0.003043
sardine_succotash,52,0,61,36,21,57,13,0.020449
trullaDE,28,0,21,19,5,24,14,0.003751
unbelizeable1,30,0,30,8,7,15,13,0.000904
username_6916,15,0,16,17,3,20,14,0.00451
AshuraBlack,138,1,0,0,2,2,14,0
SweetMaam,11,0,22,14,0,14,0,0.00003
ballisticks,11,0,11,9,3,12,13,0.000051
Asleep_Animator_8979,20,1,1,1,3,4,15,0.000002
checker280,77,0,78,38,21,59,14,0.026439
cochlearist,13,0,15,12,1,13,17,0.000464
AspirantTurtle5116,100,1,0,0,7,7,12,0
MACRS_or_Break,68,0,48,24,5,29,12,0.000054
kingofmymachine,14,0,6,4,0,4,0,0.002971
Ataraxia_Eterna,56,1,1,1,4,5,11,0.000218
Kaisha001,15,0,11,3,1,4,11,0.000612
MaiTaiMule,12,0,12,7,4,11,15,0.000544
AtiyaK87,170,1,0,0,12,12,14,0
No-Mushroom5934,16,0,10,9,0,9,0,0.000937
OneNoteToRead,27,0,32,10,6,16,14,0.001815
khizar4,13,0,15,2,2,4,15,0.000072
AwakeNowAwakeNow,67,1,0,0,2,2,15,0
Coygon,12,0,12,9,1,10,17,0.00006
cbracey4,11,0,9,2,1,3,14,0.000385
-ReadingBug-,22,0,40,24,13,37,14,0.047471
123yes1,16,0,17,6,4,10,14,0.006786
1QAte4,44,0,17,28,6,34,14,0.048721
ANewBeginningNow,15,0,18,23,0,23,0,0.042447
AT_Dande,11,0,11,12,4,16,14,0.027935
Aureliamnissan,17,0,20,9,5,14,13,0.023298
CellularSavant,15,0,14,10,2,12,14,0.019962
Corellian_Browncoat,35,0,40,24,17,41,13,0.048081
Crowmakeswing,13,0,4,7,3,10,14,0.012495
DBDude,121,0,136,65,31,96,13,0.055135
DCBuckeye82,11,0,17,7,5,12,14,0.009626
DarkExecutor,17,0,14,5,4,9,14,0.009935
DrPlatypus1,17,0,21,12,2,14,14,0.018609
Fluggernuffin,12,0,9,4,3,7,14,0.008826
GiantPineapple,29,0,28,24,6,30,14,0.038423
GrandMasterPuba,22,0,30,23,8,31,13,0.047489
HeloRising,32,0,43,23,7,30,14,0.035831
IceNein,55,0,47,35,18,53,14,0.055778
JonDowd762,20,0,28,18,13,31,14,0.04035
JuniorFarcity,13,0,21,19,10,29,13,0.027207
Kronzypantz,635,1,85,38,86,124,13,0.060848
Lefaid,63,1,16,11,15,26,14,0.012568
Mend1cant,12,0,19,18,5,23,14,0.030229
MurrayBothrard,96,0,77,42,20,62,13,0.052451
Raichu4u,248,2,15,14,49,63,13,0.029314
Rocktopod,12,0,9,13,7,20,14,0.018555
Scatman_Crothers,14,0,13,9,8,17,14,0.010479
ScreenTricky4257,15,0,20,10,3,13,15,0.019162
Serious-Top7925,19,0,22,15,9,24,14,0.028286
SpoofedFinger,12,0,18,18,5,23,14,0.039579
TheTrueMilo,17,0,28,25,13,38,14,0.051519
Tired8281,14,0,13,4,1,5,15,0.013982
betty_white_bread,25,0,51,12,11,23,14,0.017988
calguy1955,30,0,32,24,5,29,13,0.042665
chiaboy,52,0,55,22,11,33,14,0.03018
cromethus,20,0,24,21,4,25,14,0.039681
curien,37,0,44,22,13,35,14,0.039086
ddoyen,17,0,13,9,5,14,13,0.019314
digbyforever,14,0,17,20,4,24,14,0.031081
dogmuff1ns,126,1,1,2,27,29,14,0.005182
dondon98,11,0,3,9,2,11,15,0.010411
eggoed,32,0,26,14,4,18,14,0.024204
epsilona01,63,0,60,22,12,34,14,0.054368
etoneishayeuisky,34,0,47,19,6,25,12,0.041003
hblask,37,0,35,15,7,22,14,0.027328
jmnugent,19,0,21,16,7,23,14,0.021832
luminatimids,17,0,17,12,4,16,14,0.034744
mcgunner1966,44,0,54,28,13,41,13,0.050701
mycall,16,0,16,17,7,24,14,0.043971
nylockian,14,0,15,7,3,10,14,0.014416
phoenix1984,19,0,17,11,3,14,15,0.018205
pliney_,11,0,13,9,3,12,14,0.022298
ptmd,15,0,19,4,5,9,14,0.007874
semideclared,46,0,77,19,23,42,13,0.039218
socialistrob,19,0,36,17,8,25,14,0.042058
theresourcefulKman,15,0,20,8,3,11,14,0.021784
ttown2011,216,0,177,81,43,124,14,0.095856
zayelion,21,0,41,35,3,38,14,0.050299
Awkward_Freedom4565,12,1,0,0,1,1,16,0
Awkward_Purchase9176,356,1,0,0,55,55,13,0
101ina45,13,0,14,10,5,15,14,0.013631
AshleyMyers44,27,0,27,14,9,23,14,0.022218
Complex-Field7054,11,0,30,25,17,42,13,0.05024
CremePsychological77,15,0,22,13,9,22,14,0.027841
Dineology,17,0,15,19,3,22,14,0.040538
Domiiniick,13,0,12,11,2,13,15,0.025531
FuguSandwich,16,0,13,22,7,29,14,0.039107
Gta6MePleaseBrigade,24,0,30,20,4,24,14,0.047582
Idk_Very_Much,20,0,15,16,5,21,14,0.032651
Lemon_Club,13,0,6,8,3,11,14,0.012703
LolaSupreme19,13,0,22,15,1,16,15,0.036645
Matt2_ASC,14,0,44,30,22,52,13,0.055366
NekoCatSidhe,68,0,75,43,19,62,14,0.067738
Ok_Bandicoot_814,58,0,79,33,24,57,14,0.054004
RVarki,13,0,12,6,3,9,13,0.003646
SaintNutella,12,0,13,8,4,12,12,0.022563
Santosp3,12,0,12,8,3,11,13,0.018744
Time_Minute_6036,1510,9,17,12,198,210,12,0.028842
TorkBombs,39,0,22,18,8,26,14,0.023893
WaltEnterprises,15,0,26,17,1,18,15,0.019087
Zanctmao,18,0,6,11,2,13,14,0.008312
ballmermurland,66,0,74,37,28,65,13,0.070296
itsdeeps80,43,0,62,35,20,55,14,0.047121
jmtrader2,11,0,19,15,7,22,13,0.024679
judge_mercer,22,0,27,15,5,20,14,0.024254
najumobi,1214,6,5,4,157,161,13,0.008125
nyckidd,29,0,22,17,9,26,13,0.009723
schistkicker,13,0,25,16,10,26,14,0.039674
viewless25,13,0,5,6,0,6,0,0.012067
Awkward_Squire,34,1,0,0,2,2,11,0
Axlerodriguez,126,1,0,0,25,25,13,0
ChirpyRaven,19,0,15,16,1,17,15,0.001602
EdelgardSexHaver,25,0,39,24,8,32,14,0.00502
GoldenEagle828677,84,0,80,24,12,36,13,0.005023
RodeoBob,12,0,9,14,0,14,0,0.003249
Skrungus69,11,0,9,7,0,7,0,0.000592
couldbemage,17,0,41,18,16,34,13,0.004987
deep_sea2,35,0,33,20,5,25,14,0.001746
vuzz33,26,0,37,7,2,9,15,0.000782
B2utyyo,87,1,0,0,4,4,13,0
Yernar125,12,0,6,7,0,7,0,0.00003
hadesarrow3,22,0,24,6,2,8,12,0.000021
BDough,897,1,0,0,23,23,14,0
2060ASI,30,0,10,3,1,4,17,0.000072
Boisemeateater,112,0,26,8,2,10,15,0.00029
COskibunnie,26,0,18,5,4,9,18,0.000098
Competitive-Bug-7097,14,0,3,4,0,4,0,0.000063
Cornwallis400,20,0,17,15,4,19,14,0.002957
Cyberpunk2044,20,0,24,6,0,6,0,0.001445
DancingWithAWhiteHat,30,0,25,20,6,26,14,0.004642
Fickle-Syllabub6730,85,5,7,6,10,16,13,0.000237
OG-Brian,12,0,14,4,1,5,18,0.000372
Ornithopter1,21,0,38,13,9,22,14,0.002645
Temporary_Row_7572,14,0,10,4,3,7,17,0.000033
Ulthanon,20,0,10,4,2,6,16,0.000105
Useful-Back-4816,12,0,24,4,5,9,14,0.000322
WearyMatter,13,0,10,4,2,6,17,0.000042
Zromaus,20,0,8,4,2,6,16,0.000034
itsacalamity,16,0,17,10,5,15,15,0.0005
k2svpete,18,0,26,9,2,11,15,0.00051
maychoz,14,0,10,4,3,7,16,0.000251
mle_eliz,13,0,15,5,1,6,2,0.000863
BadMansBooze,112,1,1,1,4,5,11,0.000581
ItsAGoodDay,14,0,10,6,2,8,14,0.013645
Rebles,15,0,7,9,3,12,15,0.012008
Sarlax,29,0,32,19,8,27,13,0.029468
WingerRules,14,0,22,25,11,36,14,0.039847
Balarian,127,1,0,0,18,18,13,0
Jaysank,15,0,13,18,0,18,0,0.002673
MaximumOk569,34,0,21,18,6,24,14,0.005018
bettercaust,64,0,92,45,25,70,14,0.007728
brandygang,2812,1,4,2,172,174,13,0.0002
ngogos77,22,0,9,7,0,7,0,0.00091
Balverine1911,15,1,0,0,1,1,14,0
milui2,25,1,1,1,2,3,13,0
Bananaspacebar,34,1,0,0,2,2,15,0
trollcitybandit,15,0,17,7,3,10,15,0.000453
BandicootSensitive79,14,1,0,0,2,2,15,0
houtex727,11,0,13,11,2,13,15,0.000077
BarRepresentative653,544,1,0,0,61,61,13,0
After_Lie_807,22,0,22,17,9,26,14,0.006284
Alternative_Oil7733,18,0,30,18,9,27,12,0.006068
ArCSelkie37,14,0,10,11,5,16,15,0.002693
AxlLight,27,0,15,12,3,15,14,0.014688
CABRALFAN27,22,0,23,15,9,24,14,0.003625
CarsTrutherGuy,72,0,60,23,9,32,13,0.006278
Competitive_Jello531,14,0,17,11,4,15,15,0.002092
DorsalMorsel,18,0,12,9,2,11,14,0.002276
FreddieMoners,14,0,21,11,3,14,14,0.002194
Harbinger2001,38,0,45,22,10,32,12,0.006543
Here4Pornnnnn,46,0,48,13,6,19,13,0.002522
Impossible-anarchy,139,0,97,47,18,65,13,0.01102
InterestingTheory9,27,0,35,7,5,12,14,0.001298
JohnLockeNJ,23,0,28,9,3,12,14,0.005023
JustSomeCells,16,0,17,3,2,5,15,0.001181
LocketheAuthentic,20,0,21,11,3,14,14,0.002982
Majestic-Effort-541,22,0,17,8,5,13,14,0.000908
Notachance326426,11,0,28,15,7,22,13,0.003667
Outcast129,11,0,19,17,7,24,13,0.005424
Rightricket,16,0,26,8,5,13,14,0.001901
Sm3x,21,0,18,7,5,12,13,0.000609
Toums95,16,0,9,7,4,11,14,0.000758
Zequen,53,0,25,9,4,13,14,0.000934
abn1304,20,0,21,9,4,13,14,0.002216
airboRN_82,52,0,63,16,5,21,14,0.005016
antisocially_awkward,15,0,19,11,6,17,12,0.009079
blatantspeculation,11,0,7,4,3,7,13,0.000361
chrisfathead1,32,0,15,9,1,10,14,0.002915
chronberries,25,0,28,18,7,25,14,0.01258
conduffchill,11,0,12,10,4,14,13,0.001243
imhugeinjapan89,22,0,20,9,5,14,15,0.001734
josh145b,44,0,68,21,14,35,13,0.004813
kinrove1386,348,1,305,70,45,115,13,0.010311
kyngston,18,0,14,11,3,14,14,0.002565
top0impact,27,0,38,20,14,34,14,0.004211
Barbaricliberal,18,1,4,3,7,10,14,0.002038
Goggio,153,1,59,11,19,30,13,0.003089
Josvan135,183,0,70,59,11,70,14,0.006228
Dyn-O-mite_Rocketeer,16,0,17,5,2,7,14,0.000302
ElysiX,11,0,26,19,3,22,14,0.003923
Foreign_Cable_9530,451,1,5,4,45,49,12,0.000375
Level-Ladder-4346,11,0,11,11,2,13,15,0.00088
ralph-j,46,0,69,36,1,37,15,0.005963
Battlefeather,360,2,0,0,48,48,13,0
ATotalCassegrain,13,0,16,9,5,14,15,0.000856
BigbunnyATK,26,0,27,8,3,11,14,0.001163
Doub13D,118,0,118,42,21,63,13,0.008153
ExpiredPleaseUpdate,12,0,17,7,3,10,15,0.000909
FearlessResource9785,121,0,107,24,11,35,13,0.003554
Foxhound97_,11,0,27,20,3,23,14,0.005012
Idrialite,14,0,16,6,3,9,13,0.001761
LewisCarroll95,602,1,3,2,78,80,12,0.000984
Lirdon,18,0,9,9,1,10,16,0.000498
Maximum-Lack8642,19,0,12,11,2,13,15,0.001853
Pockydo,12,0,11,5,2,7,15,0.000991
PromptStock5332,11,0,16,12,4,16,14,0.002333
Rosimongus,24,0,28,17,7,24,12,0.003086
Rude_Lengthiness_101,19,0,20,10,6,16,14,0.001111
SANcapITY,66,0,58,20,5,25,14,0.003053
Salty_Map_9085,16,0,21,8,3,11,14,0.00157
Slackjawed_Horror,42,0,31,13,4,17,15,0.003544
The_Bjorn_Ultimatum,21,0,19,11,2,13,14,0.003649
The_Demosthenes_1,13,0,17,12,1,13,17,0.001373
TomatoTrebuchet,15,0,15,6,2,8,15,0.00063
WearIcy2635,33,0,37,17,11,28,13,0.003364
_phish_,11,0,12,3,2,5,14,0.000225
jwrig,44,0,54,30,11,41,14,0.007249
lordnacho666,15,0,22,16,5,21,14,0.003152
rickbubs,13,0,11,7,2,9,15,0.00159
snotick,17,0,18,5,2,7,14,0.000809
BeTheTurtle,32,1,0,0,16,16,14,0
GiveMeAHeartOfFlesh,39,0,40,10,4,14,14,0.001063
Speedy89t,12,0,17,14,3,17,15,0.004647
Urbenmyth,12,0,17,17,0,17,0,0.001684
whatsgoingon350,39,0,9,12,3,15,15,0.000847
woailyx,36,0,31,17,4,21,14,0.003006
Beautiful-Street649,31,1,0,0,3,3,12,0
Impossible_Rain_4727,24,0,11,11,0,11,0,0.000044
BedroomNo8788,63,1,0,0,4,4,11,0
lifeinwentworth,18,0,29,10,3,13,14,0.000049
Beefy4LayerBurito,26,1,0,0,3,3,12,0
BeepbopMakeEmHop,190,1,0,0,27,27,13,0
Alternative_Buy_4000,34,0,27,12,5,17,14,0.009352
Angsty-Panda,12,0,22,10,4,14,14,0.002801
Competitive_Let_9644,26,0,26,6,3,9,14,0.001311
Delli-paper,99,0,88,38,15,53,12,0.006812
Willing-Time7344,23,0,16,13,6,19,14,0.004637
Xiibe,49,0,39,17,6,23,14,0.003966
Zestyclose_Peanut_76,23,0,34,22,7,29,14,0.005263
chaucer345,1937,3,16,9,143,152,12,0.002488
coochitfrita,49,0,51,17,13,30,14,0.002416
geosunsetmoth,105,1,4,5,14,19,13,0.001087
lonecylinder,42,0,46,12,9,21,14,0.002558
memory_of_blueskies,22,0,30,14,5,19,14,0.003073
sxaez,23,0,22,7,1,8,15,0.001975
thegarymarshall,25,0,35,9,4,13,13,0.004073
traanquil,12,0,19,11,2,13,15,0.002502
BeliIRL,77,1,0,0,15,15,14,0
AdmiralSaturyn,89,0,68,33,19,52,14,0.030164
Budget_Llama_Shoes,41,0,32,11,6,17,14,0.015353
D4UOntario,11,0,9,10,1,11,15,0.009791
Significant_Arm4246,91,0,56,17,9,26,14,0.023148
SuperRocketRumble,28,0,18,13,7,20,14,0.020529
chiefmud,28,1,1,2,10,12,14,0.000552
Bennny_Profane,37,1,0,0,13,13,12,0
Razorwipe,20,0,18,14,1,15,15,0.001406
TheWhistleThistle,39,0,57,25,5,30,14,0.004845
ta_mataia,23,0,32,7,5,12,14,0.00086
BigBandit01,68,1,0,0,13,13,13,0
HazyAttorney,70,0,75,26,12,38,14,0.003793
JuicingPickle,826,1,39,25,95,120,12,0.010944
PrimaryInjurious,94,0,81,43,21,64,13,0.009129
BigMeatus524,239,1,0,0,2,2,1,0
BigGreenBillyGoat,16,0,24,9,0,9,0,0.000115
Novel_Surprise_7318,20,0,22,2,0,2,0,0
Big_Sea_5912,1023,3,1,1,111,112,12,0.000212
11grim,12,0,18,9,3,12,14,0.003494
AtmosphericReverbMan,27,0,44,20,18,38,14,0.006068
B1ackHawk12345,15,0,14,7,2,9,15,0.001212
BlueCollarRevolt,12,0,18,9,4,13,13,0.002763
Brilliant-Lab546,23,0,25,17,8,25,15,0.003475
ChazzLamborghini,20,0,19,18,5,23,14,0.014262
ChickerWings,29,0,26,12,5,17,14,0.007768
Cytothesis,13,0,10,4,3,7,14,0.001149
Dheorl,14,0,17,6,1,7,15,0.00122
DisgruntledWarrior,11,0,13,6,1,7,14,0.001645
Dry-Tough-3099,43,0,43,25,3,28,13,0.006771
EvilPutlerBotZOV,16,0,13,10,5,15,13,0.001595
Evilsushione,18,0,25,13,10,23,13,0.003374
Former_Function529,15,0,23,19,7,26,13,0.006664
JCMGamer,12,0,17,10,6,16,11,0.001699
Letshavemorefun,31,0,43,14,10,24,14,0.004554
Liad3008,99,1,28,14,19,33,13,0.001586
Local_Painter_2668,28,0,25,3,4,7,14,0.000567
MeasurementCreepy926,83,0,132,16,20,36,13,0.003674
MrScandanavia,959,1,5,8,66,74,13,0.002459
ObsessedKilljoy,249,1,49,19,30,49,13,0.003149
OddCook4909,19,0,28,10,5,15,14,0.003264
Overton_Glazier,15,0,15,7,5,12,14,0.001708
PerfectReflection155,12,0,11,3,1,4,15,0.000625
Physical-Dingo-6683,73,0,76,28,28,56,14,0.004122
PlusAd4034,20,0,23,8,6,14,14,0.002159
Proper_Solid_626,166,1,5,2,25,27,12,0.000636
Soft_Accountant_7062,59,0,83,41,12,53,13,0.008534
Sokkawater10,12,0,6,7,3,10,15,0.002164
Successful-Silver485,12,0,14,4,3,7,15,0.001119
Suitable-Activity-27,13,0,22,15,3,18,14,0.00548
Virtual_Technology_9,17,0,21,9,4,13,14,0.001687
Wayfarer285,17,0,17,4,3,7,15,0.000926
appealouterhaven,34,0,41,31,8,39,12,0.008397
axp187,22,0,22,8,2,10,14,0.002706
bingbano,28,0,26,12,6,18,13,0.001481
cairnrock1,18,0,23,10,6,16,15,0.004519
custodial_art,89,0,96,36,22,58,14,0.005948
deepstaterecords,25,0,22,10,10,20,14,0.006286
fghhjhffjjhf,19,0,27,11,1,12,15,0.001622
followedbymeteor,13,0,16,5,2,7,14,0.001252
jweezy2045,270,0,239,28,22,50,14,0.002625
majeric,32,1,5,6,7,13,13,0.000696
martco17,109,1,8,5,11,16,13,0.001566
mishaxz,31,0,38,18,3,21,14,0.004385
modernDayKing,17,0,41,19,14,33,13,0.018946
phoenix823,11,0,19,11,1,12,13,0.002004
revertbritestoan,72,0,85,26,14,40,13,0.006408
tanatan88,21,0,11,7,4,11,15,0.000771
urquhartloch,47,0,48,17,9,26,12,0.003099
vintage2019,20,0,16,15,8,23,14,0.011482
Bingewitch,284,1,0,0,16,16,10,0
Hour_Smile_9263,13,0,31,14,10,24,11,0.000178
MithosYggdrasill1992,20,0,57,13,6,19,12,0.000228
Similar_Pineapple418,20,0,15,13,1,14,1,0.000004
SoMuchMoreEagle,24,0,11,8,1,9,1,0.000003
Stormtomcat,13,0,25,11,6,17,11,0.000074
Turbulent_Cow2355,23,0,43,18,10,28,11,0.000219
Unfair_Finger5531,34,0,62,24,11,35,10,0.000096
pikminlover20,16,0,15,9,1,10,17,0.000021
BirthDeath,144,1,0,0,21,21,13,0
2057Champs__,42,0,42,17,10,27,13,0.026545
Charming-Leader-250,12,0,17,9,4,13,14,0.0057
flying87,11,0,11,8,4,12,14,0.006396
lewkiamurfarther,26,0,44,21,20,41,14,0.042345
moonkipp_,59,1,15,6,12,18,13,0.001864
BitterRaisin7797,47,1,0,0,4,4,15,0
ProofJournalist,17,0,20,3,0,3,0,0.000035
flimflam_machine,16,0,24,3,3,6,2,0.000032
BlackOpsBootlegger,286,1,0,0,22,22,13,0
Desperate-Fan695,101,1,25,26,24,50,13,0.003245
Icy_River_8259,75,0,76,26,11,37,14,0.002858
Mcwedlav,15,0,26,13,2,15,15,0.002599
Neat_Rip_7254,25,0,32,11,7,18,13,0.002377
NoTomato7740,25,0,36,24,6,30,14,0.004413
RandomGuy92x,17,0,4,6,1,7,15,0.001076
Sayakai,28,0,27,11,4,15,15,0.001746
fiktional_m3,28,0,39,10,4,14,15,0.004315
generallydisagree,66,0,53,37,16,53,14,0.008501
shouldco,41,0,55,29,14,43,13,0.007401
BlonglikZombie,18,1,0,0,5,5,12,0
fwubglubbel,44,0,25,26,4,30,16,0.000479
Blossom_Trail82,493,1,2,2,17,19,11,0
BobbieMcFee,11,0,11,11,1,12,18,0.000432
Disastrous-Nail-640,17,0,23,15,2,17,13,0.000054
Discount_Mithral,15,0,20,10,4,14,13,0.000026
LdiJ46,11,0,15,13,3,16,13,0.000104
QuietCelery7850,36,0,2,7,1,8,15,0.000027
TemptingPenguin369,23,0,37,26,1,27,1,0.000138
friendlily,13,0,17,14,1,15,15,0.000043
gr8dspro,18,0,11,10,1,11,15,0.000021
ivylass,17,0,7,4,2,6,19,0.000054
unsafeideas,23,0,33,18,4,22,10,0.000118
BlueFireFlameThrower,24,1,0,0,7,7,14,0
DenseYear2713,62,1,4,5,18,23,14,0.005764
Fiveby21,577,2,3,4,65,69,14,0.009957
repeatoffender123456,30,0,37,21,8,29,14,0.029539
0WatcherintheWater0,22,0,23,17,13,30,14,0.028915
AmigoDelDiabla,27,0,32,17,14,31,13,0.026972
BotElMago,110,0,86,25,16,41,14,0.033188
Davec433,28,0,22,15,3,18,15,0.017435
DeadlySpacePotatoes,11,0,19,8,3,11,14,0.014891
Delanorix,64,0,55,34,15,49,13,0.047973
FreeStall42,30,0,53,21,20,41,13,0.044273
GabuEx,30,0,17,23,4,27,14,0.025961
GuyInAChair,37,0,57,28,13,41,14,0.055347
Ill_Decision2729,15,0,26,23,9,32,14,0.041162
Illustrious-Pound266,150,2,6,6,27,33,13,0.016258
Inevitable-Ad-9570,14,0,16,7,3,10,15,0.013518
ItsMichaelScott25,14,0,27,17,9,26,13,0.044992
JohnnyLeftHook,11,0,7,10,4,14,15,0.024967
Junglebook3,11,0,8,9,5,14,14,0.009458
KevinCarbonara,32,0,53,26,19,45,13,0.053458
Mjolnir2000,20,0,16,14,5,19,14,0.033261
Nearbyatom,13,0,8,6,2,8,15,0.029605
NoAttitude1000,53,0,81,24,17,41,14,0.046068
PennStateInMD,110,1,8,9,30,39,13,0.017496
PoliticalJunkDrawer,17,0,14,12,2,14,14,0.016621
SparksFly55,63,0,72,53,29,82,13,0.078018
TheBigGoat44,13,0,17,15,6,21,15,0.022234
The_Awful-Truth,432,1,25,18,48,66,13,0.041726
Za_Lords_Guard,23,0,24,14,11,25,13,0.02656
au-smurf,12,0,12,8,5,13,14,0.016465
burritoace,32,0,32,15,11,26,14,0.041189
candre23,45,0,47,22,11,33,14,0.050094
cat_of_danzig,15,0,21,13,3,16,14,0.012508
clarkision,13,0,12,5,2,7,13,0.015627
coskibum002,36,0,48,30,13,43,14,0.052339
dravik,27,0,21,23,7,30,14,0.033127
getawarrantfedboi,20,0,23,21,6,27,14,0.043165
j_ly,14,0,13,11,7,18,14,0.020108
jmac31793,11,0,13,10,4,14,14,0.019338
lionhearted318,48,0,35,22,11,33,13,0.020507
mipacu427,13,0,6,12,3,15,14,0.02588
mosesoperandi,15,0,20,10,5,15,14,0.023243
pgriss,26,0,20,17,8,25,13,0.040776
pomod,14,0,27,24,6,30,14,0.04037
spacegamer2000,17,0,13,4,2,6,14,0.010257
thewoodsiswatching,13,0,13,12,2,14,13,0.019203
unknownpoltroon,24,0,19,18,10,28,14,0.035276
BodyArtist601,1836,1,0,0,36,36,10,0
1962Michael,21,0,36,23,0,23,0,0.000195
CartwheelsOverClouds,32,0,1,3,0,3,0,0.000018
Entire-Ad2058,19,0,25,10,5,15,12,0.000862
Historical_Wing3120,13,0,14,4,1,5,1,0.000161
NobleNop,16,0,28,3,2,5,15,0.00002
PikaV2002,16,0,30,11,4,15,11,0.000041
Psychonaut1008,12,0,14,4,1,5,13,0.000045
RammsteinFunstein,11,0,17,5,2,7,12,0.000051
RaptorOO7,11,0,5,6,2,8,16,0.00007
Regular-Message9591,160,1,5,4,29,33,14,0.000026
TalkToHoro,16,0,26,12,2,14,12,0.000167
abstractengineer2000,15,0,37,39,11,50,14,0.010974
almaperdida99,69,0,18,12,1,13,13,0.000127
jetttward,13,0,7,2,2,4,11,0.000022
multipocalypse,21,0,45,11,6,17,10,0.000082
tweedtybird67,11,0,5,5,0,5,0,0.000043
urfavgeeksfavgeek,22,0,5,4,1,5,1,0.00002
Bonaccorso_di_Novara,123,3,0,0,5,5,15,0
AldousKing,14,0,15,14,1,15,15,0.005062
badass_panda,40,0,46,22,5,27,14,0.00395
BranchInitial9452,118,4,0,0,7,7,13,0
21-characters,22,0,71,29,10,39,15,0.00082
Dweller201,21,0,23,6,1,7,15,0.000252
Brendan_Frost,39,1,0,0,12,12,13,0
-Ch4s3-,64,0,68,22,11,33,14,0.004937
Insectshelf3,40,0,42,26,14,40,13,0.006495
nowthatswhat,20,0,30,15,6,21,15,0.0051
Briepy,210,1,0,0,28,28,13,0
DC2LA_NYC,19,0,17,12,6,18,14,0.003035
Dr_G_E,16,0,18,14,3,17,12,0.001869
JSmith666,52,0,57,19,4,23,14,0.006007
MagicBulletin91,14,0,8,8,4,12,15,0.001074
Serious_Senator,16,0,13,12,6,18,15,0.018891
TheMrCurious,89,1,35,22,12,34,13,0.005314
Xepherya,19,0,10,6,2,8,16,0.000723
captainhukk,13,0,19,12,5,17,14,0.004631
eggynack,70,0,78,30,8,38,15,0.005078
iamcleek,32,0,20,19,3,22,14,0.003609
mem2100,17,0,23,11,6,17,14,0.003801
unscanable,65,0,59,23,16,39,14,0.003351
Brilliant-Ad3010,77,1,0,0,3,3,16,0
GSilky,16,0,23,14,4,18,15,0.000475
Savitar5510,24,0,24,3,1,4,1,0.000033
Brilliant-Mountain42,77,1,0,0,9,9,12,0
NeedForSpeed98,11,0,11,5,2,7,14,0.000146
Brilliant_Listen_507,55,1,0,0,7,7,14,0
BroccoliNo2965,133,1,0,0,2,2,11,0
BroccoliSubstantial2,30,1,0,0,2,2,15,0
Bromothymol_blue,69,1,0,0,4,4,15,0
Pongpianskul,49,0,43,29,2,31,14,0.000886
Bruh146,82,1,0,0,5,5,14,0
TheCowboyIsAnIndian,11,0,11,5,2,7,14,0.000116
Bryan4991,29,1,0,0,1,1,14,0
Bubbly-Two-3449,287,1,1,2,47,49,13,0.00425
Adeptobserver1,12,0,16,13,6,19,14,0.017683
Confusedgmr,13,0,11,9,4,13,14,0.022066
Prior_Coyote_4376,33,0,31,23,14,37,14,0.02662
Publius82,13,0,16,5,4,9,14,0.010047
ThatsARatHat,12,0,15,10,6,16,14,0.017852
_SilentGhost_10237,1808,7,1,1,218,219,12,0.002215
danappropriate,17,0,25,14,5,19,14,0.026923
help_abalone,15,0,33,23,1,24,14,0.027609
Bubbly-Wishbone8715,13,1,0,0,2,2,13,0
Bubbly_Taro,30,1,0,0,3,3,15,0
MobiusCube,23,0,30,13,1,14,15,0.00029
BuckeyeReason,143,1,0,0,27,27,14,0
4p4l3p3,17,0,28,9,7,16,14,0.004626
Which-Worth5641,45,0,49,25,19,44,14,0.052427
cp5184,27,0,40,17,11,28,13,0.011979
res0nat0r,11,0,20,17,7,24,14,0.038851
Bulky-Error-3953,20,1,0,0,1,1,1,0
Bumptoon,85,1,0,0,18,18,14,0
Storyteller-Hero,18,0,22,18,5,23,13,0.041003
alaskanperson,21,0,21,12,3,15,14,0.009996
illegalmorality,109,1,38,23,20,43,13,0.042301
josh34583,21,0,20,9,5,14,14,0.013363
wheres_my_hat,21,0,22,9,4,13,14,0.01451
BurquenaPequena,33,1,0,0,11,11,14,0
cballowe,35,0,30,25,7,32,14,0.024673
Amazing_Might_9280,16,0,21,6,6,12,14,0.000453
BackpackJack_,13,0,10,7,0,7,0,0.000639
Fondacey,23,0,30,14,3,17,12,0.003069
Rabbid0Luigi,118,1,21,9,16,25,13,0.001537
ButterscotchEqual375,11,1,3,3,2,5,2,0.000006
BuzbieBerkley,94,1,0,0,10,10,11,0
C00kiem0nstrous,332,1,0,0,8,8,11,0
SartorialDragon,18,0,38,8,5,13,11,0.000081
CRK_76,64,1,3,3,16,19,13,0.000003
StedeBonnet1,25,0,22,12,5,17,14,0.020278
ThePoppaJ,11,0,12,5,2,7,14,0.007486
mercfan3,29,0,17,19,7,26,14,0.033013
slicerprime,20,0,14,15,5,20,14,0.019856
CSquare43-Work,20,1,0,0,3,3,14,0
Calm-Opinion6117,23,1,0,0,1,1,1,0
Capable-Art-1972,455,4,17,10,48,58,13,0.000693
Evening_Spot_5151,24,0,23,14,4,18,14,0.003322
Gremlin95x,15,0,18,14,4,18,14,0.003568
LouisWillis98,11,0,11,2,1,3,14,0.000716
Munchkin_of_Pern,13,0,16,10,5,15,14,0.002003
NeoLeonn3,17,0,13,4,1,5,15,0.000694
NoWin3930,17,0,23,13,1,14,15,0.002399
Ok_Cup_5454,23,0,25,11,5,16,14,0.00743
Puzzleheaded-Bat-511,31,0,37,21,7,28,14,0.003138
Raise_A_Thoth,26,0,28,14,8,22,13,0.001847
Rakkis157,20,0,35,13,4,17,14,0.001722
RatioFinal4287,58,1,2,2,13,15,14,0.000544
Recent_Weather2228,11,0,13,8,2,10,15,0.002354
ThirteenOnline,37,0,38,21,5,26,14,0.004806
jayeffkay,27,0,28,4,3,7,15,0.000363
nuggets256,16,0,22,12,2,14,14,0.001211
stevie-antelope,21,0,32,14,6,20,15,0.002446
tbdabbholm,15,0,11,9,1,10,15,0.001145
viaJormungandr,26,0,24,13,3,16,14,0.003159
CaptainFuture56,44,1,0,0,4,4,13,0
chinese_bedbugs,155,5,1,1,14,15,12,0.000005
ven_geci,14,1,20,11,2,13,14,0.000475
Carbon_C6,29,1,0,0,6,6,11,0
citrus_cinnamon,11,0,23,16,1,17,12,0.000056
rememberimapersontoo,69,0,34,22,2,24,12,0.000062
Careless-Interest-25,2170,1,0,0,122,122,12,0
1isOneshot1,15,0,9,10,4,14,12,0.003682
69_Star_General,14,0,3,9,2,11,14,0.003218
AcceptablePea262,46,0,54,17,6,23,14,0.006147
AlarmingSpecialist88,14,0,9,4,3,7,14,0.000786
Allenobriann,26,0,23,6,4,10,14,0.001168
Analuinguist,33,0,5,8,1,9,14,0.001852
Apart_Variation1918,19,0,27,8,10,18,13,0.002091
Baby_Needles,14,0,35,23,17,40,13,0.022099
CartographerKey4618,82,0,80,41,21,62,13,0.007406
DevA248,29,0,38,13,14,27,14,0.002665
DopeShitBlaster,13,0,13,8,5,13,13,0.002525
Edens_dark_garden,36,0,32,8,4,12,15,0.002233
EksDee098,23,0,28,12,8,20,14,0.004255
ElEsDi_25,24,0,26,9,4,13,15,0.002719
Extension_Hand1326,18,0,26,18,8,26,14,0.004994
Eyesofmalice,12,0,14,4,4,8,14,0.000729
Fifteen_inches,35,0,40,20,10,30,14,0.005053
FlanneryODostoevsky,1951,3,35,19,189,208,11,0.015155
FragrantPiano9334,11,0,17,4,3,7,15,0.000652
Fulgore101,11,0,14,5,4,9,12,0.000779
Glitchy_XCI,27,0,28,8,7,15,13,0.002865
GrungleMonke,40,0,51,17,12,29,13,0.006444
Imaginary_Exam1068,15,0,19,8,7,15,14,0.002443
Impossible_Pop620,43,0,45,14,8,22,13,0.017816
JAMONLEE,28,0,32,5,6,11,15,0.001988
Krytan,16,0,25,18,3,21,14,0.005058
LSF604,28,0,37,12,6,18,14,0.004364
Locrian6669,31,0,34,10,7,17,14,0.002229
MarkHaversham,35,0,40,14,8,22,14,0.005361
MinneapolisJones12,11,0,13,8,5,13,14,0.000875
No-Broccoli-7606,13,0,23,13,7,20,14,0.004605
OnePunchReality,14,0,14,6,2,8,16,0.016357
Pale-Examination6869,13,0,7,9,5,14,14,0.001399
PeoplePerson_57,19,0,18,13,9,22,13,0.004866
PopIntelligent9515,24,0,18,10,9,19,14,0.003397
Prepared_Noob,14,0,12,2,1,3,14,0.000702
Purple_Feedback_1683,17,0,18,3,2,5,15,0.000665
QueensOfTheNoKnowAge,17,0,13,5,3,8,14,0.000904
RadiantHC,37,0,53,15,16,31,13,0.004034
Rufus_TBarleysheath,18,0,23,4,4,8,14,0.000999
SilverWear5467,13,0,19,7,4,11,14,0.003155
South-Rabbit-4064,40,0,45,16,5,21,13,0.017594
SuggestionHoliday413,147,1,9,3,14,17,14,0.000699
TarantulaWithAGuitar,11,0,10,4,2,6,15,0.001903
ToranjaNuclear,22,0,29,17,9,26,13,0.002691
Twenty_twenty4,13,0,17,5,4,9,14,0.001882
Upstairs-Scratch-927,16,0,19,11,4,15,14,0.020873
Vedic70,16,0,30,14,4,18,14,0.005291
WeakandSlowaf,24,0,25,9,5,14,14,0.002741
Winter-Hedgehog8969,15,0,7,4,2,6,14,0.00106
Zauberer-IMDB,13,0,14,7,4,11,15,0.001936
alfredo094,11,0,21,9,8,17,14,0.00225
alohazendo,24,0,27,8,4,12,14,0.001447
bfwolf1,44,0,48,10,9,19,13,0.001824
emp-sup-bry,22,0,22,11,5,16,14,0.005098
frickle_frickle,12,0,28,18,6,24,13,0.006774
haterofslimes,16,0,18,5,3,8,15,0.001099
jamvsjelly23,16,0,9,8,3,11,14,0.007107
lobonmc,30,0,30,17,5,22,14,0.00731
mark_ik,19,0,24,6,4,10,14,0.001669
nighthawk_something,17,0,26,12,11,23,14,0.003043
redelastic,20,0,39,12,10,22,14,0.00438
regolith-terroire,50,0,50,24,17,41,14,0.025886
taeerom,14,0,26,12,7,19,14,0.005932
tenfolddamage,20,0,19,5,3,8,14,0.001355
trevor32192,100,0,97,29,16,45,13,0.008073
xeere,21,0,17,11,5,16,14,0.002927
Careless_Subject_537,26,1,0,0,3,3,11,0
DirectAntique,22,0,12,12,2,14,13,0.000025
Substantial_Trip7078,49,1,6,6,8,14,10,0.000013
CaringForOthersx,205,1,0,0,10,10,11,0
Thermicthermos,11,0,12,4,0,4,0,0.00004
CastleLushak,372,1,0,0,8,8,11,0
Casus_Writera,47,2,0,0,5,5,15,0
Fattydog,33,0,18,12,3,15,16,0.000528
Ok-Condition-6932,21,0,22,10,3,13,14,0.001538
CatPuzzleheaded9837,29,1,1,1,2,3,12,0.000001
Catastrophe-Cat-36,24,1,0,0,2,2,11,0
Ceeedzz,279,1,0,0,14,14,11,0
Cowabungamon,16,0,11,7,2,9,1,0.000033
FairyCompetent,13,0,32,25,2,27,13,0.000125
Jocelyn-1973,11,0,10,9,0,9,0,0.000042
Queen_Sized_Beauty,13,0,10,9,2,11,12,0.000047
kindlypogmothoin,47,0,6,3,1,4,1,0.000065
Chaeynna,61,1,0,0,7,7,14,0
MrX2285,25,1,5,3,3,6,15,0.000008
doriangray42,12,0,25,18,1,19,17,0.000666
ChampionRoyal6883,35,1,0,0,2,2,11,0
Chance-Foundation-46,68,1,0,0,4,4,11,0
ChaoticShadows,191,1,0,0,24,24,13,0
Beautiful-Loss7663,32,0,39,21,10,31,14,0.004744
Impressive_Ad_5614,31,0,26,8,3,11,14,0.000681
PM_ME_A_PM_PLEASE_PM,30,0,33,14,9,23,14,0.0024
Pasadenaian,12,0,13,7,2,9,14,0.000792
PineBNorth85,11,0,17,15,8,23,14,0.00379
Square-Dragonfruit76,110,1,46,27,20,47,13,0.003722
The_Itsy_BitsySpider,34,0,37,18,9,27,14,0.002586
mightymite88,19,0,24,14,6,20,13,0.003418
notafuckinmarine,12,0,11,7,2,9,15,0.001967
sumit24021990,23,0,42,19,11,30,13,0.0036
Charlescotch,39,1,0,0,2,2,11,0
Charming-Community11,55,1,0,0,3,3,12,0
Thuis001,23,0,36,18,9,27,14,0.003338
WhenButterfliesCry,25,0,29,6,3,9,11,0.000004
ChartOk8329,295,1,0,0,20,20,10,0
KCarriere,12,0,14,5,4,9,13,0.000051
smbpy7,23,0,75,15,12,27,11,0.000101
Chocolatecakelover,170,1,0,0,26,26,13,0
00zau,11,0,13,11,3,14,13,0.00262
CalLaw2023,73,0,86,22,10,32,14,0.00544
ChihuahuaNoob,22,0,32,13,8,21,13,0.002311
Knave7575,16,0,18,11,3,14,15,0.003865
Noctudeit,14,0,10,7,1,8,14,0.002215
Parzival_1775,182,1,20,13,38,51,13,0.004588
StopblamingTeachers,137,2,20,16,18,34,13,0.00209
TheJewPear,1082,1,4,4,79,83,12,0.000261
jamerson537,24,0,33,9,8,17,13,0.004405
terminator3456,18,0,15,20,4,24,14,0.006968
ChromeSteelhead,82,1,0,0,13,13,13,0
CurdKin,1144,2,45,18,100,118,13,0.003217
Utapau301,11,0,18,11,7,18,14,0.002657
harpyprincess,27,0,31,10,7,17,14,0.003314
saul_not_goodman,34,0,40,14,14,28,13,0.003453
Cidodino,38,1,1,1,14,15,14,0.001451
bigdon802,12,0,30,9,9,18,14,0.021637
elmekia_lance,24,0,30,18,12,30,14,0.019946
link3945,14,0,20,17,6,23,14,0.027359
CitizenPremier,75,1,3,1,8,9,14,0.000002
CouchieWouchie,13,0,11,4,3,7,13,0.000088
minion531,11,0,33,19,1,20,18,0.000275
solid_reign,18,0,35,18,6,24,13,0.000458
CivicGuyRobert,95,1,0,0,6,6,14,0
Nageljr,14,0,8,6,2,8,14,0.000808
Classic-Rich-958,39,1,0,0,6,6,11,0
Clear-Sweet-6824,17,1,0,0,1,1,13,0
Hot_Associate_7705,12,1,1,1,1,2,12,0
CodeLicensing,245,1,0,0,35,35,13,0
BobQuixote,13,0,17,11,6,17,14,0.020473
LeftToaster,23,0,11,18,4,22,14,0.026187
Selethorme,62,0,92,15,12,27,14,0.026848
foulpudding,40,0,21,13,5,18,14,0.01904
iguacu,11,0,10,8,1,9,14,0.012147
wedgebert,11,0,16,9,5,14,12,0.007108
Cold_Entry3043,180,1,1,1,44,45,12,0.000091
Both-Estimate-5641,13,0,43,13,17,30,14,0.004395
Lumpy-Butterscotch50,94,0,93,37,10,47,14,0.004603
MediumAids,46,0,58,14,7,21,14,0.003333
RedOceanofthewest,25,0,53,32,20,52,13,0.008572
RogueCoon,16,0,20,6,4,10,14,0.000879
Zncon,35,0,38,20,11,31,14,0.005625
addictedtolife78,16,0,22,9,4,13,15,0.001259
dalekrule,14,0,13,7,1,8,15,0.001219
parentheticalobject,11,0,14,9,2,11,15,0.002531
seanflyon,19,0,27,17,2,19,14,0.003402
todudeornote,18,0,17,13,3,16,14,0.009464
Comfortable-Log-6582,110,1,0,0,24,24,12,0
ArendtAnhaenger,14,0,15,10,8,18,13,0.018402
Snatchamo,30,0,37,17,17,34,14,0.027513
ThatOtherGuyTPM,36,0,51,23,12,35,13,0.026721
dresoccer4,63,1,5,3,13,16,11,0.001954
movingtobay2019,19,0,20,13,9,22,13,0.012767
Comfortable_Bird3049,1219,1,0,0,30,30,10,0
495orange,16,0,12,9,1,10,14,0.004813
Bluman302,18,0,7,4,1,5,13,0.000024
General_Relative2838,11,0,11,7,0,7,0,0.00002
Mundane-Currency5088,15,0,29,11,5,16,11,0.00006
NopeDragon55,31,0,2,2,0,2,0,0.000008
Usrname52,19,0,23,10,2,12,12,0.000037
alliwantistacoss,17,0,30,7,4,11,11,0.000023
mountain_mists,11,0,7,5,0,5,0,0.000023
roseofjuly,23,0,20,11,7,18,11,0.000106
Comfortable_Pass_493,106,1,1,1,16,17,13,0.000101
AlphaBetaSigmaNerd,71,0,77,24,16,40,13,0.00551
Justame13,19,0,27,11,5,16,14,0.004184
TuggenDixon,25,0,23,12,5,17,15,0.001667
d-cent,12,0,17,7,1,8,15,0.002341
justanotherdude68,21,0,10,12,2,14,14,0.001778
sdric,18,0,11,8,3,11,14,0.002205
Comfortable_Wasabi18,24,1,0,0,9,9,14,0
Commercial-Pound533,23,1,0,0,3,3,13,0
Commercial_Chip_6574,49,1,0,0,7,7,12,0
camelCaseCoffeeTable,12,0,8,7,3,10,14,0.000864
Commercial_Mess1878,42,1,0,0,3,3,16,0
Actevious,13,0,8,4,2,6,15,0.000006
CorndogQueen420,76,0,2,5,2,7,16,0.000221
CommitteeOfOne,31,1,0,0,7,7,13,0
New_General3939,414,1,55,25,35,60,13,0.004069
Common-Swimming-8565,26,1,0,0,5,5,11,0
grammarlysucksass,30,0,23,8,4,12,11,0.000014
CommonBrilliant7947,64,1,0,0,13,13,14,0
Csimiami,12,0,15,11,3,14,13,0.002996
Grand-wazoo,20,0,20,10,2,12,14,0.001538
Thinslayer,11,0,11,8,3,11,15,0.000556
turboprancer,336,2,9,6,37,43,13,0.000477
CommunicationFar3995,185,1,0,0,2,2,12,0
Communistnachos,2100,1,0,0,171,171,12,0
4bkillah,11,0,11,12,3,15,14,0.002992
4rch1t3ct,15,0,11,5,3,8,15,0.000893
AdImmediate9569,13,0,17,11,4,15,15,0.003459
American_Libertarian,36,0,8,10,1,11,15,0.002599
Amoral_Abe,35,0,14,22,4,26,14,0.022358
Appropriate_Gate_701,29,0,26,10,6,16,13,0.002877
BUUAHAHAHA,87,0,21,16,3,19,14,0.001796
BurningEmbers978,28,0,39,13,9,22,14,0.005896
Darkmayday,21,0,21,8,4,12,14,0.001455
Didntlikedefaultname,61,0,64,32,16,48,13,0.005174
Dooey,16,0,13,2,1,3,16,0.000816
EH1987,28,0,34,13,4,17,14,0.004282
Eggsformycat,31,0,26,13,7,20,14,0.002055
Frientlies,15,0,14,3,2,5,14,0.000922
Glorfendail,65,0,54,21,12,33,13,0.005309
Grand-Daoist,28,1,3,4,5,9,13,0.001046
Helpful_Loss_3739,88,1,17,12,9,21,14,0.003137
Horse__Latitudes,25,0,42,8,10,18,14,0.003336
Huge-Nerve7518,11,0,21,12,3,15,14,0.004763
ICantCoexistWithFish,43,0,46,6,8,14,13,0.002877
IntelligentCicada363,13,0,7,4,3,7,14,0.001701
Intelligent_Read_697,11,0,14,13,6,19,14,0.002726
JDMultralight,13,0,18,8,5,13,14,0.003117
Kijafa,59,0,35,27,9,36,13,0.004834
KingJades,42,0,35,12,7,19,13,0.004116
Lagkiller,35,0,36,9,3,12,14,0.002843
LateQuantity8009,13,0,19,8,1,9,15,0.001921
Major-Platypus2092,21,0,21,6,4,10,14,0.001029
MissIncredulous,12,0,14,7,4,11,14,0.001534
MountainLow9790,13,0,1,6,1,7,13,0.000951
No-Somewhere-7069,38,0,46,8,7,15,14,0.002452
Nodaker1,16,0,13,9,3,12,15,0.003979
NumerousWeather9560,24,0,23,19,4,23,14,0.007228
Openmindhobo,12,0,12,6,2,8,14,0.00306
Pale-Ad9012,159,2,8,4,22,26,13,0.002276
PleaseDontBanMe82,12,0,13,6,2,8,14,0.002032
Popular-Formal-7971,74,0,68,17,10,27,14,0.003891
Putrid_Cockroach5162,62,1,4,3,8,11,13,0.001038
Raptor_197,11,0,13,3,1,4,1,0.001176
Real-Telephone4077,45,0,33,15,5,20,14,0.00422
Revachol_Dawn,91,0,90,14,13,27,13,0.002898
Rosevkiet,37,0,15,11,3,14,15,0.002032
ScannerBrightly,14,0,15,5,3,8,13,0.002281
SeveralAd6447,149,1,5,2,21,23,13,0.00166
SpecificPay985,49,0,20,10,3,13,13,0.003143
SufficientlyRested,12,0,21,10,8,18,13,0.002558
SweetJeebus,13,0,10,5,3,8,13,0.002002
Tall-Professional130,18,0,22,8,7,15,14,0.002604
TheGreatBenjie,11,0,12,3,2,5,14,0.000926
TheInsomn1ac,24,0,11,6,1,7,15,0.001275
U8337Flower,17,0,24,6,3,9,15,0.001422
Vegetable-Two-4644,16,0,16,7,4,11,14,0.003731
Whatswrongbaby9,23,0,21,13,4,17,14,0.003138
Z86144,13,0,14,4,2,6,15,0.001604
Zakaru99,25,0,31,13,6,19,14,0.003466
Zwicker101,40,0,42,13,5,18,14,0.005841
_Richter_Belmont_,89,0,35,26,4,30,12,0.004791
cferg296,55,0,36,20,6,26,14,0.004775
cptn9toes,13,0,13,2,1,3,15,0.000819
enlightenedDiMeS,493,1,12,4,35,39,13,0.001819
formandovega,25,0,31,19,7,26,14,0.004655
gquax,38,0,24,27,9,36,14,0.022872
insaneHoshi,23,0,38,19,13,32,13,0.008335
joshdrumsforfun,25,0,24,8,8,16,13,0.002176
mackinator3,30,0,33,23,13,36,13,0.005558
marbinho,12,0,18,8,3,11,14,0.002173
mattyoclock,25,0,27,15,11,26,14,0.004524
neurointervention,27,0,27,7,5,12,14,0.002172
pile_of_bees,31,0,40,15,13,28,14,0.003927
raouldukeesq,16,0,29,25,9,34,14,0.007761
rollem,38,0,22,20,6,26,14,0.006931
sheds_and_shelters,12,0,15,3,2,5,14,0.000884
shrug_addict,12,0,10,4,1,5,14,0.002867
splurtgorgle,11,0,19,9,6,15,12,0.001737
sustainthenoise,11,0,10,4,3,7,15,0.001314
xhevnobski,30,0,30,9,3,12,14,0.001462
Competitive-Loss-548,16,1,0,0,1,1,18,0
Complex_Success_6637,14,1,0,0,4,4,13,0
Confused_Beach,149,1,0,0,27,27,13,0
SurroundTiny,11,0,10,11,2,13,13,0.002296
Swimreadmed,76,0,76,13,7,20,14,0.002008
Tricky_Break_6533,19,0,29,6,3,9,14,0.000657
deck_hand,12,0,15,12,2,14,15,0.003463
km3r,19,0,19,11,5,16,14,0.004414
Connect-Meeting-4219,793,1,0,0,15,15,11,0
Dull_Banana1377,18,0,18,2,2,4,12,0.000001
LouisV25,14,0,11,8,2,10,13,0.000007
demon803,21,0,2,4,0,4,0,0.000001
Constant-Conflict860,434,1,0,0,48,48,13,0
AmELiAs_OvERcHarGeS,12,0,10,7,4,11,15,0.00282
BattMruno33,12,0,14,2,0,2,0,0.000615
Cold_Breeze3,41,0,45,17,10,27,13,0.005317
DrawPitiful6103,12,0,13,9,1,10,14,0.002999
Equivalent-Pea8907,27,0,27,12,6,18,14,0.002007
Hodgkisl,22,0,13,6,2,8,14,0.000678
I_am_the_Jukebox,61,0,64,25,17,42,14,0.00644
KFrancesC,30,0,29,8,5,13,14,0.000861
Tessenreacts,3175,3,2,2,231,233,12,0.000688
TheAzureMage,65,0,95,26,18,44,13,0.004646
TheButtDog,19,0,21,8,5,13,14,0.001413
TheRainbowpill93,13,0,5,6,3,9,13,0.001016
Unique_Statement7811,24,0,32,9,9,18,14,0.001402
elderly_millenial,15,0,14,8,7,15,14,0.003921
happyinheart,15,0,31,18,15,33,12,0.003698
imthesqwid,25,0,16,10,4,14,14,0.00334
other_view12,13,0,26,17,5,22,14,0.007123
pearl_harbour1941,28,0,28,5,1,6,14,0.000941
rollingrock16,29,0,12,8,1,9,14,0.00245
throwawaydanc3rrr,12,0,9,12,1,13,14,0.00402
xxconkriete,27,0,27,13,7,20,13,0.003883
Constant-Taste-7616,105,1,0,0,20,20,13,0
Awkward-Estate-9787,52,0,70,20,13,33,13,0.005215
ZeusThunder369,300,1,9,9,31,40,13,0.001484
dickpierce69,28,0,29,18,3,21,13,0.014727
ConstantIce6494,188,1,2,2,15,17,14,0.000356
Dr-Assbeard,81,0,82,10,5,15,14,0.001399
Imaginary-Fact-3486,14,1,5,7,4,11,13,0.001045
Ok-Emu-2881,11,0,14,5,2,7,14,0.00101
SamCam9992,26,0,12,7,1,8,15,0.000963
YetAnotherInterneter,13,0,5,4,1,5,14,0.0005
Cookser4,16,1,0,0,3,3,14,0
Coolthat6,282,1,1,1,43,44,12,0.001475
Accomplished-Park480,12,0,11,7,0,7,0,0.001024
Al-Rediph,14,0,13,8,0,8,0,0.001243
Brysynner,11,0,10,8,2,10,16,0.01205
CivilMath812,28,0,26,9,8,17,14,0.002116
DaveChild,11,0,21,9,6,15,15,0.00591
DevinTheGrand,11,0,13,7,3,10,14,0.000746
Shadruh,28,0,22,22,7,29,14,0.002429
StarChild413,13,0,32,22,11,33,14,0.004756
Stock-Film-3609,29,0,31,8,6,14,14,0.001927
duskfinger67,24,0,36,21,6,27,13,0.002296
efnord,16,0,13,6,3,9,15,0.000529
johntempleton,13,0,8,10,3,13,14,0.011406
CorgiConsistent1568,16,1,0,0,2,2,12,0
Cota-Orben,77,1,2,2,17,19,13,0.000814
BigBoetje,22,0,24,15,1,16,12,0.002536
JeruTz,17,0,15,9,3,12,14,0.002482
ReadLocke2ndTreatise,30,0,30,9,5,14,14,0.000588
mmmeadi,26,0,21,3,1,4,1,0.000324
way2lazy2care,32,0,39,28,13,41,14,0.025155
Coteup,39,1,0,0,11,11,13,0
Sptsjunkie,39,0,36,29,18,47,13,0.050859
Taconinja05,26,0,10,12,4,16,14,0.014979
hallam81,16,0,9,18,4,22,14,0.020078
CourtofTalons,119,1,0,0,22,22,14,0
GalahadDrei,238,1,4,3,41,44,13,0.013407
NepheliLouxWarrior,44,0,18,28,4,32,14,0.028923
THExLASTxDON,17,0,15,6,3,9,13,0.011409
tekyy342,12,0,5,10,2,12,15,0.021625
the_original_Retro,367,1,9,8,49,57,13,0.013175
CowboyCheesecake,20,1,0,0,3,3,14,0
GeckoV,21,0,7,7,3,10,14,0.005066
StarlightDown,322,1,2,2,58,60,13,0.000471
Cranberry_Machiatto,252,1,0,0,13,13,12,0
TheTurtleShepard,24,0,15,9,3,12,13,0.000059
jess_the_werefox,14,0,13,5,0,5,0,0.000122
shiggyhisdiggy,25,0,22,6,3,9,14,0.000076
Greedy-Win-4880,31,0,30,10,3,13,14,0.000941
Intelligent-Cow-7122,28,0,27,3,2,5,13,0.000293
MarxCosmo,14,0,23,17,7,24,12,0.002042
TomCormack,22,0,23,17,2,19,15,0.001948
helemaal,13,0,17,10,6,16,12,0.003432
juliacar,30,0,23,9,0,9,0,0.001305
potatolover83,18,0,17,3,0,3,0,0.000469
tsisdead,16,0,17,8,5,13,14,0.000944
vettewiz,58,0,61,23,11,34,12,0.003153
xChops,20,0,14,8,1,9,15,0.001038
Cretuit,19,1,0,0,1,1,14,0
Crimson_Bloom41,47,1,0,0,6,6,13,0
Critical_Service6206,60,1,0,0,4,4,11,0
CryptedScream,262,1,0,0,27,27,13,0
BoratImpression94,18,0,25,9,7,16,14,0.002599
CEO-Soul-Collector,13,0,16,10,6,16,15,0.002265
ElReyResident,15,0,13,8,4,12,14,0.001554
ParticularNo4665,14,0,8,6,3,9,15,0.000516
PharaohhOG,13,0,10,5,3,8,15,0.001534
RevolutionaryGur4419,124,0,160,33,31,64,14,0.016576
Rolly3,112,1,21,6,14,20,14,0.000644
Sad-Paramedic-8523,20,0,26,10,7,17,14,0.001008
bgaesop,29,0,32,10,6,16,14,0.000889
lepoissonstev,26,0,28,7,4,11,14,0.000951
nickchecking,12,0,15,12,6,18,13,0.014074
spyrielles,15,0,18,4,2,6,14,0.000566
CryptographerOk5459,269,1,0,0,18,18,11,0
Accurate-Neck6933,14,0,21,10,3,13,15,0.000099
TheRoadkillRapunzel,11,0,3,4,1,5,1,0.000027
destro23,12,0,9,8,0,8,0,0.00003
felice60,11,0,15,9,0,9,0,0.00002
milkywayrealestate,673,1,1,1,13,14,10,0.000007
Cultural-Mark888,81,1,0,0,17,17,13,0
AntarcticScaleWorm,32,0,34,15,6,21,15,0.017085
Wermys,30,0,52,25,15,40,13,0.05347
comments_suck,15,0,7,12,2,14,15,0.024322
33ITM420,20,0,30,13,3,16,14,0.00589
AdFun5641,14,0,19,16,2,18,15,0.004057
Agreetedboat123,34,0,61,37,19,56,13,0.010936
CMRSCptn,13,0,11,7,3,10,14,0.001804
CleverJames3,23,0,25,11,5,16,14,0.003023
DMTwolf,25,0,17,7,1,8,16,0.002148
Emergency-Style7392,16,0,27,8,6,14,13,0.002988
FlounderCautious4523,24,0,12,13,2,15,15,0.002456
Icy-Exits,12,0,14,7,5,12,14,0.002028
KathrynBooks,20,0,19,5,3,8,15,0.001605
Kristoveles,16,0,18,6,3,9,14,0.00126
Masterpiece-Haunting,46,1,2,2,8,10,13,0.000612
MyNameIsNotKyle,40,0,29,12,4,16,14,0.002574
NysemePtem,11,0,14,16,8,24,12,0.003759
Perdendosi,25,0,12,16,1,17,14,0.003477
PuzzleheadedShoe5829,1653,3,8,6,135,141,12,0.001048
Solnx,37,0,22,10,4,14,14,0.001911
StopElectingWealthy,13,0,17,8,6,14,13,0.001699
VegetableComplex5213,14,0,20,9,4,13,13,0.001842
Warny55,56,0,63,22,12,34,14,0.002783
WhereztheBleepnLight,73,2,2,2,14,16,13,0.001913
_DaEclipse_,19,1,1,1,5,6,13,0.00051
ghjm,12,0,16,7,2,9,14,0.00371
grayscale001,19,0,35,22,8,30,14,0.006803
issuefree,24,0,68,12,16,28,14,0.002564
Curiosity_456,159,1,0,0,24,24,13,0
AutistAstronaut,23,0,25,15,3,18,15,0.001782
Huge___Milkers,24,0,10,6,1,7,17,0.000971
favorable_vampire,15,0,18,8,4,12,15,0.001414
savingforresearch,18,0,19,3,2,5,14,0.001681
Curiousman1911,300,1,0,0,48,48,13,0
BadIdeaSociety,11,0,11,12,4,16,14,0.023407
ImDeputyDurland,13,0,18,5,2,7,15,0.003099
LookAtMeNow247,24,0,22,13,9,22,14,0.01427
PolicyWonka,16,0,15,10,5,15,14,0.023421
R_V_Z,12,0,15,20,6,26,14,0.024982
unidentifiedfish55,12,0,6,9,1,10,14,0.003468
Current-Macaroon9594,136,1,0,0,10,10,15,0
Impressive-Floor-700,26,0,32,14,3,17,16,0.000217
planodancer,17,0,6,4,1,5,18,0.000366
reddituserperson1122,13,0,19,3,1,4,15,0.000377
wiseduckling,30,0,11,7,1,8,1,0.000093
Cute-Bass-7169,109,1,0,0,13,13,14,0
ExtendedMacaroni,64,1,6,2,10,12,13,0.00014
ForgetfullRelms,30,1,21,6,5,11,14,0.000751
tastefulmalesideboob,361,3,23,41,39,80,13,0.00402
DESERTfOxN,17,1,0,0,4,4,14,0
DKLancer,15,0,9,7,1,8,14,0.009749
baby_budda,14,0,14,15,2,17,14,0.034497
DMVThrowaway69,68,1,0,0,2,2,12,0
DRIVELINE2018,18,1,0,0,1,1,2,0
DaMagiMan,23,1,0,0,2,2,15,0
Daddy_oogway,43,1,0,0,3,3,15,0
PeteMichaud,13,0,17,13,1,14,15,0.002842
ZappSmithBrannigan,27,0,31,21,8,29,14,0.002692
DaftMythic,35,1,1,1,6,7,13,0.000139
CobraPuts,18,0,15,17,6,23,13,0.006325
Dalakaar,23,1,1,1,1,2,15,0.000017
kep_x124,335,12,6,3,15,18,14,0.000013
DaleRod2468,49,1,5,1,6,7,13,0.000454
Advanced-Ad6210,16,0,21,4,0,4,0,0.000369
speedyjohn,15,0,20,21,8,29,14,0.003768
DancyB0y46,61,1,0,0,5,5,11,0
FeistyAd6348,86,1,2,2,2,4,15,0
DangerousDarius,52,1,0,0,12,12,10,0
Dangerous_Stay7437,20,1,0,0,5,5,11,0
Several_Razzmatazz51,43,0,10,9,0,9,0,0.000224
Daniel-1416,76,1,0,0,19,19,13,0
Arkmer,18,0,19,15,2,17,14,0.020278
bjdevar25,27,0,36,26,14,40,13,0.043345
l1qq,37,0,28,23,8,31,14,0.039343
stinkywrinkly,15,0,23,10,6,16,14,0.023454
DanteAll,104,1,0,0,6,6,15,0
LostMyKarmaElSegundo,13,0,12,10,3,13,17,0.000054
SethGekco,14,0,29,13,2,15,14,0.000186
dullaveragejoe,20,0,13,6,1,7,1,0.00007
forestrox,13,0,12,2,1,3,1,0
xfearthehiddenx,11,0,9,3,1,4,15,0.000011
EmotionalSize5586,55,0,54,16,9,25,12,0.00247
MelodiusRA,53,0,44,7,4,11,15,0.00058
Monte_Cristos_Count,19,0,24,8,0,8,0,0.002064
ScrupulousArmadillo,26,0,22,15,3,18,15,0.002533
Throwaway7131923,325,1,9,6,20,26,13,0.00076
VortexMagus,12,0,17,10,1,11,15,0.002655
siorge,149,1,6,6,15,21,13,0.000996
DarkGreenGummybear,122,1,0,0,14,14,13,0
7thpostman,11,0,15,5,2,7,15,0.001368
Chompytul,36,0,32,6,3,9,14,0.000532
Sea_Entrepreneur6204,68,0,49,19,8,27,13,0.002652
Darkstar7867,18,1,0,0,5,5,14,0
Darth_Azazoth,226,3,0,0,7,7,14,0
0ldfart,15,0,11,8,0,8,0,0.000338
PiemasterUK,11,0,7,2,0,2,0,0.000085
brutishbloodgod,13,0,15,5,1,6,15,0.000091
Darthvaderishot,44,1,0,0,4,4,12,0
Daulphins,11,1,1,1,1,2,1,0
NoOneEverSeems2SeeMe,22,0,36,5,0,5,0,0
DayzedandC0nfused,109,1,0,0,6,6,14,0
Fat_Prick,15,1,1,1,2,3,16,0.000009
Faust_8,12,0,10,6,1,7,15,0.000339
DazzlingPurple1011,20,1,0,0,1,1,11,0
Dead_Huntsman,1275,1,0,0,33,33,11,0
Ayslyn72,16,0,18,5,2,7,12,0.00131
BeatificBanana,37,0,28,8,2,10,12,0.000048
Few_House_5201,13,1,2,2,1,3,1,0.000043
Gold-Flaked-Paint,12,0,4,2,0,2,0,0.000018
Raephstel,32,0,32,14,5,19,15,0.003818
RandoGenericUserName,12,0,8,4,2,6,2,0.000138
Sufficient_Most_9713,12,0,1,3,1,4,1,0.000018
thegeniuswhore,16,0,32,13,3,16,12,0.000057
DeathStrike56,80,1,14,4,7,11,13,0.001484
AluminiumLlama,17,0,21,8,4,12,14,0.000681
No-Dinner-5894,21,0,32,8,2,10,13,0.00239
ObsidianKing,15,0,16,2,2,4,15,0.000081
Deep_Mango4053,22,1,0,0,2,2,13,0
Jack_930,188,2,4,3,33,36,13,0.001556
Dependent-Loss-4080,5005,1,3,3,242,245,12,0.002019
-spicychilli-,40,0,20,11,4,15,15,0.002659
AVGJOE78,17,0,22,10,9,19,14,0.002973
Acrobatic-Brother232,12,0,15,7,3,10,15,0.002842
Adorable_Ad_3478,23,0,27,15,5,20,14,0.003955
Adorable_Chair_6594,11,0,9,5,4,9,15,0.000885
Aggravating_Fill378,15,0,3,6,3,9,14,0.001045
Alternative_Switch39,19,0,22,3,5,8,12,0.000855
And_Justice,63,0,51,17,12,29,14,0.002163
ApetteRiche,11,0,12,6,5,11,15,0.001024
ArCovino,27,0,33,13,6,19,14,0.006073
AsterKando,16,0,15,4,2,6,15,0.001256
Bast-beast,45,0,32,13,9,22,13,0.002703
CaymanDamon,13,0,8,2,1,3,17,0.001066
ChBowling,11,0,6,6,1,7,14,0.00256
CharmCityKid09,17,0,14,5,4,9,14,0.000914
Choperello,18,0,30,16,5,21,14,0.005174
Commercial_Pie3307,18,0,20,15,6,21,12,0.007741
CptHrki,16,0,11,2,0,2,0,0.000839
CrimsonCartographer,18,0,20,4,3,7,15,0.00239
DeadlyPython79,41,0,52,11,13,24,13,0.001978
Decent_Cheesecake_29,12,0,10,5,5,10,15,0.000877
Elegant-Pie6486,19,0,26,10,2,12,14,0.002478
Every3Years,19,0,35,9,6,15,14,0.002822
Eyuplove_,39,0,49,9,6,15,14,0.002661
Few_Mistake4144,24,0,31,11,11,22,14,0.004022
Flashy-Lunch-936,11,0,17,5,6,11,13,0.001316
Fleeting_Dopamine,20,0,22,9,4,13,15,0.002925
Forte845,73,0,87,30,27,57,13,0.026379
Fulg3n,33,0,32,12,8,20,14,0.00206
GarryofRiverton,19,0,18,8,5,13,14,0.003178
GodtheBartender,22,0,15,6,7,13,15,0.000928
GroundbreakingAd6354,11,0,13,3,3,6,14,0.000969
Gurpila9987,33,0,36,21,12,33,14,0.022506
Haleakala1998,307,3,16,6,42,48,13,0.00266
Hatook123,47,0,24,16,8,24,13,0.003717
Head_Personality_394,14,0,20,5,7,12,14,0.000909
HiHoJufro,11,0,12,9,5,14,15,0.004027
Hungry-Struggle-1448,43,0,57,13,11,24,14,0.003839
Individual642,21,0,20,7,6,13,14,0.000938
IsNotACleverMan,91,0,78,18,14,32,14,0.004816
Itzko123,13,0,12,4,3,7,15,0.000865
KRAy_Z_n1nja,11,0,14,7,3,10,13,0.002184
Kotor-Knowledge-7964,23,0,22,6,2,8,15,0.00152
LateralEntry,57,0,45,27,16,43,14,0.018166
LordBecmiThaco,24,0,23,16,7,23,13,0.004549
MalekithofAngmar,12,0,14,4,3,7,15,0.001305
Master-Eggplant-6634,150,1,5,3,13,16,14,0.00117
NJS_Stamp,13,0,7,8,4,12,15,0.002529
No-Ladder7740,22,0,24,9,8,17,14,0.002284
Noob_Al3rt,45,0,64,21,15,36,14,0.006762
NotGalenNorAnsel,12,0,12,5,3,8,15,0.001049
Not_Yet_Italian_1990,12,0,19,5,7,12,14,0.002002
Odd-Bumblebee00,40,0,46,8,8,16,14,0.001359
One-Salamander-1952,21,0,24,6,5,11,14,0.001363
Opening_Acadia1843,19,0,14,11,5,16,14,0.003169
OtsaNeSword,121,0,4,30,1,31,15,0.001956
Pixelology,11,0,16,6,8,14,14,0.001193
Popular_Kangaroo5446,34,0,32,15,9,24,14,0.003479
PressPausePlay,172,1,11,8,26,34,13,0.003624
PrettyChillHotPepper,17,0,26,9,9,18,13,0.00349
PrimAhnProper998,19,0,18,4,3,7,15,0.008778
PuzzleheadedTrash131,17,0,22,3,5,8,14,0.00097
Puzzleheaded_Ad_5710,28,0,29,5,3,8,15,0.000866
QR4201,20,0,21,9,7,16,15,0.002489
RSmeep13,29,0,25,13,12,25,14,0.003753
RedSpaceman,18,0,20,5,6,11,13,0.00089
Responsible-Bunch316,353,1,31,10,40,50,13,0.002695
Reverse_Quikeh,12,0,12,2,0,2,0,0.001129
Robert_Grave,11,0,11,11,1,12,16,0.002749
Saargb,23,0,21,9,4,13,14,0.002781
SannySen,64,0,39,10,5,15,14,0.001704
Sea-Volume-4746,56,0,35,13,8,21,13,0.001419
Smart-Status2608,18,0,25,12,7,19,14,0.002565
StockAdeptness9452,12,0,13,5,2,7,15,0.001639
SunshineThunder101,13,0,14,4,4,8,14,0.000994
TangoJavaTJ,176,0,94,31,15,46,15,0.003706
Technical-King-1412,48,0,36,15,8,23,14,0.003385
ThatFuzzyBastard,13,0,17,8,2,10,14,0.002913
TheBeardedDuck,28,0,22,6,3,9,15,0.001713
Traditional_Fish_504,75,1,1,1,19,20,13,0.000833
Tristan_Gabranth,22,0,16,2,1,3,15,0.000843
Truffles15,15,0,3,5,0,5,0,0.000979
United_Librarian5491,17,0,20,7,6,13,14,0.001447
Unlikely-Distance-41,16,0,14,9,6,15,15,0.003116
Upset_Gerbil,22,0,17,5,4,9,15,0.001092
Volume2KVorochilov,64,1,2,2,10,12,13,0.001683
WhiteGold_Welder,15,0,13,5,3,8,14,0.00256
Worldly_Scarcity2179,12,0,8,6,1,7,15,0.001746
WreckinRich,24,0,32,11,6,17,14,0.00347
Zilox,11,0,8,12,5,17,14,0.003403
Zipz,13,0,11,2,1,3,16,0.000842
aardvark_gnat,285,1,71,28,53,81,13,0.004846
amitball,15,0,13,6,4,10,12,0.001103
banhs5,17,0,26,10,6,16,14,0.002679
bayesian_horse,19,0,29,6,11,17,14,0.002002
bigbadaboomx,50,0,51,6,3,9,14,0.001915
biggyshwarts,15,0,8,9,2,11,14,0.002276
billymartinkicksdirt,60,0,56,16,12,28,14,0.002684
breakbeforedawn,42,0,60,11,12,23,13,0.004269
carterthecomic,35,0,37,6,5,11,14,0.001085
cheeruphumanity,25,0,11,9,4,13,15,0.001027
communityneedle,22,0,11,11,4,15,14,0.001522
dalburgh,11,0,7,4,2,6,14,0.001136
glumjonsnow,20,0,25,7,6,13,14,0.001099
heywhutzup,21,0,23,6,4,10,14,0.00152
htmwc,13,0,6,8,2,10,15,0.001137
iamwolfe,28,0,18,6,3,9,15,0.000993
kwamzilla,25,0,36,17,11,28,13,0.004566
lalahair,402,1,26,11,34,45,13,0.005164
makeyousaywhut,13,0,12,4,2,6,14,0.001266
neverendingchalupas,16,0,28,18,12,30,14,0.046745
oopiex,12,0,7,5,3,8,15,0.00095
outestiers,42,0,66,17,16,33,14,0.002722
parsonsrazersupport,25,0,25,10,8,18,14,0.001665
radialomens,11,0,10,5,1,6,14,0.001434
renlydidnothingwrong,16,0,14,10,3,13,15,0.003466
revilocaasi,29,0,30,11,9,20,15,0.002658
shumpitostick,21,0,14,10,4,14,15,0.002358
spicymemesdotcom,41,0,31,13,10,23,13,0.00315
sterrrmbreaker,11,0,9,5,4,9,14,0.000892
systemfa1lure,26,0,7,10,5,15,15,0.006166
temujin94,14,0,16,4,4,8,13,0.001131
theUSpopulation,54,0,1,11,1,12,16,0.001059
thedorknightreturns,13,0,26,11,15,26,14,0.002105
thegreatherper,24,0,28,9,4,13,15,0.002854
wtfgrancrestwar,12,0,16,5,4,9,14,0.001526
zentimo2,14,0,2,5,0,5,0,0.000924
Dermal_Denticals,47,1,0,0,2,2,15,0
Designer_Economics94,33,1,1,2,7,9,12,0.000531
Designer_Refuse_586,70,1,0,0,5,5,13,0
Salty-Initiative-242,47,0,6,5,0,5,0,0.000068
Despaczitos,22,1,0,0,2,2,15,0
Prasiatko,15,0,20,15,3,18,14,0.00743
AgitatedBadger,12,0,15,6,3,9,15,0.000927
Gatonom,32,0,37,12,3,15,15,0.002242
Past-Winner-9226,17,0,23,6,1,7,15,0.000811
VforVenndiagram_,17,0,11,10,1,11,14,0.001298
WinDoeLickr,21,0,28,17,7,24,14,0.001945
dejamintwo,190,1,16,8,29,37,13,0.001401
funglegunk,24,0,20,7,5,12,14,0.0006
DhruvvvPanchal,16,1,3,3,7,10,14,0.000294
Dianaut,349,1,0,0,14,14,14,0
Maximum_Error3083,21,0,20,10,2,12,13,0.001629
i_love_boobiez,16,0,2,2,0,2,0,0.000042
ilcuzzo1,12,0,15,1,0,1,0,0.000038
sharkdog73,13,0,2,3,0,3,0,0.000085
Difficult-Secret-540,299,1,0,0,5,5,14,0
BonelessB0nes,11,0,11,7,1,8,14,0.002972
cwaterbottom,12,0,11,6,0,6,0,0.000199
Difficult_Wave_9326,46,1,7,3,7,10,13,0.000661
Destroyer_2_2,49,0,47,21,11,32,13,0.005194
Kithslayer,14,0,17,5,2,7,15,0.001163
Diligent_Jury_6881,385,1,0,0,13,13,11,0
Danominator,12,0,6,5,2,7,11,0.000008
DragonWyrd316,16,0,26,10,2,12,16,0.000011
FinanciallySecure9,17,0,8,4,0,4,0,0.000019
Meghanshadow,12,0,10,5,1,6,2,0.000043
OLAZ3000,15,0,12,2,0,2,0,0.000096
lycrashampoo,17,0,21,14,1,15,3,0.000061
morgaine125,16,0,17,7,1,8,1,0.000045
DingusCoconut349,24,1,0,0,1,1,11,0
Direct_Albatross_666,17,1,0,0,1,1,11,0
Disastrous-Potato407,60,1,0,0,9,9,14,0
DonQuigleone,11,0,14,5,2,7,15,0.00128
weirdoimmunity,52,0,49,14,3,17,14,0.001759
Disastrous-Tap9670,60,1,0,0,7,7,13,0
onepareil,17,0,12,9,7,16,13,0.001233
Disastrous_Phase_102,24,1,0,0,2,2,1,0
Round_Ad8947,34,0,5,5,0,5,0,0.00054
Disastrous_Wave1283,151,1,0,0,21,21,13,0
Bronze_Rager,13,0,13,3,2,5,14,0.000738
Dregride,18,0,23,6,4,10,15,0.001902
fizzmore,13,0,14,7,1,8,14,0.001517
rightful_vagabond,11,0,29,17,2,19,14,0.00456
y0da1927,15,0,26,11,7,18,14,0.00208
DiscernibleInf,69,1,0,0,17,17,13,0
Due_Satisfaction2167,13,0,13,8,1,9,15,0.001012
biteme4711,15,0,12,10,2,12,15,0.002405
DisplayInteresting59,48,1,0,0,3,3,12,0
DistinctNewspaper791,15,1,7,7,2,9,10,0.000022
Important_Pattern_85,15,0,16,4,3,7,14,0.001117
Distinct_Ask_1406,26,1,0,0,2,2,16,0
More_Mind6869,32,0,45,17,6,23,15,0.000675
Doc_Almond,27,1,0,0,3,3,12,0
Counther,12,0,19,13,1,14,16,0.000107
DogRepresentative47,93,1,0,0,6,6,11,0
lifequestio,131,1,1,1,6,7,11,0
DominicDonkey88,716,1,0,0,18,18,10,0
Janeiskla,30,0,3,4,2,6,16,0.000002
DonSarilih,67,1,2,1,14,15,14,0.000832
Donte_writes,890,1,0,0,78,78,13,0
B33f-Supreme,11,0,7,5,0,5,0,0.010217
Clausewitz1996,11,0,9,7,2,9,14,0.004458
Freeham55,11,0,10,12,3,15,15,0.007416
Honky_Cat,18,0,14,15,8,23,14,0.019036
James_Fiend,12,0,24,9,7,16,13,0.012146
PopTheRedPill,24,0,12,5,1,6,13,0.003445
SammathNaur1600,15,0,20,14,5,19,14,0.028098
TheSilkyBat,11,0,3,2,0,2,0,0.003639
ZayanZafar2254,63,1,1,1,16,17,13,0.002721
curly_spork,12,0,11,7,3,10,14,0.008261
informat7,18,0,9,12,6,18,14,0.019843
junkit33,11,0,17,14,7,21,13,0.021977
ninfan1977,32,0,32,11,5,16,14,0.021354
rogun64,29,0,12,19,4,23,14,0.019143
silence9,11,0,13,5,3,8,15,0.007868
telefawx,17,0,20,8,6,14,14,0.016849
yoshi8869,24,0,32,14,8,22,14,0.027398
Double-Incident-5125,22,1,0,0,2,2,13,0
DoughnutLow3055,1285,1,0,0,37,37,10,0
CloudAdditional7394,14,0,37,3,4,7,11,0.000013
Dense_Twi,22,0,8,3,1,4,16,0.000038
No-Acanthisitta-2973,15,0,15,4,1,5,11,0.000014
NotTravisKelce,15,0,21,3,2,5,12,0.000013
QuestionMaker207,13,0,10,6,0,6,0,0.000021
ReallyTracyQ,14,0,6,3,2,5,12,0.000031
Sad-Concentrate2936,17,0,7,6,1,7,17,0.000046
Sugah-Mama,14,0,14,3,1,4,13,0.000025
Wise_Owl5404,27,0,19,5,1,6,16,0.000014
rainmakestreesgrow,36,0,3,4,0,4,0,0.000013
Low_Imagination_1224,96,1,11,7,14,21,13,0.000547
Puresuner,34,0,29,6,6,12,14,0.000462
zizop,21,0,6,10,0,10,0,0.002937
Argo505,22,0,39,3,0,3,0,0.001789
Kotoperek,43,0,35,24,9,33,14,0.002941
LookWhatlCanDo,29,0,32,3,2,5,15,0.000267
SpecialistAddendum6,13,0,11,1,0,1,0,0.000176
fuckounknown,11,0,20,11,10,21,13,0.001992
Dr_Mowri,41,1,0,0,4,4,13,0
Either-Log-1570,254,1,4,4,10,14,12,0.000019
Drag-Upbeat,64,2,0,0,15,15,13,0
DramaMental6403,48,1,0,0,11,11,13,0
Drekavac666,63,1,1,1,12,13,11,0.00011
PretendAwareness9598,26,0,17,14,2,16,13,0.00393
Skuggsja86,16,0,22,15,8,23,14,0.003226
bigElenchus,23,0,14,10,4,14,14,0.000709
DrewwwBjork,13,1,0,0,4,4,14,0
Treethorn_Yelm,20,0,20,8,0,8,0,0.000097
DroobTube,37,1,0,0,6,6,11,0
Drphatkat,1245,1,0,0,27,27,14,0
Awkward-Dig4674,11,0,8,2,1,3,1,0.000114
CombinationRough8699,16,0,33,5,9,14,13,0.000477
DargyBear,20,0,9,5,2,7,15,0.002624
DazzlingFruit7495,38,0,38,4,4,8,14,0.000388
DoctorWinchester87,19,0,7,7,0,7,0,0.000244
Jimithyashford,294,1,9,10,51,61,13,0.010786
Knight_Machiavelli,60,0,61,30,14,44,13,0.017169
MuckleRucker3,14,0,8,3,1,4,15,0.000088
OSUfirebird18,12,0,7,5,0,5,0,0.000482
SheepherderNo2753,11,0,9,1,0,1,0,0.000054
SpaceCowboy1929,48,0,19,5,4,9,14,0.00008
TheMuffler42069,33,0,39,4,2,6,15,0.000597
ThrowRACoping,47,0,39,8,6,14,14,0.000258
caubelangthang245,12,0,6,2,0,2,0,0.000066
common_grounder,58,1,2,2,15,17,14,0.000402
redditsuckspokey1,12,0,11,4,1,5,16,0.000138
Drunken_Cannibal,37,1,0,0,2,2,13,0
Dry-Abalone2299,514,1,0,0,16,16,10,0
SeekersChoice,18,0,8,7,1,8,13,0.000025
Specialist_Value_804,16,0,12,2,2,4,15,0.000005
Dry-Championship1042,48,1,0,0,6,6,11,0
celandine_lush44,48,1,1,1,5,6,11,0
DryStar359,16,1,1,1,1,2,13,0.000003
Due-Specific9836,13,1,0,0,2,2,11,0
DueChampion3598,154,1,0,0,23,23,14,0
AdUpstairs7106,18,0,23,15,6,21,14,0.022777
False_Celebration626,13,0,10,12,4,16,14,0.024868
LukasJackson67,28,0,31,12,9,21,13,0.027037
Mijam7,79,1,9,6,26,32,14,0.010347
bearrosaurus,22,0,14,12,5,17,14,0.010492
Due_Dimension_2520,13,1,0,0,2,2,11,0
Duke_Nicetius,83,3,4,3,6,9,14,0.000061
00rb,18,0,29,20,7,27,14,0.006924
Corrupted_G_nome,75,0,53,21,7,28,14,0.002181
EDM117,55,1,0,0,6,6,12,0
Crepes_for_days3000,14,0,13,7,2,9,15,0.000113
man-vs-spider,171,1,20,9,20,29,11,0.000172
EZMoneyCOW,11,1,0,0,1,1,15,0
Earth_to_blaise,247,1,0,0,10,10,11,0
ottersncrocs,14,0,5,3,0,3,0,0.000009
Economy-Trip728,156,2,2,3,7,10,14,0.000066
PrivilegeCheckmate,17,0,28,11,3,14,14,0.00032
Economy_Ad7372,148,1,4,3,16,19,14,0.001176
Alternative_Pin_7551,61,0,66,17,7,24,13,0.010353
AnxietyObvious4018,34,0,35,25,11,36,13,0.004535
facefartfreely,18,0,34,19,1,20,14,0.002161
Educational_Major_64,119,1,0,0,14,14,10,0
KathyOverAndOut,29,0,6,5,0,5,0,0.000056
Efficient_Day4732,273,1,0,0,14,14,11,0
Human-County-1572,28,1,1,1,4,5,12,0.000001
Efficient_Tip_9991,156,2,1,1,8,9,15,0.000001
13surgeries,12,0,9,5,1,6,18,0.000226
Matinee_Lightning,39,1,1,1,5,6,16,0.000008
Eighth_Eve,80,1,6,4,21,25,13,0.000934
FixingGood_,702,1,6,6,70,76,12,0.001753
Katressl,14,0,19,9,9,18,13,0.000208
PsychologicalLuck343,12,0,10,6,2,8,13,0.000348
mylifexperience,14,1,1,1,3,4,15,0.000016
ElMoreno_X,12,1,0,0,1,1,11,0
ElectricalSpread2636,37,1,0,0,13,13,14,0
ThatOneAttorney,11,0,12,11,1,12,15,0.002878
Elegant-Variety-7482,19,1,0,0,7,7,13,0
Error_404_403,15,0,17,3,0,3,0,0.000172
ElvenNeko,63,1,8,6,3,9,16,0.00008
Embarrassed-Dress211,238,3,8,5,44,49,13,0.000678
Ace0spades808,22,0,21,7,4,11,14,0.001212
LordSwedish,20,0,11,7,3,10,14,0.001307
MennionSaysSo,13,0,21,18,3,21,14,0.005193
Personal-Advance-494,20,0,20,9,4,13,13,0.001515
RotisserieChicken007,101,1,2,2,20,22,13,0.000207
The-_Captain,576,1,14,11,61,72,13,0.003235
Zephos65,11,0,9,6,2,8,14,0.000602
fox-mcleod,74,0,93,40,24,64,14,0.012347
garnet420,25,0,21,14,4,18,14,0.001981
idktfid,40,1,2,2,3,5,14,0.000769
rustyseapants,12,0,13,5,1,6,16,0.001991
EmbarrassedYak968,102,1,3,2,12,14,13,0.000748
DarkSkyKnight,11,0,10,1,0,1,0,0.000087
Embarrassed_Love_619,34,1,0,0,3,3,11,0
Emergency_Aide_7936,13,1,0,0,4,4,12,0
EmotionalDirt798,214,1,1,1,30,31,13,0.000775
A_Soporific,29,0,24,10,4,14,13,0.00338
Kenichi2233,29,0,23,7,3,10,14,0.000428
Sloppykrab,19,0,14,12,7,19,14,0.00252
hortonian_ovf,71,1,1,1,11,12,13,0.000184
Empty_Ad960,25,1,0,0,3,3,15,0
Endless_Quested_Hope,18,1,0,0,6,6,13,0
physioworld,704,2,17,11,41,52,13,0.001379
Enough-Badger113,283,1,0,0,13,13,10,0
Min_sora,17,0,6,7,1,8,1,0.000902
Enough_Fudge3167,52,1,0,0,11,11,12,0
SiPhoenix,14,0,26,13,9,22,13,0.003545
baltinerdist,19,0,16,11,2,13,15,0.001345
Enough_Reflection_77,496,1,2,2,13,15,10,0.000002
sacredblasphemies,11,0,14,7,0,7,0,0.000395
Enough_Silver1454,52,1,0,0,8,8,11,0
EnvironmentalRub3507,43,1,0,0,1,1,13,0
IJustWantADragon21,12,0,16,8,2,10,12,0.000075
EqualPresentation736,26,1,0,0,4,4,12,0
EternalAlleviation,45,1,0,0,11,11,11,0
Sulfamide,32,0,43,15,11,26,13,0.009296
maybealmostpossibly,613,1,1,1,48,49,13,0.00008
talleyreviews,13,0,5,6,1,7,14,0.001454
Etherealityyyy,26,1,0,0,4,4,14,0
Euphoric-Wall-6027,107,1,0,0,10,10,10,0
OfficerTwigs,64,1,2,2,5,7,11,0.000054
Toppoppler,12,0,20,7,4,11,14,0.00082
Euphoric_Survey_8504,62,1,0,0,5,5,11,0
Even-Ad-9930,579,3,13,8,87,95,13,0.001008
4art4,89,0,29,25,7,32,14,0.005637
Accomplished_Tour481,20,0,29,18,6,24,14,0.025738
CallItDanzig,17,0,28,10,8,18,14,0.003114
CaptainMalForever,14,0,21,12,2,14,14,0.001852
Deep-Two7452,15,0,17,8,5,13,14,0.00222
GenerativeAdversary,13,0,9,6,3,9,14,0.000843
Planterizer,15,0,16,5,4,9,15,0.003287
Pristine_Club_3128,61,0,64,17,9,26,14,0.002389
PropDrops,19,0,9,5,2,7,14,0.000914
RetreadRoadRocket,20,0,31,9,4,13,15,0.003485
creativethoughtsy,220,1,1,1,37,38,13,0.000511
dommmm9,11,0,11,1,0,1,0,0.000511
Every-Lock4173,336,1,2,1,42,43,13,0.000221
BalrogintheDepths,12,0,5,5,0,5,0,0.003572
DebutsPal,31,0,48,21,6,27,13,0.002237
GenTwour,19,0,22,7,1,8,15,0.000957
LEDN42,15,0,15,5,3,8,15,0.000746
Narrow_List_4308,30,1,5,3,4,7,14,0.000745
OpeningChipmunk1700,23,0,24,12,7,19,14,0.01239
Overlook-237,14,0,20,6,5,11,14,0.000707
Simple_Pianist4882,37,0,31,6,4,10,14,0.000533
Tiny_Rub_8782,14,0,19,7,2,9,15,0.001903
aspiringimmortal,129,2,51,17,38,55,13,0.004114
clowncarl,27,0,14,12,5,17,13,0.00181
everydaywinner2,21,0,15,12,3,15,13,0.004844
housearachna,22,0,24,7,4,11,14,0.000345
Every_Cellist_4011,26,1,0,0,2,2,13,0
EvilSporkOfDeath,58,1,8,5,16,21,14,0.000902
eldomtom2,16,0,26,10,6,16,14,0.009413
figuring_ItOut12,23,0,37,12,5,17,15,0.027025
xXxdethl0rdxXx,22,0,20,12,4,16,14,0.01271
Excellent_Coast_398,893,1,0,0,78,78,13,0
Agitated_Elephant469,19,0,13,6,4,10,14,0.003007
AmusingMusing7,21,0,20,15,8,23,14,0.0169
Aneurhythms,15,0,20,13,7,20,13,0.019829
Arcturus_86,12,0,9,10,5,15,14,0.010245
BJPark,25,0,16,8,3,11,14,0.004519
CaptainoftheVessel,13,0,15,13,7,20,14,0.013482
DefaultProphet,13,0,15,6,2,8,15,0.006784
Emergency_Driver_487,48,0,49,8,7,15,14,0.010379
FrostyArctic47,15,0,19,13,4,17,15,0.025742
Futchkuk,16,0,3,14,0,14,0,0.008281
IfYaKnowYaKnow,11,0,5,5,1,6,14,0.009887
JustAnotherJon,15,0,17,10,7,17,14,0.019568
LosingTrackByNow,14,0,14,9,3,12,15,0.002523
Marchtmdsmiling,20,0,39,16,13,29,13,0.020447
NonsensePlanet,11,0,10,5,3,8,14,0.011101
OneReportersOpinion,22,0,29,6,4,10,14,0.012995
RebornGod,27,0,28,8,4,12,13,0.005999
SAPERPXX,13,0,10,8,2,10,14,0.013729
Sea-Document-974,13,0,12,3,2,5,14,0.004778
SpicyButterBoy,38,0,34,12,7,19,14,0.008916
StampMcfury,21,0,12,12,7,19,14,0.01184
TNine227,25,0,28,6,7,13,12,0.002633
The_Law_of_Pizza,58,0,45,27,14,41,14,0.035367
bfhurricane,21,0,20,13,8,21,14,0.015871
boldandbratsche,29,0,31,7,8,15,13,0.003687
cptjeff,20,0,14,10,3,13,14,0.018227
entr0py3,59,1,3,3,13,16,14,0.003652
shourwe,231,2,3,2,32,34,13,0.003072
sirswantepalm,241,2,43,19,34,53,13,0.027236
tlopez14,26,0,20,15,10,25,14,0.021191
tuna_HP,12,0,6,8,2,10,14,0.021522
Exciting_Sky1634,44,1,0,0,2,2,16,0
Existing_Honeydew_64,104,1,1,1,17,18,13,0.00058
Cynthesyss,20,0,17,7,3,10,13,0.001849
Exotic-End-666,82,1,0,0,12,12,12,0
Most-Ad4680,14,0,16,8,4,12,14,0.001509
seedoilbaths,1066,1,62,18,82,100,13,0.019683
ExpertDue7022,81,1,0,0,6,6,11,0
JellyfishSolid2216,14,0,18,11,5,16,13,0.004406
Expert_Height_8442,44,1,0,0,1,1,12,0
ExpiredGoatChz,443,1,0,0,16,16,10,0
AWildReaperAppears,23,0,29,9,4,13,13,0.001135
CarmenDeeJay,11,0,14,8,4,12,11,0.000582
ComprehensiveHat9054,14,0,5,3,0,3,0,0.000013
Objective-Arugula-17,24,0,18,4,2,6,11,0.000053
Express-Chemist5981,36,1,0,0,3,3,15,0
Express_Guidance9266,27,1,0,0,1,1,11,0
ExtendedWallaby,81,1,3,3,15,18,13,0.000477
Saranoya,257,1,3,3,28,31,13,0.000235
noah7233,19,0,19,14,4,18,13,0.004142
ExtensionBarnacle626,19,1,0,0,2,2,11,0
ExternalSeat,291,1,0,0,32,32,13,0
Crash927,68,0,65,23,10,33,14,0.010899
Monotonosaurus,11,0,12,6,4,10,14,0.000437
MysticalBathroomRaid,12,0,7,8,4,12,15,0.001448
bossmt_2,27,0,12,5,2,7,14,0.000671
jezx74,13,0,7,6,1,7,15,0.001155
redhillbones,24,0,30,16,13,29,13,0.003925
Extra-Tension9992,16,1,0,0,2,2,16,0
Extra_Difficulty_134,52,1,0,0,6,6,11,0
EyunO,72,1,0,0,5,5,11,0
FF1starz,100,1,0,0,2,2,15,0
Ok_Lecture_8886,11,0,9,6,1,7,16,0.000594
Fabulous-Earth-4871,66,1,0,0,10,10,13,0
dragonfirestorm948,115,2,14,4,11,15,13,0.000551
Fabulous-Suit1658,43,1,0,0,9,9,14,0
yellowhatb,14,0,12,2,1,3,14,0.002443
FabulousShirt8066,120,1,0,0,10,10,11,0
Fade067,62,1,1,1,11,12,14,0.000073
nhydre,18,0,15,10,3,13,14,0.000515
AnxiousChaosUnicorn,15,0,23,18,9,27,14,0.006124
Arnaldo1993,18,0,27,17,3,20,14,0.005339
BoogerMagnolia,19,0,21,7,6,13,14,0.00103
Chocotacoturtle,21,0,21,9,5,14,15,0.013624
Emotional-Tailor-649,11,0,16,8,4,12,14,0.002056
Former_Star1081,13,0,22,10,4,14,14,0.003474
Guldur,11,0,13,5,3,8,14,0.001729
JohnWittieless,23,0,21,13,4,17,14,0.002068
RequirementRoyal8666,23,0,26,17,8,25,14,0.005043
Working_Cucumber_437,15,0,3,3,1,4,16,0.000688
ZagreusMyDude,11,0,9,8,4,12,13,0.009552
cant_pass_CAPTCHA,86,1,5,5,8,13,14,0.00095
ecafyelims,32,0,27,10,5,15,15,0.001536
kkdawg22,16,0,21,10,7,17,11,0.003048
original_og_gangster,171,2,2,2,29,31,13,0.000557
sourcreamus,24,0,31,16,3,19,14,0.005514
wydileie,29,0,39,13,6,19,13,0.003532
Falconator100,319,1,2,1,36,37,13,0.000281
JRingo1369,16,0,19,5,6,11,14,0.000545
RedHead-Eng25,17,0,16,12,2,14,14,0.003113
health_throwaway195,25,0,26,4,2,6,15,0.000627
oofyeet21,233,1,6,8,31,39,13,0.000998
Familiar-Safety-226,298,2,0,0,5,5,16,0
FamilyJewelsTA,34,1,0,0,1,1,1,0
Far-Effective7640,30,1,0,0,5,5,14,0
RevolutionarySpot721,14,0,13,5,2,7,14,0.000393
Far_Reindeer3003,210,1,0,0,29,29,13,0
Ancient_Confusion237,42,0,52,16,4,20,14,0.002103
melissaphobia,11,0,11,4,2,6,13,0.000378
panna__cotta,34,0,34,11,7,18,13,0.001788
Fast-Plastic7058,695,1,1,1,76,77,13,0.000191
DuePersonality8585,21,0,16,4,2,6,15,0.000656
Gullible-Minute-9482,22,0,27,7,3,10,15,0.001526
LordGerdz,13,0,13,11,5,16,14,0.001835
Ossevir,13,0,10,11,3,14,14,0.003684
QuantumR4ge,11,0,21,5,7,12,14,0.001131
SinCityCane,458,1,2,2,28,30,13,0.000763
acesoverking,296,1,24,9,21,30,13,0.002224
going_my_way0102,20,0,36,18,14,32,14,0.005741
nicksey144,11,0,13,6,3,9,14,0.00324
pcgamernum1234,33,0,36,17,9,26,13,0.003541
pulsatingcrocs,23,0,26,8,7,15,14,0.002959
ququqachu,11,0,9,4,2,6,15,0.000674
rober11529,18,0,3,5,0,5,0,0.00084
FastAccident1038,13,1,0,0,2,2,11,0
Fearless_Day_5338,72,1,0,0,26,26,13,0
00PT,18,0,17,9,5,14,15,0.000813
CerealExprmntz,14,0,17,7,2,9,15,0.001051
EmbarrassedEvidence6,12,0,9,9,4,13,12,0.000585
JaggedMetalOs,16,0,17,6,1,7,15,0.000288
burnbobghostpants,12,0,13,8,4,12,14,0.00158
Fearless_Owl_9567,74,1,0,0,15,15,14,0
Sufficient_Steak_839,15,0,14,10,5,15,13,0.012993
t234k,29,0,28,13,6,19,14,0.016229
Feeling_Gur_4041,12,1,0,0,1,1,14,0
FenisDembo82,476,1,2,2,58,60,13,0.002274
DMayleeRevengeReveng,32,0,31,13,7,20,14,0.018658
JordanTheOP,11,0,9,12,2,14,13,0.006923
Lucas_Steinwalker,12,0,13,8,3,11,15,0.017604
Magehunter_Skassi,14,0,12,15,4,19,14,0.024866
PropofolMargarita,12,0,23,6,7,13,14,0.016672
Significant_Sign_520,14,0,11,17,2,19,15,0.019314
TJ11240,14,0,9,5,2,7,14,0.003716
Unfounded_archeology,13,0,15,7,4,11,14,0.009001
bambin0,56,1,1,1,7,8,14,0.001628
bionicfeetgrl,22,0,25,14,6,20,14,0.012024
honuworld,13,0,22,9,3,12,15,0.018759
FeralAndBooked,102,1,0,0,6,6,10,0
FerdinandvonAegir124,23,1,0,0,5,5,13,0
Few-Lawyer3707,43,1,0,0,7,7,14,0
Few_Parking_4685,36,1,0,0,5,5,13,0
yourlittlebirdie,17,0,11,4,1,5,1,0.000018
Fibonabdii358,64,2,1,1,8,9,13,0.000832
68_hi,12,0,18,9,1,10,13,0.003498
SophiaRaine69420,12,0,14,5,3,8,13,0.000742
throwawaytalks25,169,0,154,15,12,27,14,0.000911
Fickle-Fun-831,39,1,0,0,5,5,11,0
SQ_Madriel,28,0,8,10,0,10,0,0.000016
BobbyThrowaway6969,18,0,4,2,0,2,0,0.000075
Final_Candidate_9882,702,1,0,0,77,77,13,0
DogsOnMyCouches,14,0,11,6,2,8,15,0.00171
Gazalago,22,0,5,5,2,7,15,0.000569
GreatResetBet,29,0,14,15,5,20,14,0.003431
Iconic_Mithrandir,20,0,25,18,13,31,13,0.005343
Interesting_Claim414,1001,1,24,11,75,86,13,0.001856
NJBarFly,58,1,22,16,6,22,16,0.001567
Real-Intention-7998,208,1,22,16,28,44,13,0.001735
StargazerRex,23,0,27,5,5,10,15,0.003485
The_FriendliestGiant,11,0,13,10,2,12,15,0.003188
Then_Evidence_8580,979,1,7,4,76,80,13,0.00164
ThreeCatsAndABroom,22,0,6,7,2,9,14,0.001999
Waterworld1880,15,0,19,2,4,6,14,0.000414
chimingbell,17,0,12,3,1,4,15,0.000456
happyclam94,27,0,18,8,3,11,14,0.002529
hogsucker,15,0,13,10,8,18,14,0.00083
theroha,26,0,29,10,2,12,16,0.001252
Fire_Raptor_220,71,1,0,0,4,4,11,0
Fireblox06,12,1,0,0,2,2,12,0
First-Dependent-1452,33,1,0,0,2,2,16,0
traumfisch,17,0,22,2,1,3,15,0.000218
FishFollower74,99,1,12,6,5,11,15,0.000382
NightflowerFade,13,0,10,5,2,7,15,0.014605
Fit-Negotiation-891,220,1,0,0,10,10,12,0
Kosmopolite,14,0,19,6,2,8,14,0.000529
Fit_Sir7928,50,1,0,0,6,6,11,0
Fit_West5022,35,1,0,0,1,1,15,0
ameis314,26,0,28,15,2,17,14,0.000807
Historical_Bet,40,1,1,1,10,11,13,0.002441
NigroqueSimillima,13,0,15,6,3,9,14,0.00532
No-Ear7988,12,0,22,14,7,21,14,0.03918
Prestigious_Load1699,25,0,31,14,9,23,13,0.017264
rockclimberguy,12,0,11,6,2,8,14,0.012019
Akerlof,11,0,6,7,3,10,13,0.001046
AureliasTenant,27,0,42,22,8,30,13,0.005273
CincyAnarchy,27,0,20,11,5,16,12,0.001357
Kyrond,96,1,3,3,21,24,12,0.000529
No_Bottle7859,13,0,17,5,2,7,14,0.001467
Nojopar,41,0,41,13,10,23,13,0.002559
TetraThiaFulvalene,38,0,22,17,6,23,13,0.002977
Vesurel,21,0,26,9,1,10,15,0.001953
blangenie,14,0,14,4,4,8,13,0.001158
blueplanet96,34,0,21,9,6,15,13,0.001039
burz,16,0,15,7,4,11,14,0.001691
giraloco,13,0,11,7,4,11,14,0.001506
henosis-maniac,12,0,18,2,2,4,14,0.000438
isekai15,13,0,13,6,1,7,15,0.00356
mickeyanonymousse,16,0,18,10,7,17,12,0.001261
spectrehauntingeuro,17,0,21,10,6,16,14,0.002413
FlameDragoon933,106,3,2,2,8,10,14,0.000005
Signal_Ad_7959,14,0,12,4,2,6,16,0.00001
The_Godlike_Zeus,114,3,10,4,6,10,14,0.000061
parkway_parkway,13,0,8,6,1,7,16,0.000192
thenletskeepdancing,11,0,5,5,1,6,15,0.000343
FlamingoMiserable557,16,1,0,0,2,2,12,0
Bourbon-Decay,24,0,20,8,6,14,13,0.018504
DizzyDentist22,16,0,2,3,0,3,0,0.001324
EclipseNine,22,0,28,13,6,19,14,0.007048
Garganello,26,0,35,7,7,14,14,0.005571
Gnarly-Beard,11,0,8,5,4,9,14,0.001468
Honeycrispcombe,21,0,21,11,5,16,14,0.002186
JumperCableBeatings,14,0,8,5,2,7,14,0.001336
Large-Flamingo-5128,16,0,17,5,4,9,14,0.001633
Laue,11,0,9,8,4,12,14,0.001303
MajorPayne1911,119,1,3,3,20,23,13,0.002008
MartyTax,12,0,12,2,0,2,0,0.001347
Me_U_Meanie,11,0,11,3,3,6,13,0.00106
NTXGBR,13,0,14,4,2,6,15,0.001941
NeuroticKnight,14,0,17,9,5,14,14,0.002952
Sea_Section_9861,14,0,12,4,0,4,0,0.002548
Sharkbait_ooohaha,22,0,23,6,4,10,15,0.002129
Sovereign_Black,16,0,17,4,3,7,14,0.002124
Tea_Time9665,17,0,24,6,5,11,13,0.001884
TheIrelephant,13,0,4,5,2,7,15,0.001356
alienassasin3,12,0,9,6,2,8,14,0.002834
asah,176,2,7,2,31,33,13,0.001093
colt707,17,0,17,15,2,17,16,0.003912
csopinion,128,2,8,4,20,24,13,0.002319
goldenroman,11,0,10,5,4,9,14,0.00183
icecubtrays,11,0,13,5,2,7,15,0.001767
lastberserker,19,0,21,12,6,18,13,0.002984
peterbound,12,0,8,5,0,5,0,0.002425
pickleparty16,17,0,16,10,5,15,13,0.002644
rdsuxiszdix,31,0,43,7,7,14,15,0.002744
serravee,11,0,10,3,2,5,14,0.001118
MEGAJOHN,356,1,2,2,57,59,13,0.000471
Fluid_Literature3089,38,1,0,0,4,4,12,0
FootBeerFloat,40,1,0,0,2,2,15,0
Foreign-Resolve-8693,34,1,0,0,3,3,11,0
ButterscotchIll1523,12,0,11,6,3,9,12,0.000675
QuesoStain2,18,0,13,9,3,12,14,0.0018
Socialmediaisbroken,15,0,10,7,3,10,15,0.002426
ThatPatelGuy,267,2,5,5,27,32,13,0.000328
bshum95,13,0,18,5,1,6,15,0.000804
socialgambler,12,0,6,7,3,10,14,0.001238
Foreign_Relative_769,38,1,0,0,4,4,14,0
zeussays,11,0,12,6,3,9,14,0.009782
Bastiat_sea,14,0,19,21,6,27,14,0.003676
Plastic-Abroc67a8282,33,1,17,8,2,10,13,0.00101
Former_Account4691,85,1,0,0,7,7,11,0
Forsaken_Fan7837,29,1,0,0,4,4,11,0
No-Assistant-1948,16,0,19,8,3,11,14,0.000004
definitelynotjava,12,0,15,5,1,6,15,0.000002
FragrantAd1134,26,1,0,0,1,1,13,0
Fragrant_Maximum_966,25,1,0,0,5,5,11,0
FrameworkFaults,82,1,0,0,5,5,15,0
Top-Cupcake4775,42,0,26,12,6,18,14,0.000678
FreakInTheTreats,61,1,0,0,13,13,13,0
Significant-Cancel70,36,0,40,19,5,24,13,0.03397
Fresh-Bookkeeper5095,101,1,0,0,15,15,13,0
EDRootsMusic,22,0,22,8,5,13,14,0.002818
FriendofMolly,374,3,2,2,68,70,13,0.000243
Affenklang,14,0,7,7,2,9,14,0.001402
CandidateNew3518,15,0,16,6,6,12,13,0.002343
Final-Prize2834,14,0,12,7,5,12,14,0.000627
StrikingExcitement79,11,0,18,5,2,7,15,0.001778
myusrnmeisalrdytkn,22,0,19,6,4,10,15,0.000579
Front-Cancel5705,148,1,0,0,31,31,13,0
Rindan,14,0,11,3,2,5,14,0.003365
postdiluvium,31,0,25,21,4,25,14,0.011406
Full-Feature3193,154,1,0,0,9,9,11,0
luvchicago,11,0,4,1,0,1,0,0.000001
Fun_Run_5530,35,1,0,0,3,3,12,0
Funny-Summer8097,133,1,0,0,24,24,13,0
Intelligent-Sound-85,15,0,14,8,1,9,15,0.008039
cknight13,16,0,13,12,3,15,14,0.020548
Funny-Swan-9443,95,1,0,0,8,8,11,0
tweedledumb4u,14,0,5,4,1,5,11,0.000007
Future-succeful-man,11,1,0,0,3,3,14,0
Future_Corner4869,74,1,0,0,5,5,12,0
AgreeableMagician893,23,0,31,9,3,12,15,0.001167
JadedDruid,15,0,17,10,4,14,15,0.004038
Just-Feedback-2223,23,0,25,2,0,2,0,0.000802
Theomach1,31,0,59,9,10,19,14,0.001549
furtive_phrasing_,285,2,25,3,35,38,13,0.000539
GENERAL_GADDAFI_,48,1,0,0,3,3,15,0
BeGoodToEverybody123,29,0,21,4,2,6,15,0.000565
GaDoRa1,13,1,0,0,4,4,14,0
McKoijion,13,0,17,6,2,8,14,0.002553
Gain-Classic,45,1,0,0,5,5,15,0
AquaSnow24,12,0,9,9,4,13,14,0.017403
ZeBigD23,25,0,19,18,7,25,14,0.020028
kevbot918,13,0,14,12,7,19,14,0.024524
mongooser,16,0,14,15,3,18,15,0.018513
norealpersoninvolved,17,0,9,15,7,22,13,0.02216
GasHistorical5064,180,1,0,0,27,27,13,0
AVonGauss,17,0,18,10,6,16,14,0.022011
apiaryaviary,34,0,25,14,7,21,14,0.020257
spam__likely,15,0,24,17,14,31,13,0.034551
Gaucho1989,48,1,0,0,4,4,12,0
6SpeedBlues,15,0,6,3,0,3,0,0.000001
Swirlyflurry,13,0,8,7,1,8,11,0.000054
GerbilCopter,122,1,1,1,7,8,14,0
VordovKolnir,31,0,35,11,2,13,13,0.000095
GilfredJonesThe1st,24,1,0,0,6,6,13,0
IGotScammed5545,11,0,9,7,1,8,14,0.001252
Glad-Interview-7349,67,1,0,0,8,8,13,0
Bigthrimbles,23,0,25,5,3,8,14,0.000795
Glad-Register-3990,35,1,0,0,3,3,11,0
Glad-Try-7516,61,1,0,0,3,3,11,0
Glittering_Judge_460,31,1,0,0,4,4,11,0
Glittershitz420,57,1,0,0,3,3,11,0
GloveStreet7520,60,1,0,0,4,4,10,0
Educational-Pop-3351,11,0,19,3,1,4,15,0.000005
Good_Piccolo_4320,13,1,0,0,1,1,14,0
GooseRider960,37,1,0,0,3,3,15,0
Grand_Opinion7065,244,1,0,0,16,16,10,0
Ok-Educator850,11,0,5,4,0,4,0,0.000006
YawningDodo,11,0,15,5,2,7,13,0.000017
annang,19,0,20,6,1,7,14,0.000021
Greedy-Physics2879,80,1,0,0,8,8,11,0
BigBigBigTree,87,0,35,16,2,18,12,0.000091
RainfallsHere,17,0,19,6,2,8,12,0.000027
UteLawyer,14,0,6,4,0,4,0,0.000047
GreenTreeAndBlueSky,89,1,0,0,5,5,13,0
GregorioFumee,11,1,0,0,1,1,1,0
Gullible-Chance-7386,21,1,0,0,3,3,11,0
Gullible-Setting-724,22,1,0,0,1,1,13,0
Guy_Cross,35,1,0,0,5,5,15,0
celsius100,11,0,14,13,4,17,14,0.019273
Hah-Funny,30,1,0,0,7,7,13,0
Mysteriousdeer,13,0,16,6,5,11,13,0.000689
No_Initiative_1140,28,0,26,10,4,14,14,0.001098
WippitGuud,12,0,16,11,3,14,14,0.003943
HannasAnarion,37,1,0,0,15,15,13,0
Adiv_Kedar2,37,0,31,11,6,17,14,0.002863
HappyBee59,36,1,0,0,3,3,16,0
amongthepillows,20,0,20,5,1,6,2,0.000023
Hardik_Jain_1819,39,1,0,0,7,7,14,0
actsqueeze,13,0,15,8,4,12,13,0.002676
Harstco,24,1,0,0,3,3,15,0
Hasjojo,62,1,0,0,15,15,13,0
Automatic-Flounder-3,37,0,28,23,13,36,13,0.035083
d1stor7ed,18,0,8,6,1,7,14,0.016253
HeWhoReddits,874,1,0,0,62,62,11,0
FrickinLazerBeams,36,0,45,8,10,18,12,0.000348
IEATASSETS,30,0,26,6,4,10,13,0.00036
LeRoyRouge,24,0,26,8,5,13,14,0.014055
Mejari,18,0,34,8,10,18,14,0.002799
NotYourThrowaway17,13,0,15,5,2,7,14,0.001147
Riceowls29,31,0,38,8,4,12,13,0.004577
Shadeylark,24,0,29,7,5,12,14,0.002698
Square-Bite1355,13,0,13,3,4,7,14,0.00028
TheBouwerie,14,0,23,7,5,12,14,0.002037
WVUEnchilada,25,0,24,3,2,5,13,0.000276
Zerowantuthri,17,0,9,10,4,14,14,0.003828
_robjamesmusic,12,0,15,6,3,9,14,0.00137
im-obsolete,23,0,14,9,5,14,15,0.002078
rewt127,26,0,22,13,7,20,13,0.003441
Head_Set9820,26,1,0,0,2,2,13,0
Head_Variety7543,34,1,0,0,3,3,11,0
90daysismytherapy,20,0,23,7,6,13,14,0.001552
Academic_Guitar7372,14,0,10,3,0,3,0,0.000891
Anna-Politkovskaya,15,0,10,5,2,7,15,0.002439
Any-Wheel-9271,15,0,17,3,3,6,15,0.001135
BadBoiy33,40,0,41,4,3,7,15,0.001423
CreativeContract2170,21,0,20,9,3,12,13,0.001858
Effective_Jury4363,17,0,25,15,10,25,14,0.003731
FartingKiwi,23,0,17,16,4,20,15,0.005017
FreeGazaToday,23,0,31,17,5,22,14,0.005646
Hellion_444,11,0,13,6,5,11,15,0.00236
Herr_Tilke,13,0,9,7,2,9,14,0.01014
HungryDepth5918,44,0,47,4,1,5,17,0.001229
ImNoLawyer,16,0,12,5,2,7,14,0.015396
IslandSoft6212,24,0,31,14,3,17,14,0.002851
JoJoeyJoJo,42,0,58,10,11,21,13,0.002246
MyrddinTheKinkWizard,16,0,29,10,7,17,14,0.002771
Neither-Stage-238,11,0,11,5,2,7,15,0.00149
Perfect_Security9685,23,0,55,9,14,23,14,0.00158
PerspectiveViews,30,0,30,11,6,17,14,0.003121
ShadowSniper69,11,0,15,2,1,3,15,0.000879
Slow-Seaweed-5232,11,0,12,7,2,9,14,0.003639
Square_Hat_3994,18,0,23,8,4,12,13,0.002895
The-Grand-Pepperoni,17,0,11,2,1,3,14,0.000874
TotaLibertarian,28,0,24,12,6,18,13,0.003899
Worried4lot,14,0,12,4,2,6,15,0.007985
daoistic,21,0,26,11,8,19,13,0.001584
eldankus,20,0,16,9,7,16,14,0.003417
eteran,36,0,38,7,5,12,14,0.001909
fishingfanman,11,0,9,6,1,7,15,0.001888
loggywd,12,0,8,4,3,7,14,0.001095
scrambledhelix,21,0,29,8,8,16,14,0.001791
stopbsingman,14,0,23,9,7,16,14,0.002226
vvildlings,12,0,9,2,1,3,16,0.000857
walletinsurance,66,1,10,7,13,20,13,0.003107
xamxes,11,0,11,2,1,3,18,0.00085
medical_bancruptcy,12,0,17,5,4,9,14,0.001535
Hermeslost,78,1,0,0,13,13,12,0
Delduthling,18,0,23,6,2,8,13,0.000952
Hero-Firefighter-24,116,1,4,1,5,6,14,0.000721
jadnich,16,0,32,12,3,15,13,0.026166
xvpawel,12,0,10,4,2,6,14,0.000458
Sea-Chain7394,15,0,20,12,7,19,11,0.009435
lukaszdadamczyk,11,0,9,6,2,8,13,0.00205
HiddenReader2020,62,1,0,0,5,5,14,0
Particular_Roll_242,15,0,6,5,0,5,0,0.000543
TexanInNebraska,41,0,25,7,4,11,14,0.000531
HistoricalAd6321,2304,1,0,0,153,153,12,0
AhsokaSolo,30,0,36,4,4,8,14,0.001259
DBFool2019,22,0,29,4,6,10,13,0.001062
DJFrostyTips,26,0,33,8,3,11,14,0.00269
DeepShill,21,0,12,11,4,15,14,0.005875
Grish__,17,0,19,4,3,7,14,0.002732
Gygsqt,25,0,34,13,10,23,14,0.003576
Herodrake,15,0,6,3,0,3,0,0.001094
Idontcarelikethat,11,0,4,3,0,3,0,0.001161
In-Brightest-Day,20,0,20,11,5,16,14,0.010121
Jmcduff5,23,0,22,9,4,13,13,0.003915
Junior_Razzmatazz164,17,0,18,6,3,9,14,0.001261
Lets_Kick_Some_Ice,33,0,2,6,0,6,0,0.001324
LogensTenthFinger,13,0,11,11,3,14,14,0.00398
MisfireMillennial,77,0,51,5,2,7,14,0.001852
MrCatfishTheLong,11,0,4,4,2,6,15,0.001898
PoIIux,11,0,16,6,4,10,14,0.002538
RevoltByAllMeans,18,1,6,5,7,12,14,0.003005
Salt-Cover-5444,14,0,9,7,2,9,15,0.003788
Select-Bend2954,39,1,2,2,7,9,13,0.001482
Silon17,16,0,12,12,3,15,16,0.002633
Wayyyy_Too_Soon,11,0,14,4,0,4,0,0.001624
bearington,34,0,33,14,13,27,14,0.003108
db1965,13,0,18,15,0,15,0,0.00411
ergo_incognito,31,0,21,7,3,10,14,0.002038
frederick_the_duck,11,0,12,3,3,6,14,0.001252
infomer,36,1,1,1,11,12,13,0.001028
lasagnaman,14,0,9,5,1,6,15,0.002481
nauticalsandwich,22,0,26,18,8,26,13,0.005253
north_canadian_ice,25,0,11,4,4,8,14,0.001179
steponmedaddies,23,0,38,6,7,13,12,0.003653
sumoraiden,15,0,30,14,6,20,14,0.002784
toomanyshoeshelp,43,0,39,19,13,32,13,0.003116
ultradav24,18,0,51,18,18,36,13,0.004989
watermark3133,13,0,5,6,2,8,15,0.001757
lemickeynorings,18,0,16,6,4,10,14,0.003982
History_Fanatic1993,123,1,11,5,18,23,14,0.000844
Homie_Kisser,25,1,1,0,3,3,12,0
HoneyGlimmerDoll,313,1,0,0,16,16,14,0
WittyProfile,14,0,11,8,5,13,14,0.00064
bigfrondnicky,18,0,7,7,2,9,15,0.000227
Hopeful_Summer5808,64,1,0,0,8,8,11,0
GrapefruitNo9284,13,0,12,7,0,7,0,0.000005
Lmaris,14,0,25,8,4,12,11,0.000029
Hot-Drama-9802,292,1,0,0,16,16,13,0
Aezora,15,0,18,7,0,7,0,0.000794
dr_eh,20,0,22,8,2,10,14,0.002797
Hot-Geologist-4873,49,1,0,0,5,5,11,0
Hot_Cress8314,14,1,0,0,4,4,12,0
Hour-Lettuce-5188,39,1,0,0,4,4,12,0
Hour-Variety-3612,431,1,0,0,8,8,11,0
Codenamerondo1,31,0,32,1,0,1,0,0
WolfChasingTheMoon,14,0,15,1,0,1,0,0
itzmetheredditor,12,0,13,2,0,2,0,0.000093
nacho_hat,25,0,34,1,1,2,4,0
HowardtheFalse,138,1,0,0,19,19,14,0
Huge-Bad-8489,40,1,0,0,10,10,14,0
Hungry-Moose,750,1,1,1,39,40,13,0.000454
ErieHog,30,0,18,12,5,17,14,0.001981
Ivaryzz,20,0,7,5,1,6,14,0.000542
JonnyRobertR,37,0,32,2,1,3,15,0.000252
ML_Godzilla,126,1,6,4,16,20,13,0.000689
Salazarsims,26,0,27,4,2,6,14,0.000358
_Aporia_,12,0,8,3,1,4,14,0.000348
Hunter62610,65,1,0,0,18,18,13,0
SantaClausDid911,17,0,29,17,9,26,13,0.024987
notapoliticalalt,27,0,29,19,9,28,14,0.035488
HunterTop9579,635,1,0,0,16,16,10,0
EnterprisingAss,12,0,15,7,6,13,14,0.001024
Impossible_Disk_43,11,0,6,5,1,6,12,0.000019
Hyhoops,331,1,2,2,54,56,13,0.00128
12_0z_curls,38,0,45,19,14,33,13,0.035763
AtomicNick47,20,0,2,8,0,8,0,0.003445
DickNDiaz,37,0,57,14,12,26,14,0.020756
DinkandDrunk,23,0,18,17,5,22,14,0.015784
Dreadedvegas,26,0,19,11,4,15,14,0.013787
OstentatiousBear,14,0,15,14,6,20,14,0.009654
WonderfulMemory3697,212,1,1,1,36,37,13,0.001437
d0mini0nicco,11,0,8,13,3,16,14,0.025817
edwardludd,12,0,14,6,3,9,14,0.006443
wingsnut25,12,0,18,9,6,15,14,0.009461
Hypoxic_Oxen,184,1,0,0,36,36,13,0
Evil_B2,31,0,29,11,5,16,13,0.022138
MisterMysterios,15,0,22,10,6,16,14,0.02196
geekmasterflash,17,0,9,7,3,10,14,0.008231
wellwisher-1,35,0,40,30,13,43,13,0.05949
IAmNotLindseyNaegle,964,1,0,0,19,19,10,0
DarthEarlthepearl,12,0,1,1,0,1,0,0.000006
RequestSingularity,11,0,18,5,3,8,12,0.000071
IDCJ1234,66,1,0,0,16,16,14,0
Iamnot_hereevery1,33,1,0,0,1,1,16,0
Ibrahim12323,15,1,0,0,2,2,11,0
IceBoxFullOfBeer,410,1,0,0,14,14,13,0
BlooregardQKazoo,17,0,16,9,1,10,16,0.000169
Laceykrishna,14,0,10,4,2,6,15,0.007115
Sea_Researcher7410,11,0,10,3,0,3,0,0.000132
aaeme,17,0,20,5,2,7,16,0.000615
munche,23,0,23,9,4,13,15,0.000755
xfvh,23,0,32,11,10,21,13,0.001527
Iconic_Diva,16,1,0,0,2,2,11,0
Icy_Archer7190,202,1,0,0,25,25,13,0
Odd-Influence-5250,12,0,11,4,2,6,14,0.000574
Thermock,22,0,9,4,0,4,0,0.00125
fallingknife2,11,0,13,8,6,14,14,0.002401
whater39,70,0,71,16,12,28,14,0.007751
yaboichurro11,53,0,25,11,1,12,15,0.00234
Icy_Entry7349,387,1,0,0,13,13,13,0
Dommccabe,17,0,8,2,1,3,13,0.000384
nottrumancapote,11,0,12,2,1,3,15,0.000077
thecelcollector,13,0,8,7,3,10,14,0.000319
Ifyouliveinadream,36,1,0,0,5,5,13,0
AM_Bokke,25,0,19,15,8,23,14,0.019829
Illustrious_Ad_1117,54,1,0,0,9,9,13,0
ApocalypseYay,11,0,7,8,0,8,0,0.002061
stringbeagle,11,0,10,16,5,21,13,0.001744
Imaginary-Key-306,56,1,0,0,2,2,16,0
Imaginary_Bag976,435,1,0,0,22,22,11,0
Lambfudge,11,0,10,5,4,9,14,0.000506
babyimafiend,28,1,4,4,6,10,12,0.000021
Imaginary_Wolf8563,12,3,0,0,1,1,1,0
temoprary123,21,1,6,1,0,1,0,0
ImpalaGala,46,1,0,0,3,3,12,0
Important-Ebb5585,63,1,0,0,10,10,11,0
ImpossiblePudding696,105,1,0,0,5,5,15,0
Impossible_Nebula_20,577,1,0,0,21,21,10,0
Healthy_Brain5354,20,0,20,5,2,7,13,0.000002
made_of_awsm,12,0,3,4,1,5,2,0.000001
Impossible_Plane_192,89,1,0,0,8,8,11,0
Impossible_Rain1662,57,1,2,2,3,5,14,0.000001
IndependenceAgile202,20,1,0,0,5,5,13,0
Independent_Box_8117,120,1,7,3,18,21,14,0.000275
BeginningMedia4738,16,0,19,7,4,11,14,0.001151
zacsxe,12,0,12,3,1,4,15,0.000165
Independent_Guess372,42,1,0,0,6,6,11,0
Independent_Ice_8710,21,1,0,0,4,4,15,0
Major2Minor,12,0,13,9,1,10,16,0.000589
Individual-Dingo9385,61,1,0,0,8,8,14,0
Garblin,22,0,23,12,2,14,13,0.000559
zeptimius,22,2,2,2,4,6,12,0.000224
InfiniteBunnehs,125,1,0,0,8,8,11,0
Infinite_Bluejay_40,21,1,0,0,2,2,12,0
InfoBound,24,1,0,0,5,5,14,0
Informal_Blueberry27,21,1,0,0,2,2,12,0
IngenuityWorking,27,1,0,0,3,3,12,0
InnerCatch532,41,1,0,0,6,6,15,0
Fofolito,13,0,10,9,0,9,0,0.007904
seattleseahawks2014,20,0,37,12,9,21,14,0.001843
Inside_Light_4428,392,1,2,2,14,16,15,0.000928
CANOODLING_SOCIOPATH,11,0,6,1,0,1,0,0.000032
Local_Ad7264,12,0,11,7,5,12,15,0.000852
Space_Pirate_R,11,0,10,3,2,5,15,0.000133
sirthunksalot,17,0,13,2,1,3,16,0.000033
Intelligent-End-9833,36,1,0,0,4,4,11,0
Interesting-Sea4599,37,1,0,0,3,3,11,0
BrokenManOfSamarkand,25,0,13,10,2,12,15,0.002134
ColTwang333,11,0,11,3,1,4,14,0.000446
Kilkegard,12,0,14,7,3,10,14,0.000955
Maximus3311,17,0,16,4,1,5,15,0.000822
Mediocre-Risk3581,13,0,15,4,3,7,14,0.00144
Mediocre_Chemistry41,11,0,6,3,1,4,16,0.000773
Quarter_Twenty,18,0,13,11,6,17,13,0.002681
Routine-Equipment572,12,0,15,8,4,12,15,0.001432
furansisu,14,0,7,8,1,9,16,0.000527
lightmaker918,22,0,14,3,2,5,14,0.000291
nobaconator,14,0,13,5,3,8,15,0.000671
paikiachu,2066,1,9,4,114,118,13,0.008735
rpolkcz,17,0,24,12,7,19,13,0.002592
trolletariat69,19,0,20,7,3,10,15,0.001048
Internal-Board-6809,37,1,0,0,3,3,15,0
IntroductionSalty687,113,1,0,0,8,8,12,0
KingHenry13th,11,0,8,4,1,5,2,0.000163
tetractys_gnosys,214,1,3,4,14,18,12,0.000257
Invariable_Outcome,11,1,0,0,2,2,13,0
InvestigatorItchy270,21,1,0,0,4,4,12,0
Iriisrbb,98,1,0,0,8,8,11,0
IroncladPandora,16,1,0,0,1,1,13,0
It_is_not_that_hard,456,1,0,0,43,43,12,0
CritterFan28,11,0,14,6,5,11,12,0.001053
MountainHigh31,31,0,16,7,3,10,12,0.000579
Nichi-con,13,0,5,3,1,4,12,0.000271
NuYawker,14,0,18,2,1,3,15,0.00016
nope-nope-nope-nop,40,0,35,12,8,20,13,0.013446
Itsholymolyguacamole,173,1,0,0,19,19,13,0
Ready-Recognition519,13,0,14,8,4,12,14,0.001223
Seeker_Of_Toiletries,14,0,15,6,4,10,13,0.001539
JCurtisDrums,58,1,0,0,6,6,14,0
floatable_shark,103,2,1,1,4,5,15,0.000035
JJd3athray,111,1,0,0,8,8,11,0
JStockFL,144,1,0,0,11,11,11,0
mayhembang,12,0,2,3,0,3,0,0.000117
AStealthyPerson,23,0,28,5,3,8,14,0.01234
NaivePhilosopher,12,0,7,8,3,11,14,0.014614
RedApple655321,21,0,13,11,4,15,13,0.013921
Jaguar_AI,72,1,2,1,17,18,13,0.000177
Jncocontrol,31,1,3,1,11,12,12,0.000066
Jamesartfool,176,1,0,0,33,33,12,0
SandyPastor,13,0,5,8,3,11,15,0.001297
molten_dragon,11,0,10,3,1,4,15,0.000248
JarlofDragons,31,1,0,0,3,3,12,0
JasonaCorana,476,1,0,0,38,38,12,0
GuestCartographer,31,0,18,16,1,17,1,0.023274
No_Passion_9819,49,0,50,4,4,8,14,0.003892
medhat20005,19,0,15,9,2,11,15,0.024319
teilani_a,19,0,21,6,2,8,14,0.014881
Jazzlike-Ear-8242,292,1,0,0,15,15,11,0
MrBlizter,24,0,29,4,3,7,12,0.000003
ironwolf56,15,0,8,5,2,7,13,0.000001
JazzyWriter0,93,1,0,0,16,16,13,0
Bantis_darys,23,0,8,7,2,9,13,0.009345
JealousVast3302,72,1,0,0,6,6,12,0
Anameillforge,11,0,14,5,1,6,1,0.000096
Asleep_Region,14,0,11,4,0,4,0,0.000001
JediBlight,73,1,5,2,6,8,14,0.000054
Superdudeo,13,0,11,2,0,2,0,0.000039
JetreL,195,1,2,2,16,18,14,0.002428
BranchDiligent8874,11,0,9,2,0,2,0,0.00042
Wild-Spare4672,15,0,11,4,1,5,17,0.000434
BitterGas69,16,0,29,19,9,28,14,0.005362
Budobudo,11,0,14,5,3,8,14,0.001102
Memignorance,27,0,4,14,3,17,15,0.001068
Ponce2170,19,0,25,11,8,19,13,0.00199
Various_Succotash_79,86,0,107,16,14,30,12,0.001794
Duckney,13,0,5,9,1,10,14,0.008552
Famous-Garlic3838,20,0,21,13,7,20,14,0.023951
InFearn0,14,0,20,15,7,22,14,0.026726
RyloKloon,13,0,7,8,1,9,15,0.02192
Velocity-5348,11,0,8,6,3,9,15,0.013192
shwanky808,11,0,4,1,0,1,0,0.002185
John_F_Oliver,13,1,0,0,1,1,14,0
Chemical_Big_5118,16,0,17,7,2,9,14,0.002056
InfaSyn,33,0,8,7,2,9,16,0.001197
Junior-Wait-2812,23,1,0,0,9,9,13,0
Just_Firefighter8714,21,1,0,0,4,4,11,0
JustinSol2012,79,1,0,0,9,9,14,0
Mother_Welder_5272,16,0,14,11,2,13,14,0.000157
Nimai_TV,11,1,2,1,2,3,15,0.000005
Katarack21,37,1,9,4,7,11,13,0.008954
KazRavenEfreet,77,1,0,0,7,7,14,0
tikkymykk,35,1,7,3,2,5,13,0.000023
Key-Weakness-9509,1081,1,0,0,39,39,13,0
Every_Single_Bee,13,0,15,7,3,10,13,0.002116
Gay_andConfused,28,0,8,5,1,6,2,0.000274
Jolandersson,17,0,13,4,2,6,15,0.000126
LeagueEfficient5945,220,1,6,3,21,24,12,0.002424
Norman_debris,13,0,10,7,1,8,15,0.000875
Particular_Daikon127,15,0,13,2,1,3,16,0.00003
Rombom,55,0,53,11,4,15,16,0.000535
SydowJones,12,0,16,1,0,1,0,0.000029
TheRemanence,11,0,14,6,4,10,13,0.000478
TheThunderTrain,16,0,7,3,3,6,15,0.000032
Trashtag420,12,0,6,2,2,4,3,0.000032
UNisopod,24,0,27,13,5,18,13,0.001168
b0x3r_,13,0,8,5,2,7,15,0.002504
btafd1,20,0,16,3,3,6,16,0.00004
dreagonheart,14,0,9,4,1,5,1,0.000681
honeybee2894,18,0,15,3,0,3,0,0.000054
imperfect9119,16,0,21,2,1,3,1,0.000054
labcoat_samurai,11,0,10,1,0,1,0,0.000029
mcbriza,16,0,10,3,1,4,14,0.000044
noize_grrrl,49,0,4,5,0,5,0,0.000033
noonesine,15,0,3,6,0,6,0,0.000645
redroserequiems,25,0,35,7,6,13,15,0.000487
shivux,18,0,25,9,6,15,14,0.000545
thatVisitingHasher,19,0,12,5,1,6,16,0.000864
twinkie2001,11,0,5,3,0,3,0,0.000036
Key_Host2366,151,1,0,0,18,18,13,0
TheBossOfItAll,38,0,26,7,5,12,13,0.001597
xukly,128,1,7,5,21,26,13,0.000839
Key_Palpitation_7975,60,1,0,0,7,7,13,0
Key_Use_1514,20,1,0,0,3,3,14,0
Kidwhotrystobefunny,75,1,0,0,8,8,12,0
Kimzhal,244,1,6,3,30,33,13,0.000177
WindyWindona,17,0,15,8,4,12,13,0.000792
sumjunggai7,59,1,1,1,12,13,13,0.000143
KindheartednessAny61,17,1,0,0,5,5,13,0
Kittycatcowcow,12,1,0,0,2,2,13,0
Kleos-Nostos,62,1,0,0,6,6,13,0
Konchzapizot,16,1,0,0,2,2,11,0
DelirielDramafoot,29,0,20,6,2,8,15,0.003701
FancyyPelosi,18,0,18,9,8,17,14,0.010085
McCool303,11,0,5,5,1,6,15,0.012463
NOOBFUNK,18,0,12,11,5,16,15,0.017112
True-Grapefruit4042,12,0,4,7,2,9,14,0.008155
Tw1tcHy,34,0,48,19,16,35,12,0.036551
da_ting_go,13,0,15,4,2,6,14,0.008544
equiNine,17,0,25,19,8,27,14,0.0367
goddamnitwhalen,26,0,26,18,7,25,13,0.033704
jethomas5,31,0,62,16,18,34,14,0.034345
zlex,11,0,3,10,2,12,15,0.009742
KungLeon99,56,1,0,0,3,3,12,0
Kwpthrowaway2,54,1,0,0,5,5,16,0
dsteffee,434,3,7,3,71,74,13,0.00029
LAMARR__44,33,1,0,0,3,3,16,0
LUL_Level-Up-Life,27,1,1,1,7,8,13,0.000027
LadyOfTheMorn,419,1,0,0,14,14,14,0
roguesabre6,11,0,10,5,0,5,0,0.000075
Lalalatinas,25,1,0,0,3,3,12,0
LaorDong,82,1,5,3,11,14,13,0.000589
ManufacturerSea7907,26,0,28,12,7,19,13,0.002057
alwaysright0,37,0,51,11,2,13,15,0.001861
Last-Salamander-5537,65,1,0,0,3,3,13,0
Late-Inspector-1664,167,1,0,0,11,11,11,0
Late-Reception-2897,51,1,0,0,17,17,13,0
Pr1mrose,11,0,2,3,0,3,0,0.000355
LaurenNotABot,93,1,1,1,5,6,11,0.000093
LawfulnessActive8358,129,1,0,0,9,9,11,0
Lazy_Analyst3591,12,1,0,0,2,2,2,0
Lazy_Secret4291,80,1,0,0,9,9,13,0
StopStealingMyShit,21,0,19,4,3,7,13,0.007342
Leafy_cookie10,105,1,0,0,7,7,13,0
Leather-Membership90,32,1,0,0,3,3,14,0
Iustis,26,0,25,10,4,14,14,0.016143
arbitrageME,12,0,10,11,4,15,14,0.027704
rigormorty,13,0,12,11,3,14,14,0.007265
LeftyBigback,32,1,0,0,2,2,11,0
Legal-Split-8524,23,1,0,0,2,2,12,0
LegitimateApricot790,44,1,0,0,11,11,14,0
IFightPolarBears,11,0,6,4,0,4,0,0.000983
Slow_Principle_7079,24,0,14,10,0,10,0,0.00151
Lemma_Rhann,80,1,0,0,7,7,11,0
LemonySnacker,139,2,2,5,29,34,12,0.005864
Silent-Storms,17,0,22,9,6,15,14,0.017508
chickadee_1,15,0,15,12,4,16,14,0.002539
LeonardodaVenti,259,1,0,0,4,4,15,0
Ok-Simple5493,32,0,27,3,2,5,15,0.000008
Less-Witness-7101,37,1,0,0,4,4,14,0
LetterheadUpstairs90,452,1,0,0,28,28,13,0
AskingToFeminists,63,0,72,6,4,10,14,0.000489
Down_D_Stairz,27,0,13,12,7,19,15,0.000865
Kolo_ToureHH,11,0,14,2,0,2,0,0.000169
OldSky7061,39,0,33,6,5,11,14,0.000429
Sammy4152015,13,0,14,3,2,5,14,0.000148
SkinnerBoxBaddie,26,0,29,8,4,12,14,0.001821
BackseatCowwatcher,19,0,18,17,7,24,13,0.00459
DarkCrawler_901,14,0,15,3,1,4,15,0.000744
Flapjack_Ace,17,0,11,3,2,5,12,0.001573
Gertrude_D,17,0,18,16,3,19,14,0.016184
Sickeboy,12,0,9,7,1,8,15,0.000778
StevenGrimmas,15,0,12,9,4,13,14,0.001257
VirtualMoneyLover,38,0,56,12,17,29,13,0.002017
vreel_,13,0,11,6,2,8,14,0.005922
LifeConfident6670,567,1,0,0,57,57,12,0
A_Typicalperson,16,0,14,4,2,6,15,0.001884
Dorithompson,12,0,14,4,1,5,15,0.001344
Union_Jack_1,40,0,36,8,6,14,14,0.003244
keyboardwari0r69,11,0,17,7,10,17,14,0.001669
vankorgan,36,0,28,10,4,14,14,0.002199
LilWackmutant,573,1,0,0,16,16,14,0
Story_Man_75,65,0,21,11,6,17,13,0.000488
TFOLLT,21,0,22,8,3,11,13,0.0002
ListenHistorical5518,48,1,0,0,2,2,11,0
Little-Note-8242,171,1,0,0,27,27,12,0
Henrik3443,25,0,35,5,6,11,14,0.000309
PairBroad1763,12,0,9,6,3,9,13,0.000703
LittleJ0hns0n,59,1,0,0,3,3,15,0
MFoy,15,0,5,5,1,6,16,0.000058
OutSourcingJesus,22,0,22,13,1,14,17,0.000382
Lonely_Pride6687,62,1,0,0,4,4,12,0
SunRemiRoman,12,0,8,6,1,7,1,0.000016
Longjumping-Fondant5,241,1,0,0,12,12,10,0
Longjumping_Map_3911,127,1,0,0,11,11,11,0
LoonieF00L27,41,1,0,0,2,2,13,0
LordHamsterWheel,41,1,0,0,9,9,13,0
Loud-Let-4023,24,1,0,0,3,3,14,0
Low-Appearance4875,986,3,0,0,113,113,13,0
Altruistic-Berry-31,14,0,18,4,4,8,15,0.001543
Chinohito,12,0,11,6,3,9,14,0.002106
Content_Doughnut4590,11,0,12,4,3,7,14,0.001631
Kangaroo_shampoo4U,73,0,76,5,2,7,14,0.003034
Of-Meth-and-Men,25,1,4,3,7,10,14,0.00185
TBK_Winbar,33,0,22,10,2,12,14,0.00284
Visible_Pair3017,18,0,23,8,5,13,15,0.00459
Yuo_cna_Raed_Tihs,16,0,17,5,2,7,15,0.00213
athe085,14,0,28,4,3,7,13,0.001866
Low-Forever8802,85,1,0,0,8,8,13,0
Low_Dragonfly3928,35,1,0,0,2,2,16,0
Low_Sort_9301,32,1,0,0,5,5,11,0
Lower-Mirror8797,56,1,0,0,2,2,11,0
hiddenkobolds,42,0,10,7,1,8,17,0.000045
Lucid_World_6764,204,1,0,0,5,5,15,0
improbsable,12,0,11,2,0,2,0,0.000043
Luckpsycho601,149,1,0,0,8,8,12,0
carlosmurphynachos,12,0,2,2,0,2,0,0.000016
Luitpold92,41,1,0,0,3,3,11,0
Lukeract,22,1,1,1,3,4,15,0.000003
LutuVarka,86,1,0,0,1,1,15,0
partypill,835,1,1,1,22,23,14,0
HumanContinuity,20,0,16,9,4,13,14,0.019348
intisun,11,0,6,10,4,14,14,0.011992
jpzorro,158,2,1,1,22,23,13,0.001901
MINGIONOFFICIAL,82,1,0,0,6,6,14,0
Interesting-Shame9,19,0,15,3,1,4,13,0.0026
bearsnchairs,19,0,26,10,6,16,13,0.001276
Macintoshk,64,1,0,0,17,17,13,0
Madotsuki2,84,1,0,0,14,14,13,0
SeeRecursion,19,0,20,4,1,5,15,0.001992
Makapakamoo,47,1,0,0,4,4,11,0
MaleficentBrother187,15,1,0,0,2,2,12,0
ManHasJam,1779,1,0,0,125,125,12,0
AerieStrict7747,11,0,7,5,3,8,15,0.000501
DefiantDistance5844,18,0,10,7,4,11,14,0.001276
Friendly-Many8202,71,0,13,13,1,14,15,0.001238
GkrTV,22,0,27,11,10,21,14,0.00398
Gryffindorcommoner,54,0,55,16,11,27,14,0.017033
LankyEvening7548,31,0,29,6,4,10,15,0.001193
Lopsided_Thing_9474,14,0,14,6,3,9,14,0.001059
NovaCaesarea,15,0,6,7,1,8,16,0.000726
QuiteJam11,11,0,5,2,0,2,0,0.000486
Standupaddict,17,0,15,6,4,10,15,0.009308
TankyRo,12,0,13,4,3,7,14,0.000809
Theycallmeahmed_,19,0,12,8,3,11,14,0.000992
Whatever4M,11,0,11,3,1,4,16,0.000871
Yesyesnaaooo,11,0,2,6,1,7,15,0.000808
anaconda4290,49,0,69,6,9,15,14,0.001151
answer_giver78,13,0,16,5,3,8,16,0.002194
asafg8,20,0,15,6,1,7,14,0.001202
chamacolocal,109,1,1,1,20,21,13,0.000454
hamletswords,28,0,18,9,4,13,14,0.001441
ilGeno,13,0,17,5,3,8,14,0.003016
nar_tapio_00,79,1,2,1,12,13,13,0.000454
testtest867,12,0,12,4,2,6,15,0.001004
turtleduck,19,0,23,5,3,8,15,0.000509
Manfro_Gab,78,1,0,0,10,10,14,0
BarBryzze,19,0,17,3,2,5,16,0.000406
Eldriscp,11,0,12,8,6,14,15,0.007487
EquipmentSpecific262,18,0,24,2,1,3,16,0.000396
KingAggressive1498,26,0,36,11,12,23,14,0.000872
LynnSeattle,25,0,39,14,11,25,12,0.002454
Only____,13,0,12,3,2,5,14,0.0006
Rozenheg,13,0,12,3,2,5,15,0.000976
ShuukBoy,12,0,14,4,1,5,14,0.004637
Sufficient_Run4414,12,0,15,5,4,9,14,0.000655
Trylena,123,0,89,20,14,34,14,0.001392
VikingFjorden,11,0,12,4,2,6,15,0.000991
Worldly-Confusion759,19,0,11,4,2,6,15,0.000988
anarchistright,15,0,17,5,2,7,14,0.001262
angry_cabbie,11,0,12,8,3,11,15,0.002002
heseme,12,0,3,7,3,10,15,0.000687
mauri9998,31,0,38,6,7,13,15,0.000531
ogjaspertheghost,54,0,43,8,6,14,14,0.000525
pinksparklyreddit,11,0,15,6,2,8,16,0.001934
raptor-chan,11,0,14,5,5,10,14,0.000628
MariDob,90,1,0,0,9,9,11,0
Massive-Albatross823,79,9,1,2,7,9,13,0.000043
PitifulEar3303,965,6,1,1,44,45,12,0.000004
ExaggeratedSnails,13,0,15,4,3,7,14,0.000237
Matalya2,1266,1,0,0,128,128,12,0
Background-Key-457,65,0,12,11,3,14,14,0.001281
Cazzah,27,0,13,5,2,7,15,0.000833
JustACWrath,16,0,10,6,3,9,14,0.002489
Landoco,34,0,10,8,1,9,14,0.001608
Purple_Wizard,22,0,23,7,4,11,15,0.002479
Sparrowphone,20,0,27,8,5,13,14,0.00181
ZX52,14,0,6,8,1,9,15,0.001225
erbush1988,17,0,4,7,2,9,15,0.00108
mossed2012,15,0,10,6,3,9,14,0.001067
thatnameagain,20,0,28,10,7,17,14,0.003112
MattCrispMan117,295,1,0,0,8,8,12,0
Maximum-Hotel-1387,13,1,0,0,1,1,13,0
MaxvellGardner,42,1,0,0,4,4,15,0
MeatyQuestions,68,1,0,0,11,11,13,0
Particular-Flan5721,139,2,1,1,24,25,13,0.000109
MenuZealousideal9058,70,1,0,0,10,10,13,0
MessageJealous5740,45,1,0,0,2,2,12,0
MichaelStone987,75,1,0,0,13,13,13,0
Micro_Pinny_360,20,1,0,0,10,10,13,0
Mighty_Melon0909,21,1,1,1,1,2,15,0.000003
NuncErgoFacite,44,0,10,6,1,7,14,0.000398
Dmagnum,18,0,15,9,3,12,14,0.01584
SpockShotFirst,14,0,9,12,2,14,14,0.01518
MilesTegTechRepair,132,1,0,0,25,25,13,0
Mundane-Mud2509,17,0,22,6,3,9,13,0.000833
paadugajala,13,0,12,5,3,8,14,0.001898
Milk_tea14,14,1,0,0,1,1,2,0
Minute-Horse-2009,17,1,0,0,4,4,15,0
Minute_Emphasis_9851,69,1,0,0,2,2,12,0
MisPariss,152,1,0,0,8,8,10,0
Miserable-Tune-9512,40,1,0,0,5,5,12,0
Miserable_Web_775,18,1,0,0,2,2,12,0
MisplacedGithyanki,206,1,0,0,10,10,10,0
FlipFlopFlappityJack,13,0,17,4,4,8,11,0.000007
Mission-Invite4222,2280,1,0,0,45,45,12,0
CanoodlingCockatoo,21,0,46,7,11,18,12,0.000933
Certain_Shine636,15,0,2,4,1,5,14,0.000309
DarthMomma_PhD,12,0,4,1,0,1,0,0.000065
Direct-Bread,16,0,10,6,4,10,14,0.000123
Double_Ad2359,12,0,8,2,1,3,2,0.000078
Fredouille77,11,0,30,11,9,20,14,0.002957
GodMan7777,40,0,45,4,3,7,14,0.000071
Inevitable_Bit_9871,14,0,14,4,3,7,14,0.000078
JerriZA,13,0,4,1,0,1,0,0.000065
No_Emphasis4360,14,0,13,2,1,3,15,0.000065
Pure_Bid2758,20,0,8,3,1,4,1,0.000066
TheMenio,53,1,4,3,6,9,14,0.000105
ahtemsah,126,1,6,4,6,10,14,0.000088
anondaddio,29,0,26,3,1,4,14,0.000104
gc3,11,0,6,4,2,6,15,0.000094
iamnogoodatthis,39,0,8,5,1,6,14,0.000187
roskybosky,21,0,34,5,8,13,13,0.00008
spinbutton,19,0,24,9,6,15,14,0.001568
thatrandomuser1,13,0,20,7,4,11,15,0.000227
Mission_Pen_1201,141,1,0,0,9,9,10,0
Mission_Special242,139,1,0,0,8,8,14,0
thatRoland,11,0,3,1,0,1,0,0.000073
MisterMittens64,104,1,0,0,7,7,14,0
SoggyGrayDuck,20,0,16,15,7,22,13,0.021186
Mobile-Strain1793,371,1,0,0,47,47,13,0
Bonky147,19,0,12,9,3,12,14,0.005737
Crib15,15,0,26,6,4,10,14,0.01423
HiSno,61,0,47,21,8,29,14,0.019825
Irish_Pineapple,30,0,15,10,6,16,14,0.012305
NoOnesKing,12,0,20,14,4,18,15,0.024118
PlantComprehensive77,19,0,20,11,7,18,15,0.018301
_Floriduh_,19,0,15,14,8,22,14,0.017088
MolassesActual4703,2912,1,0,0,51,51,9,0
AltairaMorbius2200CE,12,0,3,3,1,4,2,0.000036
RedPandaReturns,16,0,10,2,2,4,12,0.000026
Royal_Savings_1731,18,0,1,1,1,2,15,0.000026
Salty-Post1717,51,0,1,3,1,4,14,0.000026
ThatBFjax,12,0,4,3,1,4,12,0.000038
ciaomain,25,0,1,2,1,3,13,0.000026
freethechimpanzees,506,1,6,1,15,16,12,0.000026
nattijon,11,0,5,1,0,1,0,0.000026
oldladylikesflowers,26,0,7,2,1,3,15,0.000026
Money-Helicopter-131,64,1,0,0,4,4,15,0
Puzzleheaded_Ant3378,17,0,18,4,3,7,16,0.000359
keepin-it-sleezy,12,0,15,6,4,10,14,0.000916
Mongoose-Best,26,1,0,0,10,10,13,0
MonkSalad1,36,1,0,0,5,5,15,0
Moosetastical,49,1,0,0,12,12,13,0
gentlemantroglodyte,11,0,8,5,2,7,15,0.00304
MoparMan59L,328,1,0,0,59,59,13,0
JoeSavinaBotero,12,0,14,7,3,10,14,0.008049
red-cloud,18,0,9,12,3,15,14,0.015209
Most_Prompt_2342,264,1,0,0,10,10,11,0
lyingdogfacepony66,14,0,8,1,0,1,0,0.000004
MotorNo3642,28,1,0,0,2,2,16,0
Motor_Lizard_9242,476,1,0,0,24,24,10,0
OrthogonalPotato,23,0,13,7,3,10,14,0.000079
j0179664,15,0,12,3,2,5,14,0.000013
MoveMedium9040,57,1,0,0,3,3,14,0
MrProfessorMD,33,1,0,0,5,5,15,0
sophisticaden_,14,0,14,4,1,5,15,0.000453
GoBills585,34,0,22,12,3,15,15,0.001575
KTKannibal,21,0,5,6,2,8,14,0.000409
Laesslie,25,0,23,11,7,18,12,0.00157
Witty-Rabbit-8225,13,0,11,4,1,5,15,0.000865
that_guy_ontheweb,59,1,2,2,13,15,13,0.000512
vht3036imo,15,0,24,7,6,13,14,0.00059
Mr_Isolation,57,1,0,0,2,2,14,0
Mr_Ivysaur,39,1,0,0,16,16,13,0
Doodenelfuego,12,0,14,6,2,8,14,0.00114
Mrooshoo,35,1,0,0,4,4,15,0
MrsFrizzleGaveMeLSD_,144,1,0,0,6,6,15,0
amf_devils_best,12,0,13,7,5,12,15,0.000638
MrsSmiles09,28,1,0,0,5,5,11,0
MsBobbyJenkins,45,1,0,0,2,2,11,0
MsChaCha14,19,1,3,1,1,2,12,0.000281
Much-Bit3531,108,1,1,1,20,21,14,0.007917
truthovertribe,39,0,57,17,16,33,14,0.027111
Much-Necessary7594,20,1,0,0,3,3,12,0
Mundane-Animal-5957,84,1,0,0,6,6,12,0
Muted-War4814,68,1,0,0,2,2,1,0
MyFreshTakeIsTaken,210,1,0,0,14,14,11,0
Firenight083,12,0,4,3,0,3,0,0.000055
IamIrene,13,0,6,3,0,3,0,0.000038
ThatCanadianViking,12,0,9,4,0,4,0,0.000057
Mysterious-Rich3661,54,1,0,0,10,10,14,0
Mysterious_Role_5554,231,1,0,0,26,26,13,0
N9s8mping,872,1,1,1,54,55,12,0.000529
GoldenLiar2,11,0,12,6,4,10,13,0.001028
Hipp0damos,29,0,15,5,1,6,15,0.000572
aintnoonegooglinthat,11,0,5,5,2,7,15,0.005725
j_ved,14,0,1,4,0,4,0,0.000281
mrspyguy,26,0,10,1,0,1,0,0.00025
plantfumigator,14,0,12,4,4,8,14,0.000597
Ragnaroknight,14,0,5,5,1,6,14,0.001043
Narrow-Ad4224,22,1,0,0,2,2,12,0
NateNandos21,56,1,0,0,1,1,17,0
National_Ad_5749,16,1,0,0,1,1,14,0
NaturalTrifle1772,26,1,0,0,6,6,12,0
Negative_Avocado4573,11,1,0,0,3,3,12,0
Negative_y93,65,1,0,0,5,5,11,0
Neither_Exercise9979,50,1,0,0,11,11,14,0
Austin_Peep_9396,14,0,11,13,5,18,14,0.019511
Jealous-Factor7345,19,0,19,6,5,11,13,0.000329
SocksRocksDocks,35,0,36,7,3,10,13,0.000451
charlesth1ckens,18,0,15,10,6,16,13,0.001686
mangongo,20,0,24,6,5,11,13,0.000471
yeahmanbombclaut,16,0,15,5,3,8,14,0.000304
New-Fix6330,33,1,0,0,5,5,11,0
MortifiedCucumber,11,0,9,8,5,13,14,0.000845
New_Wave8749,18,1,0,0,1,1,12,0
Niceotropic,268,1,0,0,35,35,13,0
BuzzBadpants,11,0,14,13,7,20,14,0.025817
KoldPurchase,15,0,13,12,6,18,13,0.008261
MrBackBreaker586,14,0,3,8,1,9,14,0.005625
personAAA,13,0,9,6,1,7,16,0.005419
Nina_Proudman,150,1,0,0,11,11,10,0
InnerBlacksmith1208,24,0,12,1,0,1,0,0.000015
NisInfinite,23,1,0,0,3,3,15,0
No-Cable-1042,26,1,0,0,4,4,13,0
No-Comfort-5669,47,1,0,0,4,4,12,0
No-Direction9565,138,1,0,0,7,7,12,0
Knight0fdragon,21,0,21,3,2,5,13,0
No-Entrance-1017,634,1,2,2,61,63,14,0.014233
AlienReprisal,39,0,17,9,4,13,14,0.009397
CSIBNX,11,0,10,5,4,9,14,0.00257
Cranyx,16,0,18,7,4,11,14,0.019633
Ion_Unbound,12,0,18,9,6,15,13,0.013287
NAINOA-,11,0,2,3,1,4,15,0.002336
RL203,21,0,16,9,4,13,14,0.017882
Ssshizzzzziit,16,0,21,10,7,17,13,0.01531
ides205,29,0,27,9,5,14,14,0.010921
spazatk,15,0,5,6,1,7,14,0.004962
No-Eye-9291,182,1,0,0,8,8,11,0
No-Necessary-7970,33,1,0,0,2,2,16,0
NoConfidence9741,142,1,0,0,2,2,14,0
No_Custom,114,1,0,0,9,9,14,0
No_Implement1511,24,1,0,0,2,2,13,0
No_Lawfulness613,58,1,0,0,4,4,11,0
Norwaytraveller25,14,1,1,1,0,1,0,0.000002
No_Question7801,13,1,0,0,1,1,12,0
No_Sector_459,22,1,0,0,2,2,12,0
No_Tonight7245,14,1,0,0,1,1,11,0
Non-Taken_Username2,33,1,0,0,4,4,12,0
NotoriousInFinit,88,1,0,0,9,9,11,0
Numerous-Guarantee86,26,1,0,0,6,6,14,0
Chronoblivion,17,0,14,8,2,10,15,0.002244
NumerousImplement668,374,1,1,1,57,58,12,0.001451
addicted_to_trash,12,0,13,9,3,12,14,0.020745
cowmix88,17,0,14,12,3,15,15,0.019552
cpatkyanks24,16,0,11,4,2,6,14,0.003066
nanoatzin,17,0,19,15,5,20,14,0.0319
NyankoSensei_uwu,25,1,0,0,4,4,11,0
NyxAsh3nvaldr,33,1,0,0,10,10,13,0
OArdBet,219,1,0,0,30,30,14,0
midnight_toker22,12,0,11,7,5,12,14,0.010395
Objective-Painter-73,17,1,0,0,6,6,14,0
999forever,11,0,3,6,1,7,14,0.015415
AgentMonkey,11,0,10,4,1,5,14,0.013564
BLKSheep93,13,0,1,4,0,4,0,0.008491
BalboaCZ,12,0,12,5,3,8,14,0.011303
Bulugaboy05,13,0,12,3,1,4,16,0.013787
Damnatus_Terrae,11,0,13,6,1,7,14,0.018423
Fuckface_Whisperer,11,0,10,3,1,4,15,0.008802
Jmoney1088,27,0,20,11,6,17,14,0.022863
JohnLayman,12,0,2,4,0,4,0,0.016145
MonaSherry,12,0,14,6,3,9,14,0.014004
Nyrin,18,0,8,11,3,14,14,0.013578
Orbital2,15,0,13,9,3,12,14,0.009993
Responsible-Yak9000,25,0,24,6,7,13,14,0.010165
RonaldTurner88,26,0,27,12,7,19,14,0.016858
Scrutinizer,11,0,2,3,1,4,1,0.008321
The-Polite-Pervert,29,0,20,12,6,18,14,0.022772
The3mbered0ne,561,1,3,2,62,64,13,0.008417
Vic-Trola,30,0,4,8,0,8,0,0.009905
Virtual-Orchid3065,835,5,3,5,99,104,13,0.016243
braindeaths,240,1,16,8,34,42,13,0.013459
dnext,22,0,5,13,0,13,0,0.015144
happy_hamburgers,11,0,5,9,1,10,14,0.012986
ironyinsideme,13,0,14,7,6,13,14,0.011356
looshface,11,0,9,3,1,4,15,0.009701
quizbowler_1,12,0,18,5,1,6,15,0.019387
speedingpullet,19,0,23,10,10,20,14,0.01388
umbren,17,0,20,4,5,9,14,0.012192
wheezyninja,19,0,1,12,0,12,0,0.015659
Odd-Flower2744,262,1,0,0,38,38,13,0
miklayn,11,0,12,4,2,6,15,0.01524
Odd_Profession_2902,534,2,1,1,41,42,13,0.000127
Be-My-Enemy,19,0,19,1,0,1,0,0.000259
Kurati-sa-Kariba,12,0,12,2,0,2,0,0.000343
Stunning_Active_8938,195,1,54,30,31,61,13,0.005045
Tacenda8279,11,0,10,10,4,14,14,0.001706
blitzkrieg_bop,44,1,1,1,12,13,13,0.000259
OddestCabbage,39,1,0,0,7,7,13,0
Ok-Emergency-8248,19,1,0,0,1,1,1,0
Ok-File-6376,119,1,0,0,4,4,11,0
Ok-Rooster-9757,16,1,0,0,1,1,13,0
Ok-Till-3265,21,1,0,0,3,3,14,0
Ok-War-2570,83,1,0,0,7,7,10,0
Ok-Warning-7494,1182,1,9,2,89,91,13,0.000143
1331_1331,13,0,14,4,3,7,15,0.000575
AngryVolcano,25,0,30,8,5,13,14,0.00138
Apprehensive_Fill_35,13,0,7,6,2,8,15,0.000674
IcyRecommendation781,28,0,26,6,6,12,13,0.000682
Sammonov,26,0,24,16,10,26,14,0.019592
Technoxgabber,17,0,16,3,2,5,14,0.000694
denyer-no1-fan,20,0,17,10,5,15,13,0.00169
forkproof2500,18,0,27,7,8,15,15,0.001127
polisharmada33,24,0,19,6,4,10,14,0.001535
poopy050224,13,0,16,2,1,3,14,0.000589
weird_mountain_bug,12,0,4,5,2,7,14,0.001188
yallakoala,16,0,6,6,3,9,14,0.000655
OkAccess6128,48,1,0,0,6,6,14,0
OkOutlandishness5343,97,1,0,0,3,3,12,0
Ok_Airport5887,15,1,0,0,1,1,1,0
Ok_Blackberry_7650,52,1,0,0,7,7,11,0
Ok_Butterscotch_2541,86,1,0,0,6,6,11,0
Ok_Dog9127,41,1,0,0,2,2,15,0
Ok_Skill_1195,27,1,0,0,1,1,16,0
Okfine11111,22,1,0,0,2,2,14,0
Okmanl,74,1,0,0,6,6,14,0
Old_Dragonfly7063,40,1,0,0,6,6,15,0
OldmanonRedditt,21,1,0,0,5,5,12,0
ModernZombies,18,0,11,4,2,6,13,0.000033
OllieDuckling,162,1,0,0,32,32,13,0
reginald-aka-bubbles,12,0,14,6,1,7,15,0.000641
OnceUponATimeIn2023,50,1,0,0,3,3,11,0
One-Present-7873,13,1,0,0,5,5,14,0
OneEstablishment5998,713,1,0,0,12,12,14,0
TheNASAguy,11,0,4,1,0,1,0,0.000018
One_Masterpiece_4412,49,1,0,0,3,3,17,0
Onegra,301,1,0,0,11,11,10,0
PossumJenkinsSoles,20,0,6,2,0,2,0,0.000005
OpenNewt2251,180,1,1,1,27,28,13,0.006761
Cunderwood2020,17,0,9,7,2,9,14,0.012599
Pineapple__Jews,22,1,1,1,8,9,14,0.000944
Opposite-Craft-3498,350,1,0,0,43,43,13,0
Grand_Fun6113,67,0,80,12,7,19,14,0.0028
Pressondude,11,0,13,9,5,14,14,0.001223
ZestycloseLaw1281,11,0,8,6,3,9,13,0.001436
leekeater,12,0,15,8,4,12,15,0.001272
Opposite-Lab6720,23,1,0,0,5,5,11,0
OptionAny5471,314,1,0,0,49,49,13,0
Prince_Marf,227,1,2,1,27,28,13,0.00158
Roselily808,47,0,10,12,1,13,15,0.006146
Orangekale,119,1,0,0,13,13,14,0
Ordinary_Magician_22,223,1,0,0,33,33,13,0
Avaposter,24,0,32,11,7,18,13,0.008252
Origami-Tesseract,59,1,2,1,7,8,14,0.000027
Orygregs,79,1,0,0,23,23,12,0
attlerexLSPDFR,16,0,8,12,3,15,15,0.000586
OutlandishnessNo5091,51,1,0,0,7,7,13,0
Outrageous-Limit-326,44,1,0,0,7,7,11,0
Over_Adeptness_8920,122,1,0,0,8,8,11,0
atotalmess__,11,0,9,4,1,5,1,0.000004
OverpricedGoods,98,1,7,5,19,24,12,0.001451
ChampagneDividends,56,0,51,13,10,23,12,0.001224
Szeto802,632,1,3,2,84,86,12,0.000239
Own-Agent-900,234,1,0,0,49,49,13,0
Bluehen55,19,0,19,15,6,21,15,0.019586
PM_ur_gimpsuit_pics,330,1,0,0,12,12,13,0
Soliae,16,0,4,5,0,5,0,0.000076
UmbraPenumbra,11,0,2,2,0,2,0,0.000404
sirlost33,11,0,3,3,0,3,0,0.00041
POUUER,333,1,0,0,29,29,14,0
PacinoWig,533,1,0,0,65,65,13,0
MKing150,22,0,29,12,9,21,13,0.002303
Muadeeb,11,0,16,3,1,4,15,0.000485
Riflemate,21,0,5,5,2,7,15,0.000384
SillyAlternative420,342,1,1,1,69,70,12,0.00032
SocratesWasSmart,14,0,8,5,2,7,15,0.001997
soldiergeneal,56,0,65,12,8,20,14,0.001783
Panda7001,202,1,0,0,36,36,13,0
Better-Needleworker6,19,0,15,4,3,7,14,0.000476
Paradoxbuilder,116,3,0,0,6,6,14,0
jusfukoff,11,0,5,1,1,2,14,0.000049
ParakeetLover2024,443,4,0,0,51,51,13,0
MaybePrudent3877,15,0,15,4,2,6,15,0.000372
Radish00,30,0,14,9,4,13,14,0.00099
The_White_Ram,12,0,16,7,2,9,14,0.001089
bluepillarmy,361,2,11,10,27,37,13,0.001036
Parking-Cheek2636,16,1,0,0,6,6,13,0
Parking_Extension695,35,1,0,0,3,3,12,0
Parking_Walrus8150,15,1,1,1,5,6,14,0.000899
Particular-Day-542,29,1,1,1,8,9,14,0.000186
Particular_Bit_7728,482,1,0,0,15,15,11,0
ClaraClassy,31,0,22,4,2,6,12,0.000002
Party-Perspective-66,14,1,0,0,4,4,14,0
Party_Manner1860,79,1,0,0,17,17,14,0
DocPsychosis,12,0,7,9,4,13,14,0.012246
Donkletown,12,0,27,4,6,10,13,0.001512
PassageEconomy6005,45,1,0,0,2,2,13,0
Patient_Title_5417,17,1,0,0,2,2,11,0
PeaOk7154,21,1,0,0,4,4,14,0
Fit_Cut_4238,11,0,14,8,6,14,14,0.004739
Peppy_Puppy,17,1,0,0,1,1,18,0
PerceptionHungry7504,85,1,0,0,15,15,13,0
PerceptionSand,106,1,2,3,28,31,13,0.002319
Performer-Left,18,1,0,0,4,4,12,0
Only-Ingenuity7889,49,0,3,4,0,4,0,0.00001
PerformerEmotional25,14,1,0,0,1,1,14,0
PharmPhrenzy,446,1,0,0,52,52,13,0
Simpygoony,230,1,1,1,29,30,13,0.0016
ashkesLasso,11,0,13,3,3,6,14,0.002247
Phineas-Bogg,24,1,0,0,9,9,14,0
KyleDutcher,17,0,18,4,2,6,15,0.004965
Big_P4U,15,0,7,2,2,4,15,0.000148
Key_Zucchini9764,13,0,15,5,2,7,2,0.00036
PiersPlays,13,0,13,4,2,6,15,0.000455
chickpeahummus,24,0,11,4,0,4,0,0.000155
Pitiful_Sea6965,134,1,0,0,7,7,14,0
PM_ME_UR_Definitions,12,0,11,6,0,6,0,0.000088
teflondung,31,0,21,4,3,7,14,0.000213
Planting_For_Peace,25,1,0,0,3,3,12,0
Plenty-Lake922,125,1,0,0,4,4,12,0
Pokoirl,87,1,0,0,5,5,14,0
PoliticsDunnRight,90,1,0,0,16,16,13,0
superskink,11,0,13,6,3,9,14,0.002131
PolybianPrime,32,1,0,0,9,9,12,0
Pop-Bard,31,1,0,0,9,9,13,0
ArtOfBBQ,20,0,28,17,8,25,13,0.003885
Popular_Chip4665,42,1,0,0,1,1,11,0
Potential-Main-8964,103,1,0,0,13,13,13,0
Powerful_Falcon_4006,217,15,0,0,16,16,13,0
Practical_Dinner3481,44,1,1,1,2,3,13,0.000001
Prairiefyre,21,1,2,0,4,4,14,0
Preaddly,31,1,3,3,9,12,14,0.003215
Present-Afternoon-70,35,1,0,0,6,6,13,0
PresentOwn5734,77,1,0,0,20,20,13,0
Prestigious_Mix4418,69,2,0,0,8,8,12,0
LupineVenom,13,0,16,3,2,5,13,0
Pretend-Ad-1439,17,1,0,0,2,2,12,0
TrickyTicket9400,29,0,12,12,2,14,15,0.001243
TuskaTheDaemonKilla,12,0,12,6,1,7,14,0.001068
Professional-Push995,30,1,0,0,3,3,13,0
Professional-Rain402,77,1,0,0,11,11,14,0
ProfessionalEither58,743,1,0,0,66,66,13,0
Deadpoint,23,0,18,7,5,12,14,0.000871
Limmeryc,13,0,16,6,5,11,13,0.001097
crispy1989,16,0,12,7,3,10,15,0.001265
mrGeaRbOx,29,0,30,9,5,14,14,0.00132
ProfessionalMath8873,81,1,0,0,14,14,13,0
Proof-Wolverine2581,886,1,0,0,19,19,10,0
Mysterious_Emu8820,49,0,1,5,0,5,0,0.000003
Persis-,21,0,17,3,3,6,13,0.000025
mt-beefcake,15,0,1,2,1,3,12,0.000002
Proof_Caregiver_4234,16,1,0,0,8,8,13,0
Proof_Strategy2442,3807,1,0,0,42,42,10,0
JeezieB,13,0,1,1,0,1,0,0.000018
Laines_Ecossaises,20,0,1,2,0,2,0,0.000018
Princess-Eilonwy,62,0,26,10,3,13,14,0.000119
body_oil_glass_view,11,0,15,5,0,5,0,0.000067
elbowpit,27,0,4,2,0,2,0,0.000018
maiingaans,15,0,12,2,1,3,14,0.000018
Proof_Wrongdoer_1266,22,1,0,0,5,5,11,0
PropagandaPagoda,72,1,0,0,15,15,13,0
Proper-Possession163,55,1,0,0,4,4,13,0
ClueMaterial,32,0,35,8,6,14,12,0.001918
Frooctose,22,0,21,3,1,4,13,0.000302
Psuedo_FeD,76,1,0,0,3,3,14,0
PsychLegalMind,1925,9,2,0,187,187,13,0
Baerog,12,0,9,9,4,13,14,0.014689
CMShaffer07,14,0,3,8,1,9,14,0.014562
Dapper_Reputation_16,11,0,3,2,1,3,16,0.006425
Emergency_Streets,12,0,10,5,2,7,15,0.012068
Gweena,23,0,20,4,3,7,15,0.007224
Pi6,14,0,12,9,5,14,14,0.015843
RabbaJabba,41,0,39,14,9,23,13,0.021785
Visco0825,351,1,3,4,47,51,13,0.010747
Weyman16,20,0,7,6,3,9,14,0.010443
XGPHero,25,1,2,1,7,8,13,0.005821
jaywst22,24,0,20,5,4,9,13,0.01353
parzival_2377,20,0,7,8,1,9,15,0.008804
popeIeo,37,0,32,10,6,16,14,0.013824
powerboy20,26,0,18,4,2,6,15,0.006941
Psychological_Roof85,94,1,0,0,14,14,13,0
PurplePercentage6342,108,1,0,0,5,5,12,0
Purple_Fault_4231,15,1,0,0,4,4,13,0
Legal-Profile-183,15,0,16,2,0,2,0,0.000747
Puzzleheaded-Web9085,24,1,0,0,5,5,10,0
PuzzleheadedAd9566,74,1,0,0,11,11,13,0
TownAfterTown,27,0,22,9,6,15,14,0.001458
PuzzleheadedEcho6210,12,1,0,0,3,3,11,0
ManliestBunny,15,0,14,3,2,5,15,0.000537
OptimisticRealist__,24,0,17,16,2,18,15,0.005255
isamudragon,18,0,18,2,1,3,16,0.000533
kavk27,11,0,9,2,1,3,15,0.000579
moboticus,12,0,15,10,7,17,14,0.003235
rogthnor,14,0,1,5,1,6,14,0.000807
werewulf35,13,0,13,2,2,4,13,0.000593
Puzzleheaded_Line210,23,2,0,0,2,2,14,0
Q6236,249,1,0,0,16,16,14,0
Quantum-Croissant27,120,2,0,0,10,10,11,0
QuantumQuicksilver,71,1,0,0,15,15,14,0
Queasy-Guidance-6680,34,1,0,0,2,2,13,0
Question1034,33,1,0,0,2,2,12,0
Quouar,41,1,0,0,6,6,14,0
throw-away-doh,19,0,23,6,2,8,15,0.000638
R136a1pks,23,1,0,0,4,4,14,0
chao-pecao,596,1,3,2,54,56,13,0.000143
xwsrx,33,1,3,2,4,6,14,0.003187
RaidersofLostArkFord,149,1,0,0,24,24,13,0
RateTheNews,98,1,0,0,18,18,13,0
smatereveryday,58,1,8,4,14,18,13,0.00038
RationalTidbits,91,1,1,1,13,14,13,0.000292
stex85,16,0,20,3,1,4,15,0.000433
RayasOasis,49,1,0,0,4,4,13,0
RazzlyPatazzly,241,1,0,0,6,6,12,0
ReadingwithMe,200,1,0,0,28,28,13,0
dudemanwhoa,17,0,17,2,0,2,0,0.000259
this_is_theone,348,1,8,6,51,57,13,0.000892
Bingo-Bango-Bongo_,12,0,6,3,1,4,15,0.00029
Realistic-Cost508,44,1,0,0,4,4,14,0
RealisticAd5146,144,1,0,0,28,28,13,0
Realistic_Risk_4721,11,1,0,0,2,2,11,0
Realistic_Writing671,19,1,0,0,8,8,14,0
Reasonable-Toe6556,22,1,0,0,3,3,14,0
Reasonable_Device_58,3074,1,0,0,74,74,11,0
AccordingMedicine129,15,0,11,2,4,6,15,0.000159
Benaholicguy,17,0,8,1,0,1,0,0.000158
BurtMSnakehole,18,0,29,3,3,6,17,0.00016
CanadaGooses,11,0,3,2,2,4,15,0.000166
Chemical-Lunch2175,21,0,9,8,5,13,14,0.000279
DazzlingLanguage5774,53,0,42,5,6,11,14,0.000161
Dependent-Canary-514,36,0,17,4,2,6,18,0.000161
FL_Duff,14,0,12,3,3,6,14,0.000163
Federal-Muscle-9962,39,0,9,9,1,10,1,0.000592
LandImportant,13,0,5,2,2,4,15,0.00016
Minyatur757,21,0,2,4,1,5,15,0.000162
Mr-Lungu,16,0,5,7,1,8,19,0.000181
Nehneh14,12,0,5,1,2,3,15,0.000158
RennietheAquarian,23,0,27,5,7,12,14,0.000164
Significant-Berry-95,11,0,11,3,3,6,14,0.00016
SimonPopeDK,15,0,24,4,3,7,14,0.000162
Stunning-Drawing8240,12,0,15,4,3,7,16,0.000163
TehNudel,13,0,11,6,1,7,15,0.002059
constructioncranes,27,0,14,5,3,8,15,0.000164
ladylondonderry,13,0,12,5,4,9,14,0.000357
mikefick21,21,0,32,3,6,9,16,0.000159
pitmyshants69,14,0,4,3,2,5,15,0.000161
s-b-mac,11,0,18,3,3,6,14,0.000171
vminnear,23,0,5,5,3,8,14,0.000172
RedCamCam,27,1,0,0,3,3,11,0
RedStorm1917,19,1,0,0,6,6,14,0
Reddit-Exploiter,65,1,0,0,9,9,14,0
Relevant-Estimate404,29,1,0,0,2,2,11,0
Remarkable_Edge_7536,325,1,0,0,17,17,12,0
Equivalent_Length719,34,0,31,3,2,5,3,0.000054
Firestorm42222,18,0,21,2,1,3,4,0.000054
GullibleAntelope,11,1,6,2,1,3,4,0.000054
athesomekh,11,0,9,4,2,6,3,0.000076
Remarkable_Sir2279,13,1,0,0,1,1,1,0
RemoteVanilla1934,50,1,0,0,1,1,15,0
RepresentativeAd6489,91,1,0,0,8,8,14,0
Bitter-Assignment464,16,0,18,8,2,10,14,0.00614
Repulsive-Ebb-6934,28,2,0,0,3,3,14,0
Paul-Kersey,13,0,3,3,0,3,0,0.000001
ResidentDry1240,112,1,0,0,27,27,13,0
L3onK1ng,23,0,23,7,7,14,14,0.001057
justanotherthrxw234,11,0,7,4,2,6,14,0.000719
Responsible-Way5056,19,1,0,0,2,2,13,0
Responsible-You8066,19,1,1,1,4,5,14,0.000018
ssjx7squall,88,1,1,1,6,7,14,0.000002
Responsible_Ad_6702,38,1,0,0,5,5,14,0
nichenietzche,74,1,3,3,6,9,14,0.000081
RetepExplainsJokes,23,1,2,1,9,10,13,0.000063
Retro-Digital_,15,1,0,0,2,2,15,0
RetroAristocrat,98,1,0,0,4,4,14,0
Clawless,16,0,8,3,1,4,15,0.000016
anglican_skywalker,13,0,21,1,1,2,16,0.000001
iMac_Hunt,12,0,9,7,4,11,14,0.000731
RevolutionaryHalf170,136,1,0,0,7,7,11,0
RexSmasher,17,1,0,0,7,7,14,0
RhubarbNext1128,13,1,0,0,2,2,13,0
RhubyDifferent3576,92,1,0,0,4,4,12,0
Shadow42184,178,1,1,1,20,21,13,0.000002
Yobama-sama,1375,1,1,1,23,24,11,0.000002
Riddle-Maker,253,1,0,0,18,18,10,0
whorl-,13,0,15,8,4,12,13,0.000885
Right-Refuse-5346,215,1,1,1,22,23,13,0.000369
Jartblacklung,16,0,13,4,1,5,16,0.000806
ccblr06,12,0,6,5,2,7,14,0.000471
Right_Apartment3673,108,1,2,1,5,6,15,0.000061
WildMaineBlueberry87,29,0,25,2,1,3,16,0.000004
Gohab2001,13,0,14,9,5,14,14,0.001591
Rombodawg,55,1,0,0,16,16,13,0
Sevourn,50,0,48,6,5,11,13,0.001066
Delcane,11,0,11,3,1,4,14,0.000257
timeless1991,522,1,24,10,52,62,12,0.00138
Royal_Papaya8694,42,1,0,0,9,9,14,0
Rwandrall3,55,1,0,0,6,6,13,0
Ryuh16,94,1,0,0,11,11,13,0
SKiVRUser,38,1,0,0,6,6,11,0
SabotageFusion1,47,1,0,0,14,14,13,0
SadStudy1993,308,1,0,0,35,35,13,0
6a6566663437,13,0,11,4,1,5,13,0.000361
HeavyDutyForks,16,0,12,11,0,11,0,0.002088
Sad_Ghost14,32,1,0,0,6,6,13,0
Sad_Reserve_1090,17,1,0,0,1,1,16,0
Sad_Shock_6270,46,1,0,0,2,2,11,0
Sad_Wishbone_164,64,1,0,0,1,1,1,0
SaksocuSonic,13,1,0,0,2,2,15,0
Salt_Economy5659,36,1,0,0,1,1,15,0
Samvel_2015,66,1,0,0,10,10,13,0
Sanabubbos,32,1,0,0,2,2,1,0
Saviche888,20,1,0,0,1,1,12,0
ScarcityOk737,15,1,0,0,2,2,4,0
ScaredSalad9051,24,1,0,0,2,2,12,0
Scary_Extension9977,64,1,0,0,7,7,13,0
Scholar__Fit,178,1,0,0,6,6,12,0
mxxncxty,16,0,7,2,0,2,0,0.000016
SchoolAggravating315,159,1,0,0,26,26,14,0
whomda,11,0,10,3,2,5,14,0.005971
ScribeUp_io,22,1,0,0,3,3,15,0
Sea-Objective9094,40,1,0,0,5,5,12,0
Seb_MirJR95,26,1,0,0,1,1,1,0
Secret-Ball7570,159,1,0,0,19,19,13,0
pyramidalembargo,15,0,17,4,2,6,14,0.000525
Secret-Cream-6299,33,1,0,0,7,7,12,0
Secret_Solid8750,20,1,0,0,1,1,2,0
Secure-Performer8914,27,1,0,0,1,1,16,0
Sensitive-Vast-4979,1017,1,0,0,67,67,12,0
Bad_Badger_DGAF,14,0,3,4,1,5,16,0.000348
Poerflip23,13,0,4,4,2,6,15,0.000362
ZhopaRazzi,17,0,16,7,4,11,14,0.002134
Sensitive-Wash-3979,113,1,0,0,10,10,11,0
Serendipity3301,33,1,0,0,12,12,13,0
Puzzleheaded_Buy_921,19,0,10,6,0,6,0,0.00041
Serious-Lobster-5450,568,1,0,0,80,80,12,0
EvilBosom,16,0,5,6,4,10,15,0.005955
TheyGaveMeThisTrain,21,0,13,9,3,12,15,0.013866
ant_guy,11,0,1,7,0,7,0,0.003958
moment_in_the_sun_,34,0,9,4,0,4,0,0.002785
SerpentEmperor,45,1,0,0,3,3,15,0
SevereDev,53,1,0,0,3,3,11,0
Sharp-Button-9863,112,1,0,0,22,22,13,0
Terakian,213,1,1,2,25,27,13,0.000959
Sharp-Tax-26827,21,1,0,0,3,3,14,0
SheOwnz,943,1,0,0,16,16,11,0
Elendel19,14,0,4,1,0,1,0,0.000001
Shifty_Wizard0801,86,1,0,0,3,3,13,0
Shmackback,55,1,0,0,13,13,15,0
Sigmamale5678,285,1,0,0,5,5,14,0
CracklierKarma9,11,0,18,3,1,4,16,0.000238
Cultural-Budget-8866,11,0,13,2,1,3,1,0.000017
Signal-Scene-6,91,1,0,0,4,4,12,0
Significant_Fan5372,77,1,0,0,8,8,11,0
Silentdisco8,675,1,0,0,68,68,13,0
Thtguy1289_NY,11,0,8,4,2,6,14,0.000522
Alien_invader44,16,0,14,6,2,8,14,0.000748
ElegantMankey,20,0,9,7,1,8,16,0.00041
Mysterious_Eye6989,12,0,20,14,7,21,14,0.00545
ow_bpx,20,0,14,4,4,8,13,0.002131
Single_Bowler_724,61,1,0,0,5,5,15,0
Skrtmvsterr,19,1,0,0,2,2,13,0
_Unity-,88,1,3,2,6,8,12,0.000002
Skyshot2,61,1,0,0,1,1,15,0
Sleepy_SpiderZzz,20,1,0,0,1,1,12,0
Slight-Attorney-8214,672,1,0,0,56,56,12,0
AlwaysHigh27,16,0,17,3,2,5,15,0.000264
Broseph_Heller,55,0,27,11,7,18,13,0.001494
Careless_Bat_9226,26,0,27,12,6,18,13,0.001554
JohnFresh669,20,0,16,1,0,1,0,0.000212
cuntpimp,17,0,17,4,1,5,15,0.000444
wishyoukarma,14,0,7,5,2,7,16,0.000241
Slow_Ad_2828,84,1,0,0,4,4,15,0
SnooCalculations2363,17,1,0,0,2,2,15,0
Snoopdigglet,274,1,0,0,25,25,13,0
SoapyCooper,164,1,1,1,26,27,12,0.000304
space_force_majeure,15,0,11,3,2,5,14,0.000648
Soapy_Illusion_13,19,1,0,0,2,2,16,0
SoccerProblem3547,1103,1,0,0,26,26,9,0
Extraslargegordita,11,0,9,1,1,2,1,0.000024
Shoddy-Potential5727,29,0,11,1,0,1,0,0.000024
Youwhooo60,26,0,3,4,0,4,0,0.000036
Solo_Scroller,24,1,0,0,2,2,15,0
Southpaw535,173,1,1,1,11,12,12,0.000018
luckyhunterdude,12,0,12,2,1,3,15,0.000063
SovereignJames,61,1,0,0,6,6,16,0
SovietRusika,221,1,0,0,36,36,13,0
Statman12,17,0,18,7,4,11,14,0.006726
Sovietwannab3,39,1,0,0,8,8,11,0
SpaceySpice,796,1,0,0,74,74,13,0
AVeryBadMon,22,0,20,5,3,8,14,0.004957
FredUpWithIt,20,0,16,5,3,8,14,0.010619
MissMenace101,19,0,58,7,17,24,13,0.005764
Repeatitpete,36,0,20,10,5,15,14,0.005691
SparklingDude_EU,89,1,0,0,5,5,14,0
Tripsy_mcfallover,50,0,24,5,3,8,15,0.000227
SpecialistPie1037,326,1,0,0,9,9,11,0
Helen_A_Handbasket,12,0,10,7,3,10,12,0.000032
Specialist_Oil_9228,35,1,0,0,4,4,11,0
SpeppyBoi1,132,2,0,0,9,9,14,0
Spiritual_Big_9927,48,1,0,0,5,5,14,0
SquareNecessary5767,148,1,0,0,23,23,13,0
helion_ut,21,0,27,4,3,7,13,0.000384
Stock_Gur_5118,27,1,0,0,5,5,15,0
Stock_Serve_3011,40,1,0,0,5,5,14,0
StoodCastle,73,1,0,0,11,11,13,0
Rakhered,35,0,8,8,1,9,12,0.002017
Strict-Bee-5621,283,1,0,0,1,1,1,0
juliaskig,11,0,2,1,0,1,0,0
Strict-Manner5575,42,1,0,0,4,4,13,0
Strong_Prize8778,20,1,0,0,7,7,13,0
Stubert47,44,1,0,0,12,12,14,0
Nick_Beard,113,0,31,16,5,21,14,0.001173
Stunning_Farmer3611,38,1,0,0,5,5,12,0
Style-Afraid,71,1,0,0,6,6,11,0
SubjectHistorian3146,675,1,0,0,16,16,11,0
FullPerspective9406,23,0,2,2,0,2,0,0.000001
Ok-Car-1224,13,0,8,2,0,2,0,0.000003
Substantial-Part4444,355,1,0,0,46,46,14,0
Substantial_Barber88,50,1,0,0,5,5,14,0
WeekendFantastic2941,238,6,2,1,9,10,13,0.000002
Substantial_Push_702,64,1,1,1,4,5,13,0
EmilytheALtransGirl,12,0,14,3,1,4,15,0.000765
Successful-Drive562,80,1,0,0,18,18,13,0
Affectionate_Top340,17,0,21,9,6,15,14,0.010306
Successful_Map4660,87,1,0,0,9,9,12,0
Sufficient-Taro-1166,71,1,0,0,16,16,14,0
Sufficient-Tie-1708,1195,1,0,0,25,25,11,0
EggOkNow,17,0,17,3,3,6,14,0.000024
Human_Ad7946,18,0,4,4,2,6,13,0.000028
kmactane,27,0,3,3,2,5,15,0.000021
Sumiklab,38,1,0,0,5,5,14,0
SuperDamian,41,1,0,0,2,2,13,0
Sure-Start-9303,145,1,0,0,5,5,14,0
SuspectParticular913,63,1,0,0,5,5,12,0
Suspicious_Trick_38,16,1,0,0,3,3,11,0
Swisscheese111,14,1,0,0,4,4,12,0
SyntaxDeleter,160,1,0,0,20,20,13,0
ResidentBackground35,14,0,10,11,6,17,13,0.017814
TheTrueCampor,14,0,17,4,1,5,16,0.000624
jacquidaiquiri,15,0,17,4,3,7,13,0.000708
thebottomblocks,25,0,22,6,3,9,15,0.000498
T-Rex-On-A-Bike,37,1,0,0,5,5,11,0
T_DMac,69,1,0,0,4,4,14,0
Taemojitsu,52,1,0,0,3,3,15,0
TakingNamesFan69,14,1,0,0,1,1,16,0
TankLouie,38,1,0,0,2,2,19,0
Tasty-Slide411,181,1,1,1,4,5,13,0.000002
Tasty-Window,48,2,0,0,6,6,13,0
TastyAd8346,28,1,0,0,1,1,12,0
TastyWillingness4475,38,1,0,0,4,4,14,0
TaylorSwiftian,150,1,0,0,31,31,13,0
Technical-Grocery-19,16,2,0,0,1,1,1,0
Technical-Speech-969,41,1,0,0,8,8,14,0
Tel-aran-rhiod,86,1,0,0,16,16,13,0
JJSF2021,26,0,28,5,2,7,14,0.000452
Temporary-Effect2898,966,1,0,0,21,21,10,0
Temporary_Bug_907,12,1,0,0,1,1,2,0
Temporary_Yam_7774,37,1,0,0,2,2,16,0
HenryWallacewasright,11,0,7,4,0,4,0,0.007625
LingonberryPossible6,24,0,6,11,1,12,15,0.007587
Terrible_Historian58,184,1,0,0,4,4,12,0
TerrorBird47,483,1,0,0,25,25,10,0
FindingNemosAnus,24,0,4,6,2,8,3,0.000053
nikki57,33,0,2,3,0,3,0,0.000042
1-objective-opinion,17,0,19,5,5,10,13,0.001837
6data,14,0,16,5,4,9,14,0.002919
A_Duck_Using_Reddit,59,0,28,13,6,19,14,0.002603
Additional-Coffee-86,13,0,8,7,1,8,14,0.002794
Background_Cause_992,17,0,5,5,1,6,16,0.001554
BrandonLart,17,0,22,6,7,13,12,0.010326
Dazzling_Instance_57,20,0,38,9,12,21,14,0.002762
Decent_Visual_4845,14,0,9,5,2,7,14,0.002845
Hastur13,13,0,7,2,1,3,13,0.001501
InfestedJesus,31,0,2,13,0,13,0,0.002452
Jalphorion1,20,0,15,2,2,4,14,0.001786
Lenyngrad,29,0,29,6,3,9,15,0.002612
Mistybrit,13,0,13,4,4,8,15,0.0024
Ok-Recipe5434,12,0,11,5,4,9,14,0.002078
Riptiidex,25,0,21,7,5,12,14,0.003049
Shmuckle2,23,0,16,5,2,7,15,0.001568
TheMCMC,11,0,10,6,3,9,14,0.010443
john2218,11,0,6,3,3,6,14,0.00173
land_and_air,11,0,14,2,1,3,15,0.001487
lists4everything,15,0,9,7,3,10,14,0.003546
stolt,46,0,1,10,0,10,0,0.001896
ladygrinningsoul1973,1653,1,3,3,82,85,12,0.000277
The-Divine-Ms-M,43,1,0,0,1,1,12,0
SpecialistBet4656,14,0,31,4,5,9,14,0.000588
The-zKR0N0S,412,1,0,0,33,33,13,0
PetiteDreamerGirl,11,0,11,1,1,2,14,0.002361
TheAlmostGreat,37,1,0,0,10,10,13,0
TheAverage_American,177,1,0,0,16,16,13,0
Royalfatty,11,0,11,3,2,5,15,0.000782
Seyon,11,0,9,5,3,8,14,0.004832
fps916,15,0,15,3,2,5,14,0.00463
nerojt,28,0,32,8,7,15,14,0.002616
TheFinnishChamp,62,1,0,0,11,11,13,0
TheFreshHearth,67,1,0,0,5,5,12,0
DaEccentric,18,0,17,3,2,5,14,0.000448
DrunkAlbatross,13,0,12,2,1,3,15,0.000458
GloomyButterfly8751,28,0,28,7,4,11,15,0.000968
GunMuratIlban,13,0,14,4,1,5,15,0.000767
Hugo28Boss,14,0,11,5,2,7,14,0.001047
LongjumpingSeaweed36,17,0,14,2,1,3,15,0.000422
McMetal770,14,0,9,5,3,8,13,0.001057
basedaudiosolutions,36,1,1,1,7,8,14,0.0004
mpshumake,33,1,2,2,3,5,14,0.001121
nidarus,22,0,20,9,6,15,13,0.001324
TheLexus_,87,1,2,0,19,19,13,0
TheMagnuson,178,1,0,0,6,6,13,0
ThePatriotAttack,42,1,0,0,5,5,13,0
TheProblemWithUs,82,1,0,0,6,6,14,0
TheSnazzySharky,46,1,0,0,8,8,13,0
TheTripodLegend,146,1,0,0,10,10,12,0
gburgwardt,33,0,33,9,7,16,14,0.01285
The_Egalitarian,682,2,1,0,90,90,13,0
HazelCheese,18,0,16,3,2,5,15,0.003385
jamiebond,12,0,2,6,1,7,15,0.00336
The_Shock_Factor,48,1,0,0,9,9,10,0
Thedefiantmessenger,626,1,0,0,23,23,10,0
Various-Ocelot-2209,33,0,7,7,0,7,0,0.000011
milly_moonstoned,19,0,12,4,3,7,13,0.000007
wecouldhaveitsogood,16,0,11,4,2,6,12,0.00001
Then_Alternative4318,11,1,0,0,3,3,11,0
Then_Carpenter2851,262,1,0,0,14,14,11,0
AOWLock1,31,0,28,5,2,7,14,0.000606
Kitchen-War242,16,0,23,7,1,8,15,0.002523
PhysicalWave454,16,0,11,3,2,5,15,0.000344
Upstairs-Extension-9,12,0,6,4,1,5,15,0.000773
michaelas10sk8,16,0,14,4,4,8,14,0.000364
Theo04t,44,1,0,0,5,5,15,0
ThisIsYourAnonAcct,28,1,0,0,10,10,13,0
ricknightwood13,78,1,10,5,19,24,13,0.000552
ThoraxLover,27,1,0,0,4,4,12,0
Throawayhaibhai,879,1,0,0,100,100,12,0
AlkatrazzPrime,28,0,29,5,3,8,14,0.000847
Famous-ish,13,0,13,4,2,6,13,0.001159
ThrowRA-drowning123,14,1,0,0,4,4,11,0
ThrowRA-richpoor,290,1,0,0,16,16,10,0
let_me_know_22,18,0,3,7,1,8,16,0.00148
ThrowRA1261626,31,1,0,0,4,4,11,0
ThrowRAgoldenbride,202,1,0,0,6,6,10,0
Throw_Away68127,37,1,0,0,5,5,11,0
Thunderbird93,13,1,0,0,1,1,15,0
Padonogan,14,0,22,5,4,9,14,0.008631
Rynex,29,0,7,12,3,15,15,0.017377
Your__Pal,19,0,3,10,0,10,0,0.019652
Timelord_Omega,12,1,0,0,2,2,14,0
Tiny-Bookkeeper3982,18,1,0,0,6,6,14,0
Tiny-Detail5789,12,1,0,0,2,2,12,0
Todisfreakingcool,371,1,0,0,16,16,9,0
Commercial_Blood2330,11,0,8,6,1,7,16,0.00059
Medical_Water_7890,19,0,6,3,0,3,0,0.000012
Toh97,25,1,0,0,2,2,16,0
TomatoClown24,311,1,0,0,34,34,12,0
ToothNo6373,40,1,0,0,5,5,13,0
Total_Escape_9778,2201,2,1,3,159,162,12,0.000338
BigMcLargeHuge8989,17,0,12,4,3,7,14,0.001011
Financial_Change_183,20,0,11,5,3,8,14,0.00097
Finklesfudge,14,0,16,7,6,13,13,0.001558
Massive_Wealth42069,13,0,12,4,3,7,13,0.000909
Nate-dude,12,0,12,5,2,7,13,0.001158
Thriftless_Ambition,21,0,22,10,7,17,13,0.010417
VivaLaRory,12,0,14,3,2,5,14,0.000905
argument___clinic,40,0,3,16,0,16,0,0.001666
courtd93,29,0,30,10,7,17,11,0.001957
crazy_cookie123,16,0,3,6,3,9,13,0.001086
dinjamora,18,0,4,10,3,13,14,0.001547
marzaksar,15,0,14,4,2,6,13,0.000892
ulvisblack,11,0,5,7,3,10,14,0.000974
username_blex,32,0,26,7,11,18,13,0.000929
ToxicLittleBear,16,1,0,0,1,1,11,0
Traditional_Crew6617,44,1,0,0,7,7,13,0
Traveledfarwestward,26,1,0,0,4,4,13,0
TravisNotScott,41,1,0,0,6,6,14,0
Tricky_Warning4152,51,1,0,0,4,4,11,0
TrinityBrinity,122,1,0,0,14,14,10,0
Tripleawge,230,1,0,0,30,30,13,0
Tris_notsayingname,95,1,0,0,5,5,11,0
True-Half-1746,27,1,0,0,2,2,11,0
arseholierthanthou,15,0,5,2,0,2,0,0.000001
Trusty-McGoodGuy,49,1,0,0,7,7,14,0
Unable_Storm_4357,24,1,0,0,1,1,14,0
UncleVolk,53,1,0,0,12,12,14,0
UndergroundFlaws,710,1,0,0,11,11,14,0
IgnoranceIsShameful,23,0,19,2,1,3,15,0.000037
Unusual_Custard4195,163,1,0,0,6,6,12,0
UpsetPhilosopher862,40,1,0,0,12,12,14,0
Upstairs-Insurance61,85,1,0,0,8,8,13,0
User9865465158,166,1,0,0,9,9,11,0
Username-17,85,1,0,0,11,11,13,0
Utopia_Builder,54,1,0,0,13,13,13,0
UzumakiBarrages1,22,1,0,0,1,1,14,0
Valid_Username69,52,1,0,0,6,6,15,0
ValoNoctis,143,4,0,0,36,36,13,0
Valuable-Owl-9896,55,1,4,3,13,16,13,0.000625
Verac10us,23,1,0,0,2,2,15,0
Veruminate,48,1,0,0,12,12,14,0
VictorianAuthor,111,1,1,1,6,7,13,0.000257
Viking18l,155,1,0,0,4,4,12,0
Vinduesvisker,47,1,0,0,2,2,16,0
Vir_Norin,28,1,0,0,3,3,15,0
Virus_infector,2893,2,0,0,74,74,11,0
BigWhiteDog,19,0,9,1,1,2,15,0.000348
Certain-Definition51,22,0,13,5,3,8,15,0.000602
KittyQueen63,84,0,50,8,5,13,15,0.000664
Obsessive0551,11,0,13,6,4,10,15,0.000977
OneEye3360,12,0,10,5,4,9,14,0.00085
PipingTheTobak,13,0,12,3,1,4,18,0.000375
SystemOfATwist,12,0,7,4,4,8,17,0.000352
YNABDisciple,64,0,24,6,3,9,16,0.001298
ewazer,283,1,1,1,45,46,13,0.000348
ucotcvyvov,25,0,19,4,1,5,15,0.000372
VisibleLoan7460,43,1,2,1,8,9,13,0.000177
Visible_Adagio_3963,74,1,0,0,5,5,11,0
Vitor_471,32,1,0,0,5,5,12,0
Vivid_Fix_8164,39,1,0,0,2,2,13,0
WE_ARE_V3N0M,38,1,0,0,1,1,11,0
WIBTAFORTHISONE,31,1,0,0,1,1,15,0
Warm-Accountant-6553,43,1,0,0,9,9,10,0
Warm_Anxiety_7379,2047,1,0,0,132,132,12,0
Easy_Masterpiece_605,53,0,19,10,3,13,15,0.001031
MrNumber0,11,0,2,4,2,6,15,0.00065
Overall-Ratio-1446,35,0,39,7,10,17,12,0.00068
Powerful-Union-7962,21,0,8,4,0,4,0,0.000615
TheGhostofJoeGibbs,19,0,16,7,4,11,14,0.000677
arrogant_ambassador,33,0,19,10,4,14,14,0.000903
dontreallyknoww2341,167,1,1,2,21,23,13,0.000531
michaelcanav,17,0,13,6,3,9,14,0.0009
redthrowaway1976,14,0,8,9,6,15,14,0.001189
Water-Majestic,17,1,0,0,1,1,11,0
Marston_vc,15,0,5,5,4,9,14,0.005634
YakCDaddy,18,0,21,5,2,7,14,0.005101
Weak_Ad1836,19,1,0,0,2,2,13,0
Weird-Interaction370,21,1,3,1,2,3,13,0.000002
toptierverbatim,64,1,1,1,7,8,12,0.000001
Weirdojellyfish,101,1,0,0,1,1,2,0
WendyDarling989,497,1,0,0,25,25,10,0
Bartok_The_Batty,13,0,22,3,0,3,0,0.000016
_Calmarkel,11,0,15,1,1,2,13,0.000004
captainwhatserface_5,19,0,13,3,1,4,1,0.000004
WestFactor6649,13,1,0,0,2,2,13,0
strongerthenbefore20,488,10,1,1,22,23,12,0
Western-Volume2676,28,1,0,0,3,3,13,0
WhatsUpSkaters,167,1,0,0,28,28,13,0
WildHuck,23,1,0,0,2,2,12,0
Wildthings501,863,1,0,0,15,15,10,0
Wine_Gum1,133,1,0,0,22,22,13,0
Winsas,19,1,0,0,1,1,15,0
Winter-Ad4608,100,1,0,0,6,6,13,0
Witty_Possibility_41,50,1,0,0,3,3,14,0
Wonderful-Food1274,401,1,0,0,36,36,13,0
Paradoxe-999,29,0,36,8,9,17,13,0.000539
Wonderful_Nature_167,16,1,0,0,3,3,11,0
Worried_Mirror605,13,1,0,0,1,1,12,0
Worth-Recognition808,17,1,0,0,1,1,12,0
Would-Be-Superhero,27,1,0,0,2,2,15,0
Wrinkyyyy,100,1,0,0,13,13,13,0
PrecisionHat,19,0,24,11,8,19,13,0.001417
WulfyTheMuffin,122,1,0,0,5,5,14,0
XDeathBringer1,14,1,0,0,1,1,16,0
XxItsNowOrNever99xX,89,2,0,0,8,8,13,0
Woah_Mad_Frollick,14,0,14,2,0,2,0,0.000046
Yahallost,83,1,0,0,19,19,13,0
Yellow_Squeezer,63,1,0,0,4,4,14,0
BeeVegetable3177,34,0,2,5,0,5,0,0.000068
BillyBobJangles,14,0,15,2,4,6,15,0.000061
Ok-Question1597,13,0,12,2,1,3,16,0.000061
PsilosirenRose,11,0,9,1,0,1,0,0.000061
YogurtProductions,255,1,0,0,31,31,11,0
enterthewoods1,20,0,20,2,1,3,15,0.000246
YugiohXYZ,208,1,1,1,24,25,12,0.000212
ZLCZMartello,50,1,1,1,14,15,13,0.000278
Zealousideal-Bee5320,29,1,0,0,3,3,11,0
ZealousidealLog7959,25,1,0,0,4,4,12,0
Zealousideal_Mark647,16,1,0,0,2,2,14,0
Zealousideal_Sky5722,46,1,0,0,9,9,13,0
Zeppelinman,71,1,0,0,4,4,14,0
Zestyclose-Bowl-3938,35,1,0,0,7,7,11,0
Zestyclose-Paper-201,128,1,0,0,10,10,11,0
Zestyclose_Slip_5150,29,1,0,0,5,5,11,0
Zoma456,180,1,0,0,25,25,13,0
Old-Pear9539,11,0,10,4,3,7,13,0.000518
ZultaniteAngel,53,1,0,0,2,2,16,0
Zyrann,48,1,0,0,2,2,12,0
Oxidopamine,12,0,3,7,0,7,0,0.009393
Slicelker,13,0,10,10,3,13,14,0.016646
StrategistEU,13,0,8,7,2,9,14,0.012349
Zestyclose-Cat-1093,14,0,21,4,4,8,14,0.007668
davida_usa,53,1,3,4,13,17,14,0.008655
firewatch959,23,0,27,5,8,13,13,0.009589
turbografx_64,15,0,16,3,3,6,12,0.007128
xtra819,19,0,26,6,7,13,14,0.012807
_Spoxie_,21,1,0,0,1,1,12,0
___Cyanide___,111,1,0,0,15,15,11,0
___krunchy___,32,1,0,0,11,11,13,0
_alpinisto,268,1,0,0,41,41,13,0
ablativeyoyo,41,1,0,0,10,10,13,0
mnoodleman,14,0,15,6,3,9,14,0.001038
adante111,25,1,0,0,13,13,14,0
aespaste,116,2,0,0,25,25,13,0
Kangaroo_80,24,0,5,8,2,10,14,0.002016
ahaha2222,81,1,0,0,13,13,13,0
aikkkkk,54,1,0,0,4,4,12,0
aitneux,786,1,0,0,29,29,14,0
Correct_Cupcake_5493,67,0,39,6,3,9,15,0.00042
albh05,180,1,0,0,30,30,14,0
aloo-ka-paratha,496,2,1,1,59,60,13,0.000403
ambrosebrando,15,1,0,0,1,1,2,0
ananeedshelps,981,2,0,0,70,70,13,0
FlashMcSuave,13,0,6,7,0,7,0,0.001902
Spite-Organic,24,0,14,4,5,9,13,0.000318
VPackardPersuadedMe,15,0,12,3,1,4,15,0.000408
angshaojun08,14,2,0,0,1,1,12,0
anonbrowzinlol,414,1,0,0,8,8,11,0
anonymouscardboard,13,1,0,0,2,2,16,0
antobantoo,16,1,0,0,2,2,13,0
asklepios7,64,1,0,0,9,9,13,0
aszymier,61,1,0,0,16,16,14,0
azqwa,83,1,0,0,14,14,13,0
badouche,55,1,0,0,18,18,13,0
bambucks,990,2,0,0,129,129,12,0
FinalSealBearerr,34,0,46,12,11,23,13,0.005651
soozerain,1912,2,3,2,118,120,11,0.003973
basilbabyy222,64,1,0,0,3,3,11,0
bbppbbpp,49,1,0,0,3,3,1,0
bdhjsj,35,1,0,0,1,1,13,0
bellabelleell,178,1,0,0,6,6,11,0
betterlogicthanu,162,1,0,0,15,15,14,0
bg-peole,153,1,0,0,5,5,13,0
Former_Indication172,13,0,10,6,4,10,15,0.001138
Slight-Improvement84,17,0,15,2,1,3,17,0.000002
bgoodwin956,331,2,0,0,44,44,13,0
bibimbapbapp,32,1,0,0,1,1,2,0
bivox01,27,1,0,0,3,3,16,0
bliznitch,206,1,0,0,33,33,13,0
Samanthacino,12,0,12,3,2,5,14,0.000157
McAlpineFusiliers,21,0,22,2,0,2,0,0.00026
blueredscreen,55,1,0,0,12,12,13,0
bonniesbunny,14,1,0,0,1,1,15,0
bornintowinter,131,1,0,0,21,21,13,0
Beneficial-Set2738,27,0,31,4,4,8,14,0.000988
Distinct-Temp6557,15,0,14,6,4,10,14,0.001028
Fattyboy_777,11,0,20,5,7,12,14,0.002258
No-stradumbass,18,0,19,3,4,7,14,0.000962
WanderingAlienBoy,12,0,12,9,8,17,14,0.002115
lemonbottles_89,862,1,1,2,65,67,13,0.000901
sh1tpost1nsh1t,12,0,11,3,1,4,15,0.001003
silverpixie2435,15,0,27,4,5,9,14,0.000958
bubbleluna6718,74,1,0,0,4,4,11,0
bunchesandcrunches,139,1,0,0,7,7,14,0
burner187_,184,1,0,0,10,10,10,0
bxrcx,25,1,0,0,2,2,2,0
c_mad788,143,1,1,1,22,23,13,0.000088
satanic_androids,11,0,11,3,3,6,14,0.000337
cakezoncakez555,33,1,0,0,8,8,14,0
onefourtygreenstream,12,0,9,3,2,5,14,0.000144
camport95,25,1,0,0,6,6,14,0
capribskd6,14,1,0,0,3,3,10,0
capybarafanpage69,80,1,0,0,3,3,12,0
carrotbae0,25,1,0,0,3,3,11,0
carrotman19978,72,1,0,0,4,4,12,0
helpprogram2,15,0,15,3,1,4,13,0.000369
cassavasyams,40,1,0,0,5,5,15,0
casti3l9_18,15,1,0,0,1,1,12,0
causticjalapenos,20,1,0,0,4,4,16,0
champdude17,64,1,0,0,5,5,16,0
Individual_Row_2950,18,0,20,2,2,4,15,0.000189
JefeRex,18,0,20,6,2,8,15,0.000286
miahmagick,11,0,2,5,0,5,0,0.000573
chasemnay,15,1,0,0,1,1,12,0
jedisushi72,11,0,14,3,2,5,13,0.008894
rethinkingat59,13,0,9,6,2,8,15,0.001525
cheeseplatesuperman,311,1,0,0,29,29,13,0
I_lie_on_reddit_alot,12,0,2,4,0,4,0,0.000437
Past_Scholar3723,13,0,18,3,4,7,14,0.000133
cheesyminecart,23,1,0,0,1,1,14,0
chewie_questionmark,22,1,0,0,3,3,12,0
chezdor,142,1,0,0,11,11,13,0
chorizard9,221,2,0,0,37,37,13,0
PlayfulRemote9,12,0,18,5,4,9,14,0.000504
cinnamondulce86,14,1,0,0,2,2,11,0
climbing_account,143,1,0,0,34,34,13,0
ignoreme010101,20,0,28,6,5,11,14,0.00065
clockwerkgnome,74,1,0,0,17,17,13,0
coconut__moose,171,1,1,1,32,33,13,0.00068
coffeecuponmydesk,660,1,0,0,71,71,13,0
Best_Pants,19,0,17,6,4,10,14,0.00048
PerAsperaDaAstra,18,0,19,3,2,5,14,0.000368
colepercy120,657,7,0,0,119,119,12,0
Honest_Initiative471,12,0,21,6,6,12,14,0.002336
colourful_bagels,12,1,0,0,1,1,2,0
conceredworker345,844,1,0,0,73,73,12,0
Heavy-Top-8540,11,0,19,6,7,13,14,0.001204
corbynista2029,58,1,0,0,12,12,13,0
daddygirl_industries,54,1,0,0,2,2,15,0
daplaya9,23,1,0,0,3,3,14,0
darkendknigt,17,1,0,0,2,2,14,0
deathvidal,172,1,0,0,24,24,13,0
elocin1985,14,0,11,10,3,13,14,0.000893
deviantcowards,38,1,0,0,6,6,14,0
tinyhermione,21,0,26,3,1,4,13,0.000336
dingesthecat,56,1,0,0,2,2,11,0
discreetPeach2979,53,1,0,0,5,5,13,0
disharmonic_key,74,1,0,0,14,14,13,0
the_buddhaverse,12,0,16,2,2,4,14,0.004241
doremipasol123,48,1,0,0,11,11,13,0
dorkynerdgirl2004,11,1,0,0,4,4,12,0
garaile64,201,4,1,1,36,37,13,0.000074
Irdes,29,0,31,7,7,14,14,0.002087
dub47,19,1,0,0,3,3,14,0
ebbybaeby,24,1,0,0,2,2,2,0
effervescentpapaya,23,1,0,0,1,1,14,0
efg444,59,1,0,0,13,13,14,0
eirikouu,34,1,0,0,1,1,2,0
ellieee-luvsA,98,1,0,0,6,6,11,0
ellxie_fox,33,1,0,0,1,1,15,0
emergent_convergence,131,3,0,0,10,10,14,0
emmashhh,106,1,0,0,2,2,11,0
ensodi,177,1,0,0,23,23,13,0
Doxjmon,12,0,14,4,2,6,14,0.001484
ergeorgiev,51,1,0,0,12,12,14,0
eun_jeong,20,1,0,0,1,1,12,0
eviierose,21,1,0,0,2,2,13,0
Miles_vel_Day,16,0,11,11,6,17,14,0.014738
exploitedgecko,59,1,0,0,5,5,12,0
extraaccountforporn1,107,1,0,0,11,11,13,0
Mrs_Noelle15,14,0,10,5,3,8,14,0.000211
falfai_effect,24,1,3,3,2,5,12,0.000295
fart439,356,1,0,0,9,9,14,0
Specialist-Rise1622,38,0,18,4,1,5,1,0.000122
Symbiotic_flux,17,0,14,2,1,3,1,0.000033
bigsquirrel,11,0,6,3,2,5,14,0.000127
fcoterroba,78,1,0,0,7,7,13,0
Longjumping_Meal_151,12,1,2,1,1,2,18,0.000009
fendoria,39,1,0,0,11,11,14,0
ferrariwdc,37,1,0,0,6,6,10,0
finally_free234,32,1,0,0,9,9,12,0
flowerpower2009,122,1,0,0,3,3,12,0
follower_of_yohma,459,1,0,0,49,49,12,0
foodfriend,169,1,0,0,35,35,13,0
foreverknot13,36,1,1,0,3,3,12,0
funnyIlaugh,39,1,1,1,15,16,13,0.000023
Osr0,13,0,10,6,2,8,15,0.00065
gatuflow,32,1,1,0,1,1,1,0
ginamarie1986,898,1,0,0,24,24,10,0
Netlawyer,11,0,5,1,0,1,0,0.000004
goldwoolf,69,1,0,0,3,3,11,0
googolbyte_91,41,1,0,0,3,3,15,0
gruninuim,243,1,0,0,40,40,13,0
gtavi_pixelblower,188,1,0,0,28,28,13,0
h4rpyhare,241,1,0,0,11,11,11,0
happy_witcher,57,1,0,0,9,9,14,0
harikrishnanpa,49,2,0,0,2,2,16,0
helloworldxddcc,19,1,0,0,8,8,14,0
hhjmk9,43,1,0,0,13,13,13,0
hongkong3009,160,1,0,0,30,30,12,0
horizonsystem,108,2,0,0,6,6,14,0
hundredandoneeyes,85,1,0,0,9,9,13,0
iND3_,16,1,0,0,4,4,15,0
i_memine,116,1,0,0,4,4,15,0
iam_Saurabh21,125,1,0,0,26,26,13,0
icantstanditany,116,1,0,0,5,5,11,0
ifitisntconnor,146,1,0,0,43,43,12,0
jey-GMCB,71,1,1,1,18,19,13,0.000234
im-so-sorry-himiko,47,1,0,0,1,1,15,0
infinitely15,30,1,0,0,1,1,16,0
internetcreed,42,1,0,0,2,2,16,0
interstellardisco,186,1,0,0,9,9,10,0
ireallydontcareifiam,23,1,0,0,1,1,16,0
iwatchcredits,107,1,0,0,20,20,13,0
jEG550tm,38,1,0,0,3,3,16,0
jackietea123,39,1,0,0,15,15,13,0
jaminfine,226,1,0,0,21,21,13,0
jaytee319,110,1,0,0,28,28,14,0
jazzygirl0908,18,1,0,0,1,1,1,0
jcarunningman,27,1,0,0,5,5,15,0
jkpatches,42,1,0,0,10,10,14,0
jo__ba,46,1,0,0,6,6,13,0
johnmangala,79,1,0,0,22,22,11,0
josquepo,25,1,0,0,4,4,15,0
jpcapone,197,1,0,0,33,33,13,0
kidcudi115,11,0,13,2,1,3,14,0.002681
jrandall1017,234,1,0,0,21,21,13,0
jujuondatbeat619,11,1,0,0,1,1,1,0
juniibunni,15,1,0,0,2,2,13,0
kacchans_husband,11,1,0,0,2,2,11,0
kaiana_,40,1,0,0,2,2,11,0
bobthebreeder42,11,0,8,3,1,4,15,0.00008
kasebrotchen,69,1,0,0,6,6,14,0
kaseysmasher,17,1,0,0,3,3,11,0
kaushal96,21,1,0,0,3,3,15,0
kgrace78,52,1,0,0,1,1,15,0
kiLLercactus24,32,1,0,0,4,4,12,0
kylefsu32,856,1,0,0,23,23,9,0
AlabasterPelican,15,0,11,5,2,7,13,0.000357
Critical-Buy-8677,24,0,22,6,4,10,13,0.000438
Disastrous_Onion_958,26,0,32,3,2,5,13,0.00032
IllIlIlIlIlIll,12,0,11,2,1,3,13,0.000314
Iricliphan,20,0,14,3,2,5,15,0.000253
Key_Ingenuity_4444,12,0,11,2,1,3,13,0.000314
Scooney92,14,0,13,3,1,4,14,0.000279
SilverTumbleweed5546,16,0,15,4,2,6,13,0.000611
The_Zacain,17,0,21,3,2,5,14,0.000277
dachuggs,14,0,13,3,1,4,14,0.000255
languageinfinity,142,5,0,0,10,10,12,0
latassalouni,35,1,0,0,3,3,11,0
latruce,135,1,0,0,6,6,12,0
lavender_and_lilies,51,1,0,0,4,4,11,0
lefrogo,16,1,0,0,3,3,12,0
legendarykam,36,1,0,0,3,3,15,0
sylar999,29,1,1,1,2,3,15,0.000001
lelelalon,36,1,0,0,5,5,12,0
lesbianspider69,106,1,0,0,12,12,13,0
lets_clutch_this,34,1,0,0,9,9,14,0
lieutenantseaanemone,30,1,0,0,2,2,14,0
Ok_Beat9172,18,0,11,4,2,6,15,0.00022
literature43,133,1,0,0,9,9,13,0
llisa1175,113,1,0,0,12,12,10,0
lnkuih,23,1,0,0,1,1,15,0
lo_stronzo,501,1,0,0,18,18,10,0
lonelyroom-eklaghor,196,1,0,0,22,22,13,0
loopin-lupin,183,1,0,0,29,29,13,0
lor3nt,34,1,0,0,11,11,13,0
loveonthedownlow568,12,1,0,0,1,1,11,0
loyalsolider95,468,1,1,1,43,44,13,0.00068
TCharlieZ,17,0,1,3,1,4,16,0.000247
hippyup,12,0,7,9,3,12,14,0.001459
lunaflowerssa,52,1,0,0,2,2,12,0
lyly-r,85,1,0,0,7,7,14,0
mamakajkakakakaka,249,1,0,0,26,26,13,0
mangofan99,601,1,0,0,13,13,11,0
marmar8888,19,1,0,0,2,2,13,0
mayappleaday,13,1,0,0,1,1,16,0
No_Comfortable_3148,33,0,18,9,4,13,14,0.000834
darbmobile,12,0,1,2,0,2,0,0.000263
point_of_you,13,0,10,2,1,3,15,0.000224
mdbroderick1,154,1,0,0,23,23,13,0
CaedustheBaedus,12,0,9,5,2,7,14,0.000731
megacide84,42,1,0,0,4,4,15,0
melody_magical,78,1,0,0,22,22,13,0
metayeti2,290,1,0,0,38,38,12,0
IeyasuMcBob,14,0,18,5,5,10,13,0.000964
mhliu8,49,2,0,0,4,4,12,0
mileslostjordans,17,1,0,0,3,3,11,0
mindy650,26,1,0,0,1,1,14,0
misty_mustard,61,1,0,0,13,13,13,0
miyomaku,70,1,0,0,14,14,14,0
mmalin,115,1,0,0,8,8,14,0
momentforlife92,1329,2,0,0,143,143,12,0
Bassist57,11,0,1,4,1,5,15,0.000987
Level_Ad9278,43,0,39,6,5,11,14,0.00124
Quiet_Fan_7008,11,0,11,4,2,6,15,0.000839
redditratman,28,0,17,8,4,12,15,0.000894
trustnobody01,578,1,1,1,52,53,12,0.00068
muffinbready,12,1,0,0,1,1,1,0
mustard_ant,98,2,0,0,9,9,12,0
mxxnlyte,17,1,0,0,1,1,11,0
beardsac,22,0,14,5,3,8,14,0.006958
refboy4,11,0,8,3,2,5,13,0.009039
snagsguiness,12,0,7,4,4,8,14,0.006575
nashwaak,24,1,0,0,2,2,14,0
nearly_blinded,39,1,0,0,1,1,15,0
nerpa_floppybara,256,3,0,0,36,36,13,0
MrWoodblockKowalski,13,0,14,6,2,8,14,0.002263
nexxwav,922,3,0,0,108,108,13,0
DarthJarJarJar,20,0,19,5,3,8,14,0.005774
_SCHULTZY_,16,0,3,4,1,5,16,0.004704
threeLetterMeyhem,12,0,7,4,3,7,15,0.004968
ninapennyy,18,1,0,0,4,4,11,0
nnneeeeee,61,1,0,0,4,4,13,0
noodles17x,78,1,0,0,5,5,12,0
notchandlerbing,81,1,0,0,21,21,14,0
nothingarc,27,1,0,0,3,3,15,0
notme_28,38,1,0,0,1,1,13,0
o_50,239,1,0,0,14,14,11,0
Rebel_Grrl,20,0,1,7,0,7,0,0.000047
observant_learner,103,1,0,0,4,4,15,0
oceanadakmak,72,1,0,0,12,12,14,0
findmeauname,12,0,12,3,1,4,14,0.000262
oldman_redditTA,1379,1,1,2,35,37,9,0.00001
DivorceIncoming123,47,0,40,6,1,7,15,0.000146
omd0201,19,1,0,0,1,1,11,0
omega4444,52,1,0,0,1,1,15,0
omgitsmittnacht,210,1,0,0,36,36,13,0
ButtExplosion,12,0,4,6,0,6,0,0.000386
DreamofCommunism,12,0,18,3,3,6,14,0.000287
vbob99,16,0,16,5,3,8,13,0.000316
orinmerryhelm,304,1,0,0,40,40,12,0
orpheusprotocol355,30,1,0,0,1,1,1,0
osomiisterioso,125,1,0,0,20,20,13,0
overwhelmedmom3,126,1,0,0,3,3,13,0
owltowl19,24,1,0,0,4,4,14,0
p0tat0_ch1ps,78,1,0,0,6,6,11,0
pafdoot,23,1,0,0,2,2,12,0
AltruisticCoach9217,16,0,16,2,1,3,15,0.000407
JawnSnuuu,13,0,12,4,2,6,15,0.000618
Live_for_Now,14,0,13,3,2,5,15,0.000558
MediocreEffectt,16,0,13,4,2,6,15,0.000429
No-Coach533,15,0,11,3,2,5,14,0.000442
No-System3367,11,0,6,3,2,5,15,0.000433
notyourgrandad,86,0,41,12,8,20,14,0.000755
oeg2415,99,0,39,12,6,18,13,0.001437
snootsintheair,11,0,6,2,0,2,0,0.000516
stuckwitharmor,184,1,1,1,35,36,13,0.000403
pansy_honeybee05,90,1,0,0,9,9,11,0
papasoex,66,1,0,0,7,7,13,0
papiforyou,71,1,1,1,5,6,14,0
CinemaPunditry,13,0,8,3,2,5,16,0.000057
Comfortable-Way-8029,12,0,18,4,3,7,15,0.000108
Meddling-Kat,17,0,16,2,1,3,1,0.000049
SteamtasticVagabond,12,0,9,1,0,1,0,0.000049
ninjatahu,24,0,24,2,1,3,1,0.000049
slate88,17,0,1,2,0,2,0,0.000126
space_cult,13,0,21,2,1,3,15,0.000097
pea_pods,103,1,0,0,29,29,13,0
pearllypie3,226,1,0,0,12,12,10,0
Upstairs-Waltz-3611,11,0,9,5,2,7,12,0.000003
thisisstupid0099,11,0,16,2,4,6,12,0.000001
penrudee1205,35,1,0,0,9,9,13,0
perverseintellect,13,1,0,0,5,5,14,0
pghcecc,26,2,0,0,2,2,16,0
ph0on,57,1,0,0,11,11,13,0
phileconomicus,57,1,0,0,10,10,13,0
phoenixhuber,54,1,0,0,6,6,14,0
Diveblock,21,0,23,1,0,1,0,0.00018
pitsoutfortitbul,229,1,0,0,9,9,11,0
pleasecallmenancy,15,1,0,0,2,2,14,0
politicalthrowaway1z,31,1,0,0,3,3,12,0
politicsandmore,27,1,0,0,9,9,14,0
potsandpole,25,1,0,0,4,4,11,0
pro_nait,44,1,0,0,1,1,16,0
proggga,59,1,0,0,7,7,15,0
psychcaligirl,22,1,0,0,3,3,12,0
puppyaku,78,1,0,0,8,8,12,0
pyrrhonic_victory,60,1,0,0,14,14,13,0
ragequilter0204,62,1,0,0,9,9,13,0
ranom_name,19,1,0,0,3,3,13,0
red5,121,1,0,0,22,22,12,0
redditatlas,5374,1,0,0,71,71,12,0
Basic-Western-9124,14,0,7,2,2,4,16,0.000219
BearlyPosts,17,0,7,3,3,6,15,0.000229
Calm-Purchase-8044,66,0,24,2,2,4,17,0.000218
Dragonmancer76,22,0,11,2,1,3,16,0.00022
EpicCurious,12,0,4,2,2,4,17,0.000218
Fickle-Sense-8210,52,0,1,6,0,6,0,0.000361
FoilCharacter,11,0,9,2,1,3,16,0.000219
Glittering_Set6017,12,0,10,1,0,1,0,0.000218
Important_Charge9560,22,0,6,3,1,4,16,0.000254
Loli3535,12,0,6,2,1,3,1,0.000292
No_Site_8690,12,0,8,1,0,1,0,0.000218
Ok-Significance2978,26,0,28,4,6,10,15,0.000222
RespondCharacter6633,31,0,21,2,1,3,1,0.000218
Urfubar12,22,0,1,4,0,4,0,0.000319
abetterlogin,45,0,26,4,2,6,1,0.000293
alaunaslay,18,0,4,5,1,6,1,0.000461
emory_2001,11,0,4,1,1,2,16,0.000218
jcdigg,14,0,1,3,0,3,0,0.000219
reactorfuel,28,0,27,2,1,3,1,0.000218
redditname175,165,1,0,0,3,3,13,0
redpandaonstimulants,72,1,0,0,14,14,13,0
reinesilly,51,1,0,0,4,4,11,0
remendiy,12,1,0,0,1,1,13,0
risingsun1964,125,1,0,0,29,29,13,0
rmanec,30,1,0,0,4,4,12,0
robertboyle56,17,1,0,0,2,2,15,0
rocketsunrise,46,1,0,0,9,9,12,0
roses4angeI,87,1,0,0,9,9,13,0
ruisen2,65,1,0,0,7,7,15,0
s_b_53,25,1,0,0,4,4,15,0
sadcapric0rn,14,1,0,0,1,1,12,0
santan25,25,2,0,0,3,3,15,0
sassychip26,54,1,0,0,7,7,13,0
scuba_steve94,36,1,0,0,8,8,11,0
sde_error_farmer,13,1,1,0,1,1,15,0
CatalyticDragon,12,0,7,3,3,6,14,0.00133
PunishedDemiurge,16,0,8,4,3,7,14,0.000883
selfsabotage8,18,1,0,0,3,3,11,0
sexinsuburbia,35,1,0,0,8,8,14,0
shootermcgvn,52,1,0,0,15,15,13,0
Aquiduck,17,0,16,3,0,3,0,0.000741
shyguyz88,17,1,0,0,1,1,13,0
simmol,20,1,0,0,7,7,14,0
someguyplayingwild,394,1,0,0,56,56,13,0
straightcashhomey29,17,0,16,2,1,3,14,0.002446
somestuffiscoolio,85,1,0,0,12,12,13,0
EmporerJustinian,24,0,3,5,1,6,15,0.000758
Historical-Jaguar793,12,0,5,2,1,3,13,0.00143
Kibbles-N-Titss,18,0,20,2,1,3,13,0.000592
NonbinaryYolo,11,0,14,3,2,5,15,0.000803
datingcoach32,18,0,24,4,6,10,13,0.000889
ducksuite,16,0,5,4,1,5,1,0.000597
thesumofallvice,47,1,1,1,15,16,13,0.00058
sopara862k,47,1,0,0,11,11,11,0
spicygal96,85,1,0,0,7,7,13,0
spidermonkey174,34,1,0,0,7,7,11,0
sstiel,56,1,0,0,1,1,15,0
starshockey91va,40,1,0,0,5,5,14,0
stevendub86,45,1,0,0,2,2,14,0
stoner4life42,50,1,0,0,2,2,12,0
strider7,53,1,0,0,11,11,13,0
Ottomatik80,18,0,19,2,1,3,1,0.000028
grottohopper,12,0,11,2,1,3,1,0.000028
stuck_inthe_suburbs,68,1,0,0,5,5,12,0
supermans_left_tit,376,1,0,0,7,7,12,0
surfingbarbie2025,98,1,0,0,9,9,10,0
sweet_t02,53,1,0,0,5,5,11,0
tarrs92,23,1,0,0,3,3,11,0
testaccount4one,41,1,0,0,10,10,13,0
texasguitarguy,207,1,0,0,10,10,14,0
thatpianokidpj,36,1,0,0,1,1,1,0
theRadiofreak,85,1,0,0,17,17,13,0
thenewmeredith,33,1,0,0,3,3,15,0
thiccurlss,121,1,0,0,1,1,2,0
Its_Your_Father,12,0,6,5,2,7,14,0.000713
thomasmaster912,37,1,0,0,8,8,14,0
throw_a_waypo,44,1,0,0,1,1,12,0
throwa_coolcuke,280,1,0,0,10,10,10,0
throwawaY6689012meow,44,1,0,0,3,3,12,0
throwaway2922223,19,1,0,0,1,1,11,0
throwaway904820,51,1,0,0,2,2,12,0
throwaway_alladvice,42,1,0,0,6,6,12,0
throwdranzer,729,1,0,0,22,22,10,0
Marty-the-monkey,26,0,28,4,1,5,14,0.000548
Tirriforma,21,0,19,4,3,7,14,0.000268
ellirae,21,0,17,5,4,9,14,0.000368
throwaway-tinfoilhat,11,0,6,2,1,3,14,0.000261
tinytidgy,48,1,0,0,7,7,11,0
tipputappi,275,2,0,0,36,36,13,0
topgear9123,58,1,0,0,10,10,14,0
trevor_darley,255,1,0,0,30,30,14,0
tribulating,117,1,0,0,13,13,13,0
troy_52,27,1,0,0,1,1,14,0
Suspicious_Tank_61,11,0,12,3,2,5,15,0.000249
kurrganinterrogator,23,0,23,2,2,4,15,0.000179
tuotone75,30,1,0,0,9,9,14,0
tuxcoders,119,1,0,0,9,9,10,0
u_ami,104,1,0,0,3,3,14,0
uktabilizard,53,1,0,0,6,6,14,0
unbroductive,50,1,0,0,3,3,15,0
unknownusernameig,21,1,0,0,3,3,12,0
usedolds,15,1,0,0,2,2,14,0
v3st1ge,35,1,0,0,5,5,11,0
vardys0907,20,1,0,0,1,1,11,0
vatevername,365,2,0,0,41,41,13,0
vdaysk8,438,1,0,0,40,40,13,0
brend0p3,11,0,7,3,1,4,14,0.00025
gemunicornvr,93,0,144,10,15,25,13,0.000451
veganonthespectrum,12,1,0,0,1,1,16,0
vicky_gervais,46,1,0,0,7,7,11,0
vossboss161,282,1,0,0,30,30,14,0
wabuilderman,56,1,0,0,11,11,13,0
wafflesgy,18,1,0,0,9,9,14,0
wand-n-words,37,1,0,0,5,5,14,0
wanderingdesigner_,21,1,0,0,2,2,15,0
wannabeAIdev,14,1,0,0,4,4,13,0
what_50000,2318,1,0,0,46,46,9,0
AcademicCandidate825,13,0,1,1,0,1,0,0.00001
Friday_dances,37,1,1,1,0,1,0,0.00001
PinkedOff,12,0,9,2,1,3,13,0.00001
UnbreakableAlice,25,0,26,1,1,2,1,0.00001
Weirdawesome197,23,0,8,3,2,5,11,0.00001
hoardbooksanddragons,13,0,2,2,1,3,4,0.00001
whateversynthlife,400,1,0,0,24,24,13,0
whoisorange,18,1,0,0,3,3,12,0
windpearl2,49,1,0,0,3,3,16,0
wombo23,18,1,0,0,2,2,15,0
wyntersnow1,92,1,0,0,22,22,13,0
xnuriex,22,1,0,0,2,2,13,0
xolon6,18,1,0,0,5,5,13,0
xxtikit0xx,41,1,0,0,5,5,11,0
yeah-toast101,36,1,0,0,12,12,14,0
yogamamalover1953,28,1,0,0,3,3,11,0
youngsurpriseperson,111,2,0,0,21,21,13,0
yuyii_9,22,1,0,0,5,5,11,0
zen___monk,17,1,0,0,3,3,13,0
EmptyEstablishment78,13,0,6,5,2,7,13,0.002121
GeorgeHarris419,11,0,12,2,3,5,13,0
LittleWhiteGirl,14,0,5,3,3,6,12,0.000001
Xicadarksoul,25,0,24,2,2,4,14,0.000073
AcanthisittaCute2732,95,1,0,0,0,0,0,0
Additional-Bother827,13,1,0,0,0,0,0,0
Alarming_Zombie8221,22,1,0,0,0,0,0,0
Altruistic-Truth8154,26,1,0,0,0,0,0,0
Angxlmilk,11,1,0,0,0,0,0,0
Any_Peach2603,15,1,0,0,0,0,0,0
ArkaneDigital,15,1,0,0,0,0,0,0
AshleyMay_30,29,1,0,0,0,0,0,0
Careful_Dingo_1443,17,1,0,0,0,0,0,0
Cautious-Trifle3892,12,1,0,0,0,0,0,0
ChangeIsNotTheEnemy,17,1,0,0,0,0,0,0
Character_Poet1473,16,1,0,0,0,0,0,0
Charming_Struggle_29,12,1,0,0,0,0,0,0
Cold-Yogurtcloset640,11,1,0,0,0,0,0,0
ColdCup1285,14,1,0,0,0,0,0,0
Comfortable-Snow3804,85,1,0,0,0,0,0,0
ComfortableMeeting14,22,1,0,0,0,0,0,0
ComprehensiveWeb2502,15,1,0,0,0,0,0,0
ConnectionRude4832,26,1,0,0,0,0,0,0
CookieButterLover03,30,1,0,0,0,0,0,0
CyanoxD,23,1,0,0,0,0,0,0
DeepestSecrets97,16,1,0,0,0,0,0,0
DiceyPisces,11,0,10,0,0,0,0,0
Dragon_Czar,13,1,0,0,0,0,0,0
Drewthulu,15,1,0,0,0,0,0,0
Equivalent_Ebb8534,15,1,0,0,0,0,0,0
Excellent-Hospital16,18,1,0,0,0,0,0,0
FlyNarrow824,22,1,0,0,0,0,0,0
Flying_Leg,14,1,0,0,0,0,0,0
Foreign_Chocolate316,13,1,0,0,0,0,0,0
Frightened-Lad,12,1,0,0,0,0,0,0
GPoshly,16,1,0,0,0,0,0,0
GarageNo7539,16,1,0,0,0,0,0,0
Gold_Sock_1025,25,1,0,0,0,0,0,0
Good_Quiet_8632,23,1,0,0,0,0,0,0
Hisoka_Morrow_,31,1,0,0,0,0,0,0
I-Wheely-Mean-It,59,1,0,0,0,0,0,0
IamTyrion_Lannister,16,1,0,0,0,0,0,0
Important-Fig600,47,1,0,0,0,0,0,0
InformalConcept7030,38,1,0,0,0,0,0,0
InspectorDull9735,217,1,0,0,0,0,0,0
Intelligent-Duty-153,21,1,0,0,0,0,0,0
Intrepid-Jello-1886,356,1,0,0,0,0,0,0
Iyiem,45,1,0,0,0,0,0,0
Jolly_Green_4255,23,1,0,0,0,0,0,0
Lancasterbation,11,0,17,0,0,0,0,0
Liminal-Logic,281,1,0,0,0,0,0,0
Low-Home7613,16,1,0,0,0,0,0,0
ManyTumbleweed9140,13,1,0,0,0,0,0,0
Medical_Guarantee_56,36,1,0,0,0,0,0,0
MinuteIll654,13,1,0,0,0,0,0,0
Moses_Benjamin,12,1,0,0,0,0,0,0
Nice-Equipment-7383,39,1,0,0,0,0,0,0
NoOpportunity7847,22,1,0,0,0,0,0,0
No_Glove3742,14,1,0,0,0,0,0,0
Not-Giving-Up-Yet,12,1,0,0,0,0,0,0
Ok-Cauliflower-8055,12,1,0,0,0,0,0,0
Ok-Motor-8412,11,1,0,0,0,0,0,0
Ok_Community_2570,13,1,0,0,0,0,0,0
Ok_Staff4255,730,1,0,0,0,0,0,0
Otherwise_Sock_4040,31,1,0,0,0,0,0,0
Own_Explorer4422,16,1,0,0,0,0,0,0
Prestigious-Can5880,39,1,0,0,0,0,0,0
Pristine-Click-7695,13,1,0,0,0,0,0,0
Pulu15,35,1,0,0,0,0,0,0
Quiet-Amoeba-3922,35,1,0,0,0,0,0,0
Radiant-External-631,51,1,0,0,0,0,0,0
Regular-Mousse-5493,27,1,0,0,0,0,0,0
Regular_Ad7297,17,1,0,0,0,0,0,0
Relative_Survey_7752,14,1,0,0,0,0,0,0
Rough_University_536,13,1,0,0,0,0,0,0
Sad_Reaction5890,162,3,0,0,0,0,0,0
Safe-Caterpillar-587,13,1,0,0,0,0,0,0
SalMinellaOnYouTube,12,1,0,0,0,0,0,0
SaliktheCruel,11,1,0,0,0,0,0,0
Salty-Computer-2737,12,1,0,0,0,0,0,0
Salty_Stomach2604,80,1,0,0,0,0,0,0
Sea-Whole-4616,24,1,0,0,0,0,0,0
Sea_Signal_7024,52,1,0,0,0,0,0,0
Secret-Bag-6766,24,1,0,0,0,0,0,0
SecretFine1214,18,1,0,0,0,0,0,0
Straight-Finance-135,193,1,1,0,0,0,0,0
Tasty_Werewolf7297,54,1,0,0,0,0,0,0
TheLastMartian13,204,1,0,0,0,0,0,0
ThrowRA_dot_,11,1,0,0,0,0,0,0
Toothfairy29,31,1,0,0,0,0,0,0
True-Ride2034,16,1,0,0,0,0,0,0
VastEnthusiasm6915,39,1,0,0,0,0,0,0
VertigoShock,16,1,0,0,0,0,0,0
Waste_Blueberry_8675,37,1,0,0,0,0,0,0
_noob_san,21,1,0,0,0,0,0,0
am_ok,16,1,0,0,0,0,0,0
ayizan88,33,2,0,0,0,0,0,0
blueoats77,13,1,0,0,0,0,0,0
bona_dult2000,13,1,0,0,0,0,0,0
calcifer0573,44,1,0,0,0,0,0,0
camjvp,39,1,0,0,0,0,0,0
cannedbeans97,49,1,0,0,0,0,0,0
cat_topia,13,1,0,0,0,0,0,0
cryptonite_05,11,1,0,0,0,0,0,0
dr_pepper_addict5678,11,1,0,0,0,0,0,0
dre__966,43,1,0,0,0,0,0,0
fisjajn,35,1,0,0,0,0,0,0
hillel_bergman,16,1,0,0,0,0,0,0
itsgigi-,276,1,0,0,0,0,0,0
krankenschwester82,18,1,0,0,0,0,0,0
lemonmakesmehappy,11,1,0,0,0,0,0,0
lincolnistrying,36,1,0,0,0,0,0,0
lordbeepworth,19,1,0,0,0,0,0,0
memphisjohn,20,0,12,0,0,0,0,0
nopedouttt,44,1,0,0,0,0,0,0
notanotherthroaway1,12,1,0,0,0,0,0,0
onlineidiot1994,31,1,0,0,0,0,0,0
peachlessbobcat,25,1,0,0,0,0,0,0
redbeardedpiratedog,72,1,0,0,0,0,0,0
rockyroad42069,75,1,0,0,0,0,0,0
sleepingbeast87,42,1,0,0,0,0,0,0
src88,13,0,8,0,0,0,0,0
stamosface,17,1,0,0,0,0,0,0
szmatuafy,32,1,0,0,0,0,0,0
throughaghwae,26,1,0,0,0,0,0,0
throwaway_dextrome,15,1,0,0,0,0,0,0
ullol234,17,1,0,0,0,0,0,0
usernamenew12,21,1,0,0,0,0,0,0
vool_exe,16,1,0,0,0,0,0,0
