id,engagement,indegree,outdegree,degree,eccentricity,authority
12bEngie,38,7,72,79,11,0.003417
10thAmdAbsolutist,391,69,83,152,12,0.008598
AberforthSpeck,11,4,0,4,0,0.001855
AnLoingseach,11,2,2,4,12,0.000402
AutoModerator,1943,71,0,71,0,0.118076
BarleyWineIsTheBest,80,12,10,22,12,0.002333
Budget_Trifle_1304,10,7,3,10,12,0.001337
Commercial-Print-,27,5,4,9,12,0.00044
Conscious-Function-2,35,13,4,17,13,0.003779
DeltaBot,1045,66,38,104,11,0.023498
Difficult_Minute8202,15,2,1,3,14,0.001024
DoesMatter2,16,6,4,10,12,0.000906
DryEditor7792,21,7,0,7,0,0.005248
False_Appointment_24,30,19,6,25,12,0.001853
FarConstruction4877,37,9,2,11,13,0.003194
GermanPayroll,23,18,7,25,12,0.002324
HexspaReloaded,21,4,21,25,12,0.001247
Holiman,10,2,1,3,1,0.000391
HumansMustBeCrazy,10,4,1,5,15,0.000718
ImmortalAgentEta,19,9,4,13,14,0.002234
Inferno_Zyrack,22,12,7,19,12,0.003712
Johnnadawearsglasses,18,7,4,11,12,0.003925
Key-Practice-2336,10,3,1,4,14,0.000702
LimeDramatic4624,10,4,4,8,13,0.000411
LisleAdam12,48,16,15,31,13,0.004519
Matsdaq,10,5,5,10,12,0.002232
Mental-Cupcake9750,19,4,0,4,0,0.003363
Morthra,171,64,60,124,11,0.011983
Mvpbeserker,19,9,5,14,12,0.00475
NaturalCarob5611,67,26,12,38,12,0.006416
Nofanta,29,4,1,5,1,0.001294
Phage0070,43,7,5,12,13,0.001669
Potential_Wish4943,45,26,15,41,11,0.004324
Ramguy2014,28,8,5,13,13,0.002164
Rare-Discipline3774,13,5,0,5,0,0.001619
RiverCityWoodwork,31,20,6,26,13,0.004806
Shadow_666_,10,5,3,8,13,0.011094
Sure_Acanthaceae_348,25,8,3,11,14,0.004752
SweatyAnimator6189,10,2,1,3,16,0.000391
TPSreportmkay,108,22,9,31,13,0.004839
Technical_Goose_8160,20,10,6,16,12,0.018622
WanderingSpearIt,62,9,3,12,13,0.001686
Wooden-Ad-3382,46,13,10,23,12,0.001952
ZorgZeFrenchGuy,15,9,5,14,13,0.001747
a_rabid_anti_dentite,12,5,3,8,13,0.000773
azuredota,22,8,5,13,13,0.001475
caseybvdc74,16,3,34,37,12,0.00041
changemyview-ModTeam,3697,73,2,75,14,0.026253
darthmcdarthface,50,16,11,27,13,0.003725
enemy884real,12,4,0,4,0,0.002894
hillswalker87,35,13,13,26,12,0.004324
ihatepasswords1234,79,13,19,32,12,0.001693
jbslaw1214,34,7,6,13,12,0.000461
legal_opium,12,5,6,11,13,0.003498
lifeisabowlofbs,73,30,49,79,11,0.006933
nogooduse,21,10,9,19,13,0.005391
nrcx,25,6,6,12,12,0.000782
ozneoknarf,16,3,2,5,12,0.002189
saintsithney,15,4,5,9,11,0.000567
thebossmin,31,11,3,14,11,0.013046
tidalbeing,27,5,2,7,14,0.000711
wolacouska,12,6,5,11,13,0.002764
212312383,28,11,32,43,12,0.006202
Beneficial-Diet-9897,30,5,3,8,12,0.000512
Beyond_Reason09,11,5,3,8,13,0.001581
DrNogoodNewman,30,14,8,22,12,0.001556
Foulis68,48,10,6,16,13,0.001665
Gurrgurrburr,14,2,4,6,13,0.001691
Happy-Viper,29,5,2,7,12,0.000842
Hypekyuu,42,10,5,15,13,0.002589
Inner_Butterfly1991,41,14,9,23,12,0.003258
Jaded_Jerry,22,17,0,17,0,0.005593
Madrigall,29,10,5,15,13,0.001202
Nrdman,352,33,15,48,12,0.005428
ParticularBreath8425,14,8,4,12,13,0.001539
Regalian,24,4,1,5,13,0.001446
Roadshell,78,23,9,32,12,0.002513
RulesBeDamned,38,18,5,23,12,0.004798
TheSauceeBoss,78,24,14,38,12,0.005189
ZoomZoomDiva,98,23,16,39,13,0.003403
azarash,12,6,4,10,13,0.001386
curiouslyjake,69,22,8,30,12,0.003374
davidml1023,54,16,9,25,13,0.001191
iosefster,11,3,2,5,13,0.000397
lolexecs,11,5,4,9,14,0.012556
premiumPLUM,49,11,2,13,13,0.002001
the_1st_inductionist,65,10,4,14,13,0.000885
81forest,11,5,28,33,11,0.001457
ATLEMT,12,5,1,6,13,0.000899
AresBloodwrath,11,4,2,6,12,0.000199
BuskerDan,11,4,2,6,13,0.000145
Cactuswhack1,31,21,4,25,12,0.001655
DrFabio23,12,3,1,4,12,0.00018
FerdinandTheGiant,62,17,18,35,11,0.002934
IT_ServiceDesk,66,29,9,38,12,0.004541
KaiBahamut,72,21,21,42,12,0.002498
Mashaka,86,14,0,14,0,0.006666
Mysterious_Cum,11,2,1,3,14,0.000118
ProfessionalLurkerJr,20,9,9,18,10,0.001467
SmokeySFW,20,3,0,3,0,0.000147
Successful-Cat9185,10,1,2,3,12,0.000114
SupervisorSCADA,34,6,4,10,12,0.0009
TheMan5991,28,5,4,9,12,0.000302
Thin-Management-1960,16,4,0,4,0,0.000678
YouJustNeurotic,55,12,6,18,12,0.002876
deftonite,20,9,4,13,12,0.002371
flairsupply,73,22,5,27,13,0.0043
vsv2021,21,8,6,14,12,0.002365
8NaanJeremy,34,7,33,40,11,0.000806
47ca05e6209a317a8fb3,17,13,2,15,13,0.002121
ButterscotchNo1546,62,7,7,14,12,0.001058
Douchebazooka,11,3,2,5,13,0.00028
Downtown-Campaign536,17,6,1,7,13,0.000908
Dry_Bumblebee1111,152,48,8,56,13,0.00833
Fabulous-Suspect-72,155,23,21,44,12,0.00257
Falernum,67,18,7,25,13,0.00371
LucidMetal,119,36,23,59,11,0.004974
Ohjiisan,28,5,2,7,14,0.000592
Ok-Round-1473,39,9,6,15,13,0.000438
Potential_Being_7226,10,5,3,8,12,0.000206
ScytheSong05,11,5,2,7,13,0.000513
Significant_Stand_17,20,2,2,4,13,0.000143
Slime__queen,26,7,5,12,11,0.000748
bifewova234,10,4,0,4,0,0.000481
heroyoudontdeserve,45,12,12,24,12,0.000668
misanthpope,33,12,9,21,12,0.001388
sh00l33,42,12,7,19,12,0.00243
washingtonu,11,5,3,8,13,0.009685
yyzjertl,126,42,11,53,11,0.005952
zxxQQz,24,15,14,29,12,0.001594
AlexandrTheTolerable,15,6,49,55,12,0.029057
Alive_Shoulder3573,80,15,15,30,12,0.034872
Ana_Na_Moose,36,11,8,19,13,0.039215
Ashmedai,78,27,31,58,12,0.090801
BRAINSPLATTER16,26,5,5,10,13,0.004339
Buck_Thorn,15,5,3,8,13,0.016664
Delta-9-,55,19,17,36,12,0.05448
Edgar_Brown,19,6,3,9,13,0.014649
Fargason,84,16,17,33,12,0.026104
Fluffy-Load1810,14,7,2,9,14,0.027467
FrozenSeas,19,12,8,20,13,0.031045
Hyndis,28,9,9,18,12,0.03638
IleGrandePagliaccio,31,7,4,11,13,0.023225
IniNew,43,20,15,35,12,0.065953
Interrophish,123,26,38,64,12,0.080802
IntrepidAd2478,32,19,15,34,13,0.043012
Jen0BIous,29,3,1,4,13,0.00444
Kaleb_Bunt,12,5,0,5,0,0.004224
KurtisRambo19,12,6,5,11,13,0.01483
MaineHippo83,112,44,37,81,11,0.0625
ManBearScientist,80,25,23,48,12,0.064163
Moccus,95,35,38,73,12,0.066938
NorthernerWuwu,24,9,7,16,12,0.038351
Nothing_Better_3_Do,109,54,29,83,12,0.096385
Objective_Aside1858,166,74,353,427,11,0.072329
Omari-OTL,11,3,2,5,13,0.002468
PoliticalDiscussion-ModTeam,203,15,0,15,0,0.07885
Sageblue32,64,20,22,42,13,0.055315
Sarmq,28,5,4,9,13,0.018235
StanDaMan1,15,9,7,16,13,0.023638
TheMikeyMac13,65,26,15,41,12,0.046181
UnfoldedHeart,99,37,33,70,12,0.074466
WhiteWolf3117,10,3,2,5,12,0.012319
XXXCincinnatusXXX,24,9,5,14,12,0.028775
anti-torque,66,18,25,43,12,0.060427
baxterstate,146,45,22,67,12,0.091386
bl1y,509,94,115,209,12,0.10794
clios_daughter,21,5,5,10,12,0.002941
clorox_cowboy,10,4,5,9,12,0.004387
kingjoey52a,49,31,8,39,12,0.036709
mskmagic,37,11,7,18,12,0.027829
neosituation_unknown,16,15,0,15,0,0.017875
skyfishgoo,34,11,5,16,13,0.047859
sllewgh,147,18,13,31,12,0.016054
sunfishtommy,18,11,12,23,12,0.03393
theyfellforthedecoy,58,30,25,55,12,0.070667
AncienTleeOnez,21,5,28,33,12,0.011051
Far_Realm_Sage,27,17,3,20,13,0.069417
JDogg126,45,22,12,34,13,0.045496
ManOfLaBook,10,2,2,4,13,0.001238
Roadside_Prophet,12,9,5,14,13,0.007273
RobotAlbertross,19,9,2,11,12,0.047575
Rook_lol,10,9,3,12,13,0.018832
Slam_Bingo,13,5,2,7,14,0.012956
SlowMotionSprint,34,12,11,23,12,0.052093
TheOvy,25,15,6,21,13,0.03957
ThePensiveE,29,13,6,19,12,0.046629
The_B_Wolf,63,19,12,31,12,0.02078
__zagat__,68,19,27,46,12,0.05308
drdildamesh,18,5,4,9,13,0.020242
infiniteninjas,14,3,2,5,14,0.015226
kenmele,15,3,1,4,12,0.01107
mrjcall,116,35,20,55,13,0.090727
peetnice,16,7,7,14,13,0.016462
satyrday12,57,31,21,52,13,0.081085
tosser1579,43,21,7,28,13,0.039929
vesselofwords,13,6,6,12,13,0.023698
Awesomeuser90,31,2,177,179,11,0.000486
-ReadingBug-,40,11,10,21,12,0.046053
-SOFA-KING-VOTE-,75,23,13,36,13,0.029853
123yes1,17,5,4,9,13,0.010123
1QAte4,17,22,5,27,13,0.053536
303Carpenter,12,8,5,13,13,0.032742
8to24,89,54,28,82,13,0.082376
ANewBeginningNow,18,12,0,12,0,0.041808
AT_Dande,11,8,4,12,13,0.035887
Aazadan,15,8,8,16,12,0.036371
Ashamed_Job_8151,18,8,7,15,13,0.044307
Aureliamnissan,20,5,5,10,12,0.023744
Balanced_Outlook,68,20,33,53,12,0.041278
Bishop_Colubra,10,5,3,8,13,0.009643
BluesSuedeClues,285,90,250,340,12,0.129669
CellularSavant,14,6,2,8,13,0.02236
ChepaukPitch,10,2,3,5,14,0.007952
ClockOfTheLongNow,776,161,162,323,11,0.164159
Comfortable-Policy70,14,6,5,11,12,0.039494
Corellian_Browncoat,40,20,18,38,12,0.048756
Cursethewind,13,3,4,7,13,0.019009
DBDude,136,47,34,81,12,0.051614
DCBuckeye82,17,5,5,10,13,0.010548
DarkExecutor,14,6,5,11,12,0.015059
Donut-Strong,10,9,1,10,13,0.018347
DrPlatypus1,21,7,3,10,13,0.009907
Eric848448,44,20,14,34,12,0.045638
Factory-town,224,44,54,98,12,0.102419
FallOutShelterBoy,10,8,5,13,13,0.032531
Fit-Order-9468,61,10,5,15,13,0.008308
Fragrant-Luck-8063,34,12,10,22,12,0.034346
GarbledComms,14,10,5,15,13,0.011061
GiantPineapple,28,14,7,21,13,0.030357
GoldenInfrared,25,6,7,13,12,0.010848
GrandMasterPuba,30,12,9,21,13,0.037
GreatConsequence7847,11,5,5,10,13,0.010269
Hapankaali,49,13,10,23,13,0.046986
HardlyDecent,38,21,10,31,13,0.062548
HeloRising,43,12,6,18,12,0.037697
I-Here-555,57,29,19,48,12,0.062919
I405CA,215,70,37,107,12,0.111444
IceNein,47,30,18,48,13,0.043481
Ill-Description3096,127,41,36,77,12,0.032599
InNominePasta,22,16,9,25,13,0.043564
JKlerk,189,47,36,83,12,0.112912
JQuilty,29,10,9,19,12,0.032118
JohnSpartan2025,12,4,80,84,12,0.03364
JonDowd762,28,14,14,28,12,0.042926
JuniorFarcity,21,12,10,22,13,0.020614
Key_Day_7932,10,6,4,10,12,0.048581
Kronzypantz,86,23,105,128,12,0.049646
LagerHead,10,2,4,6,12,0.009489
LanaDelHeeey,49,22,13,35,12,0.027258
Lanracie,43,14,5,19,12,0.056531
Leather-Map-8138,68,22,12,34,12,0.089242
Lefaid,17,7,19,26,13,0.01185
LifesARiver,13,5,4,9,12,0.038596
MatthewRebel,12,7,2,9,13,0.02522
Mend1cant,19,10,4,14,13,0.027086
MiddleAndLeg_,10,2,0,2,0,0.011282
MorganWick,44,14,17,31,12,0.041362
MurrayBothrard,77,35,26,61,12,0.062359
NoExcuses1984,43,14,17,31,12,0.038657
NomadicScribe,11,5,3,8,13,0.009796
Nulono,30,6,10,16,13,0.027003
Only_Economics7148,15,2,0,2,0,0.016497
Ornery-Ticket834,59,18,13,31,12,0.058067
Outrageous-Pay535,16,7,7,14,12,0.023333
Personage1,10,5,5,10,13,0.020577
PhiloPhocion,11,6,3,9,13,0.034316
Polyodontus,144,32,39,71,12,0.033297
Potato_Pristine,15,7,7,14,13,0.03227
RCA2CE,196,51,31,82,12,0.109366
Raichu4u,17,9,54,63,12,0.032792
Riokaii,49,18,13,31,12,0.077184
Rivercitybruin,65,31,9,40,12,0.079724
SagesLament,11,7,6,13,13,0.009773
Sapriste,47,16,10,26,12,0.036302
Scatman_Crothers,13,9,9,18,13,0.013409
ScoobiusMaximus,27,13,6,19,12,0.035602
ScoutsHonorHoops,11,3,2,5,14,0.009082
ScreenTricky4257,20,7,3,10,13,0.02481
Serious-Top7925,22,14,10,24,12,0.03642
Spackledgoat,11,5,4,9,13,0.012841
Splenda,35,14,9,23,13,0.059585
SpoofedFinger,18,10,5,15,13,0.031682
TheTrueMilo,28,14,14,28,12,0.051848
ThemesOfMurderBears,21,12,9,21,13,0.062012
Tired8281,13,3,1,4,14,0.019425
Vast-Information4565,12,3,4,7,14,0.007906
VodkaBeatsCube,239,42,43,85,12,0.103862
WISCOrear,15,12,4,16,13,0.038304
WavesAndSaves,75,48,110,158,12,0.077165
Wetness_Pensive,17,7,7,14,12,0.02322
XxSpaceGnomexx,14,6,2,8,13,0.033848
Y0___0Y,38,31,12,43,13,0.055234
Zagden,48,29,20,49,12,0.057485
airbear13,25,5,3,8,13,0.023005
badnuub,13,4,5,9,13,0.019641
barchueetadonai,29,9,12,21,12,0.039871
benfromgr,15,5,3,8,14,0.027243
betty_white_bread,51,9,14,23,12,0.009719
bruce_cockburn,15,5,3,8,13,0.025023
calguy1955,32,16,7,23,12,0.038073
callmejay,24,9,7,16,12,0.010574
chiaboy,55,13,11,24,12,0.039371
cromethus,24,13,5,18,13,0.048155
curien,44,14,11,25,12,0.037385
davethompson413,10,6,2,8,13,0.015883
ddoyen,13,9,5,14,12,0.028866
digbyforever,17,11,3,14,12,0.018192
discourse_friendly,190,54,48,102,12,0.081923
eggoed,26,11,6,17,13,0.025185
epsilona01,60,23,16,39,13,0.071373
etoneishayeuisky,47,8,5,13,12,0.037166
frisbeejesus,31,22,14,36,13,0.05883
gregaustex,23,19,5,24,12,0.059716
hblask,35,12,8,20,12,0.031355
jetpacksforall,102,30,31,61,12,0.069045
jinxbob,10,6,3,9,13,0.017553
jmnugent,21,11,7,18,13,0.02036
just_helping,175,49,61,110,12,0.107314
kinkgirlwriter,44,16,11,27,12,0.063227
luminatimids,17,9,4,13,12,0.04035
maybeafarmer,11,3,0,3,0,0.028484
mcgunner1966,54,17,15,32,13,0.045889
morrison4371,20,8,4,12,13,0.046934
mortemdeus,10,7,3,10,13,0.023589
mycall,16,12,7,19,13,0.047736
mypoliticalvoice,11,2,0,2,0,0.016497
news_feed_me,13,6,1,7,13,0.038231
nylockian,15,7,3,10,13,0.020446
phoenix1984,17,9,5,14,13,0.02148
pliney_,13,7,3,10,13,0.022322
ptmd,19,3,4,7,12,0.012324
reasonably_plausible,25,14,9,23,13,0.038597
roehnin,15,7,6,13,12,0.033562
semideclared,77,20,25,45,12,0.050648
siberianmi,25,17,8,25,12,0.040991
silverionmox,145,25,25,50,12,0.021639
socialistrob,36,11,11,22,13,0.03157
the_calibre_cat,106,24,33,57,12,0.068405
theresourcefulKman,20,7,4,11,13,0.025785
ttown2011,177,69,48,117,12,0.094517
wereallbozos,11,4,3,7,12,0.020339
yo2sense,28,11,9,20,13,0.03877
youcantexterminateme,10,1,1,2,13,0.007752
zayelion,41,10,3,13,12,0.026022
DanforthWhitcomb_,182,46,55,101,12,0.067476
ERedfieldh,41,13,6,19,12,0.051949
ItsAGoodDay,10,3,1,4,13,0.002821
Sarlax,32,12,8,20,12,0.026984
WingerRules,22,12,9,21,12,0.03378
Basic_Cockroach_9545,23,7,26,33,11,0.000715
Alan5953,12,3,2,5,13,0.000404
Cultist_O,29,8,7,15,12,0.000815
Dyn-O-mite_Rocketeer,17,3,2,5,13,0.000233
ElysiX,26,8,3,11,13,0.002306
Level-Ladder-4346,11,7,2,9,13,0.000933
Ok_Border419,16,4,4,8,13,0.001526
PoofyGummy,12,1,0,1,0,0.000111
SINWillett,12,4,4,8,14,0.000157
StillLikesTurtles,29,8,4,12,12,0.001559
TemperatureThese7909,63,36,4,40,12,0.006826
TonySu,12,6,3,9,13,0.001945
Uhhyt231,83,11,5,16,13,0.00224
horshack_test,68,8,4,12,13,0.001676
ninja-gecko,43,16,8,24,12,0.002477
ralph-j,69,14,1,15,13,0.00234
rgtong,13,3,3,6,13,0.000158
the_brightest_prize,31,8,4,12,13,0.001376
-dag-,23,9,7,16,13,0.032257
0WatcherintheWater0,23,14,12,26,12,0.038935
1ameve,14,4,6,10,13,0.021565
3xploringforever,20,6,12,18,12,0.042437
AdumbroDeus,12,5,5,10,12,0.020106
AmigoDelDiabla,32,13,11,24,12,0.035752
Appropriate_Ear6101,13,5,4,9,12,0.02395
Banes_Addiction,19,14,7,21,13,0.046398
Big-Willingness3384,11,7,6,13,13,0.040711
Bimlouhay83,11,4,2,6,13,0.011201
BitterFuture,176,35,42,77,12,0.059717
BotElMago,86,24,17,41,12,0.04235
BrainDamage2029,23,21,13,34,12,0.039595
Brickscratcher,60,18,17,35,12,0.047878
CelestialFury,27,9,7,16,13,0.03111
Cluefuljewel,37,11,6,17,12,0.055273
ComprehensiveHold382,13,5,2,7,13,0.021538
Davec433,22,12,5,17,12,0.014924
DeadlySpacePotatoes,19,6,5,11,13,0.013324
Delanorix,55,26,11,37,12,0.047687
Domiiniick,12,8,2,10,14,0.023893
Done327,16,10,2,12,14,0.042091
Dr_CleanBones,49,19,17,36,12,0.032795
Flor1daman08,138,30,35,65,11,0.048439
FreeStall42,53,16,18,34,12,0.051082
FreedomPocket,12,3,3,6,13,0.012667
Funklestein,70,24,13,37,13,0.068583
GabuEx,17,11,3,14,13,0.021484
GitmoGrrl1,12,2,4,6,13,0.010605
Grumblepugs2000,16,4,2,6,13,0.011511
GuyInAChair,57,17,14,31,12,0.056575
Ill_Decision2729,26,13,9,22,11,0.057946
Inevitable-Ad-9570,16,3,3,6,13,0.01143
InquiringAmerican,10,5,1,6,13,0.015789
ItsMichaelScott25,27,10,9,19,13,0.054598
Jake0024,79,17,15,32,12,0.012681
Kevin-W,47,14,17,31,13,0.054734
KevinCarbonara,53,18,17,35,12,0.053949
Kuramhan,64,37,26,63,12,0.084499
Leopold_Darkworth,24,17,13,30,13,0.043812
LifeScientist123,10,4,4,8,13,0.013896
LolaSupreme19,22,4,1,5,13,0.025084
Mishigots,11,2,1,3,13,0.014777
Mjolnir2000,16,14,6,20,12,0.047491
Mrgoodtrips64,34,17,13,30,12,0.054962
Mztmarie93,42,16,23,39,12,0.038916
New_Seaweed_6554,18,9,5,14,12,0.041685
NoAttitude1000,81,15,15,30,12,0.044723
Ok_Juice4449,11,4,4,8,13,0.024241
Optimal_Let7233,17,4,5,9,14,0.011245
Petrichordates,98,46,34,80,12,0.068851
PinchesTheCrab,22,8,10,18,12,0.05267
PoliticalJunkDrawer,14,10,4,14,13,0.015817
Positronic_Matrix,10,7,4,11,13,0.024922
Rhoubbhe,20,7,5,12,12,0.049734
Robot_Alchemist,25,7,8,15,13,0.012091
Savethecannolis,23,7,12,19,12,0.041715
SchuminWeb,32,11,14,25,13,0.046859
SparksFly55,72,37,29,66,12,0.052904
StromburgBlackrune,16,8,2,10,13,0.027205
Successful-Extent-22,29,6,11,17,13,0.025802
Tadpoleonicwars,39,6,6,12,12,0.014151
TheBigGoat44,17,9,6,15,13,0.017419
TheGOPisTheDeepState,10,4,1,5,13,0.01482
TheMadTemplar,10,6,4,10,12,0.02744
TheZarkingPhoton,14,6,6,12,13,0.038666
The_Awful-Truth,26,10,70,80,12,0.026991
Utterlybored,31,16,9,25,12,0.048612
Weak-Elk4756,14,6,1,7,13,0.016442
Za_Lords_Guard,24,8,11,19,13,0.022981
akcrono,13,4,6,10,13,0.011531
alexmikli,10,6,8,14,13,0.023434
almightywhacko,33,18,5,23,14,0.067742
au-smurf,12,6,5,11,13,0.014818
ballmermurland,74,27,28,55,12,0.066961
billpalto,74,27,8,35,12,0.087572
burritoace,32,14,10,24,12,0.060211
candre23,47,19,12,31,12,0.058447
cat_of_danzig,21,8,4,12,13,0.012072
che-che-chester,17,6,6,12,13,0.020934
chiclets5,15,3,2,5,13,0.027399
clarkision,12,4,2,6,13,0.025371
clintCamp,20,11,8,19,13,0.05351
coskibum002,48,18,14,32,12,0.060174
daniel_smith_555,29,9,5,14,13,0.046897
dravik,21,15,7,22,13,0.030778
eh_steve_420,66,17,29,46,12,0.054706
ewokninja123,25,7,6,13,13,0.024089
foul_ol_ron,14,8,5,13,13,0.027272
frostyflakes1,10,4,3,7,13,0.034309
getawarrantfedboi,23,14,8,22,12,0.044081
gonz4dieg,18,13,8,21,13,0.040216
hairybeasty,13,4,0,4,0,0.037747
harrumphstan,31,15,11,26,12,0.040634
hereiswhatisay,14,3,2,5,14,0.036011
hryipcdxeoyqufcc,14,4,4,8,13,0.013412
j_ly,13,6,8,14,12,0.019737
jmac31793,13,7,4,11,13,0.023482
lionhearted318,35,18,10,28,12,0.02213
mia_elora,13,4,3,7,13,0.028353
mleibowitz97,10,7,4,11,13,0.017972
mosesoperandi,20,7,6,13,13,0.024977
navkat,19,7,7,14,13,0.036889
notpoleonbonaparte,15,7,4,11,13,0.016228
novagenesis,60,17,17,34,12,0.032359
o-Valar-Morghulis-o,11,3,5,8,13,0.022327
pgriss,20,15,10,25,12,0.04006
pomod,27,12,7,19,12,0.033109
punktualPorcupine,13,7,5,12,12,0.025559
reaper527,26,5,2,7,13,0.0451
repeatoffender123456,37,15,10,25,12,0.032613
slayer_of_idiots,113,37,16,53,12,0.04803
some1saveusnow,18,10,9,19,13,0.044493
spacegamer2000,13,6,2,8,13,0.017139
stoneimp,18,10,8,18,12,0.012415
swagonflyyyy,47,19,13,32,12,0.061065
thatthatguy,15,5,0,5,0,0.015042
thewoodsiswatching,13,7,3,10,13,0.019108
unknownpoltroon,19,13,9,22,12,0.038848
willowdove01,10,2,1,3,15,0.010618
wip30ut,18,7,7,14,13,0.038302
zackks,10,4,4,8,13,0.03173
zaoldyeck,178,56,51,107,12,0.074281
Boring_Clothes5233,16,6,11,17,12,0.002556
AldousKing,15,7,1,8,14,0.002126
BaronNahNah,17,4,0,4,0,0.001055
PushPopNostalgia,27,5,4,9,13,0.000402
Rhundan,190,41,11,52,12,0.005495
TheVioletBarry,77,8,3,11,13,0.001634
badass_panda,46,10,5,15,13,0.002021
homomorphisme,22,6,1,7,14,0.00108
scarab456,35,3,1,4,14,0.000141
Business-Stretch2208,21,6,18,24,12,0.000713
3superfrank,38,13,6,19,13,0.004373
Amazing_Might_9280,21,5,6,11,12,0.00026
BackpackJack_,10,5,0,5,0,0.000305
Finch20,16,5,0,5,0,0.000672
Fondacey,30,7,3,10,13,0.000618
KokonutMonkey,28,5,0,5,0,0.00073
Murky-Magician9475,117,21,20,41,12,0.002686
ProDavid_,277,45,24,69,12,0.004771
Rabbid0Luigi,22,5,21,26,12,0.000479
SANcapITY,58,14,6,20,13,0.001324
ZizzianYouthMinister,37,7,1,8,13,0.001415
Canuck_Voyageur,30,3,5,8,14,0.000489
21-characters,71,4,10,14,13,0.000306
GregHullender,11,2,0,2,0,0.000358
Pongpianskul,43,11,2,13,14,0.001478
SendMeYourDPics,31,2,0,2,0,0.000127
Capable-Art-1972,21,3,60,63,11,0.000305
Accomplished-Plan191,11,2,2,4,12,0.000286
Alesus2-0,35,16,4,20,13,0.001266
BloodyPaintress,12,6,7,13,11,0.000925
Clear_Newspaper4052,11,1,1,2,16,0.000273
EdelgardSexHaver,39,11,9,20,12,0.002296
Evening_Spot_5151,23,10,6,16,13,0.0007
ExpiredPleaseUpdate,17,3,3,6,13,0.000436
Gremlin95x,18,10,4,14,13,0.00364
HadeanBlands,231,40,32,72,11,0.005576
Imadevilsadvocater,224,57,57,114,11,0.026917
KrabbyMccrab,21,7,4,11,13,0.001965
LouisWillis98,11,3,2,5,13,0.000857
Lylieth,104,25,11,36,12,0.002482
MaximumOk569,21,10,6,16,12,0.002845
Molenium,10,2,3,5,11,0.000404
Munchkin_of_Pern,16,7,6,13,12,0.000824
NeoLeonn3,13,4,2,6,13,0.000369
NoWin3930,23,4,1,5,13,0.000648
Ok_Cup_5454,25,9,7,16,13,0.00831
Puzzleheaded-Bat-511,37,8,6,14,12,0.000865
Rainbwned,141,31,12,43,12,0.004595
Raise_A_Thoth,28,11,8,19,13,0.001663
Rakkis157,35,5,4,9,13,0.000416
Recent_Weather2228,13,5,1,6,13,0.002247
RickRussellTX,45,6,4,10,13,0.001133
Sigmatronic,12,2,1,3,14,0.000279
TheWhistleThistle,57,10,4,14,12,0.003672
ThirteenOnline,38,15,5,20,12,0.003623
Thoth_the_5th_of_Tho,57,32,17,49,11,0.006209
Toverhead,83,29,11,40,12,0.008732
UnicornForeverK,12,4,2,6,13,0.000508
VegetableBuilding330,11,4,2,6,13,0.000519
jatjqtjat,88,12,6,18,13,0.003868
jayeffkay,28,5,4,9,13,0.000349
laz1b01,12,5,1,6,13,0.000536
lee1026,118,28,23,51,12,0.012001
m_abdeen,10,4,3,7,12,0.001064
maximumhippo,11,2,1,3,14,0.000307
motherthrowee,26,6,1,7,13,0.000731
nuggets256,22,4,2,6,13,0.000833
stevie-antelope,32,8,6,14,13,0.001531
strikerdude10,23,7,2,9,13,0.002141
tbdabbholm,11,4,1,5,14,0.000416
theAltRightCornholio,27,9,9,18,11,0.017118
themcos,72,17,7,24,12,0.004117
viaJormungandr,24,11,4,15,12,0.002195
CptPatches,21,4,11,15,13,0.032576
Matt2_ASC,44,12,23,35,12,0.040896
MonarchLawyer,17,10,3,13,13,0.014716
See-A-Moose,12,8,3,11,13,0.020624
CrazyCoKids,17,1,41,42,11,0.000123
Constellation-88,61,10,11,21,11,0.003231
Greedy-Win-4880,30,5,3,8,13,0.000283
Helpful_Loss_3739,18,3,13,16,12,0.000258
Intelligent-Cow-7122,27,2,2,4,13,0.000258
Jakyland,23,5,1,6,12,0.000532
MarxCosmo,23,10,9,19,13,0.000943
MaxTheCookie,10,2,1,3,13,0.000284
ObsessedKilljoy,50,11,41,52,10,0.000888
Robie_John,32,7,8,15,13,0.001657
Tangentkoala,13,4,2,6,13,0.002359
TheTyger,37,11,10,21,12,0.002637
TomCormack,23,6,2,8,12,0.000388
hacksoncode,87,21,13,34,12,0.004333
helemaal,17,8,6,14,12,0.001258
jawrsh21,12,2,2,4,14,0.000564
juliacar,23,6,0,6,0,0.000864
knightress_oxhide,10,2,3,5,12,0.000283
majesticSkyZombie,111,24,21,45,12,0.00245
potatolover83,17,2,0,2,0,0.000374
rolyfuckingdiscopoly,16,6,2,8,13,0.000626
talashrrg,11,6,1,7,14,0.001188
tsisdead,17,6,7,13,13,0.000674
vettewiz,61,17,12,29,12,0.002934
weedywet,18,8,2,10,13,0.002983
xChops,14,9,1,10,13,0.001014
yankeeboy1865,13,4,2,6,14,0.00138
yogfthagen,15,7,3,10,12,0.003461
CurdKin,47,14,141,155,11,0.00295
-Ch4s3-,68,15,13,28,12,0.002333
33ITM420,30,6,2,8,13,0.005398
Able_Enthusiasm2729,19,4,7,11,13,0.002254
AdFun5641,19,9,2,11,13,0.003064
Agreetedboat123,61,16,19,35,12,0.003121
Altruistwhite,11,3,6,9,13,0.000764
BigDaddyDumperSquad,13,5,5,10,13,0.000936
BoyHytrek,23,8,7,15,12,0.001214
BurningEmbers978,39,8,7,15,13,0.003124
CMRSCptn,11,7,3,10,12,0.002093
Changer_of_Names,10,7,2,9,12,0.002027
CleverJames3,25,9,5,14,11,0.002978
CunnyWizard,62,14,9,23,12,0.00753
DMTwolf,17,6,3,9,14,0.002159
DaddyRocka,21,8,10,18,12,0.002434
Dependent-Tailor7366,10,4,3,7,12,0.001023
DevelopmentSad2303,14,6,4,10,12,0.002409
Doub13D,118,26,21,47,12,0.003486
DrRealName,19,6,3,9,13,0.003157
Dry-Tough-3099,43,10,5,15,13,0.003226
Eat--The--Rich--,13,6,2,8,13,0.0022
Emergency-Style7392,27,6,8,14,12,0.002386
Entire-Ratio-9681,11,3,0,3,0,0.00192
Exact-Joke-2562,21,7,5,12,13,0.001191
EyePharTed_,30,9,9,18,12,0.003008
Far_Mistake9314,12,5,3,8,13,0.001545
Financial_Shame4902,14,6,0,6,0,0.004125
FlounderCautious4523,12,11,2,13,13,0.001364
Full-Professional246,175,50,43,93,12,0.009469
FurryYokel,15,8,7,15,12,0.004647
GenghisKhandybar,12,5,5,10,12,0.006901
Green__lightning,75,28,9,37,13,0.007431
Here4Pornnnnn,48,10,6,16,13,0.002711
HereForTheBoos1013,15,8,7,15,12,0.004559
HeyYoisTaken,20,4,2,6,13,0.001086
ILikeToJustReadHere,21,3,2,5,13,0.000943
Icy-Exits,14,4,4,8,12,0.000894
ImmodestPolitician,16,6,6,12,12,0.002045
Internal_Kale1923,18,5,3,8,13,0.004626
ItsGrum14,29,12,10,22,12,0.001861
Jscapistm,15,6,6,12,12,0.001114
Kakamile,107,34,21,55,12,0.007318
KathrynBooks,19,4,2,6,12,0.000771
Kijafa,35,21,9,30,13,0.0027
KlausVonChiliPowder,31,18,10,28,12,0.00171
Korimito,38,3,4,7,12,0.001089
Kristoveles,18,5,3,8,13,0.00153
LivingGhost371,15,21,5,26,12,0.002432
MyNameIsNotKyle,29,12,5,17,13,0.002651
New_General3939,56,17,52,69,12,0.003777
No-Perspective3453,24,4,1,5,14,0.003586
NysemePtem,14,10,8,18,12,0.002399
Ok-External6314,18,7,4,11,13,0.003557
One-Independent8303,81,16,9,25,11,0.003081
Orphan_Guy_Incognito,69,23,23,46,12,0.011324
Perdendosi,12,7,1,8,13,0.001035
PinGroundbreaking754,11,2,1,3,14,0.000761
PirateMean4420,13,4,1,5,14,0.002442
Popular-Formal-7971,68,18,14,32,12,0.002846
PuzzleheadedShoe5829,11,2,175,177,11,0.000788
Randomousity,72,18,24,42,12,0.001875
Rightsideup23,11,1,0,1,0,0.00076
Shadruh,22,14,7,21,12,0.001823
SilenceDobad76,10,8,4,12,12,0.003932
Solnx,22,7,4,11,13,0.001518
Speedy89t,17,3,2,5,13,0.00233
Square-Dragonfruit76,47,15,26,41,12,0.002717
StopElectingWealthy,17,7,6,13,12,0.001708
Successful-Daikon777,13,6,4,10,13,0.002573
Thatsthepoint2,10,3,0,3,0,0.003036
The_Itsy_BitsySpider,37,16,10,26,12,0.002221
Think_Clearly_Quick,13,7,4,11,13,0.00229
VegetableComplex5213,20,3,3,6,12,0.000786
Warny55,63,19,15,34,12,0.002809
WeekendThief,13,2,1,3,14,0.000775
Zestyclose_Peanut_76,34,12,6,18,13,0.003284
alfredo094,21,8,9,17,12,0.002069
anewleaf1234,283,44,34,78,12,0.01187
camilo16,12,4,5,9,12,0.000865
cferg296,36,15,7,22,13,0.00176
fossil_freak68,107,18,15,33,12,0.001255
galaxyapp,10,4,1,5,13,0.002224
generallydisagree,53,27,16,43,12,0.005848
ghjm,16,2,2,4,13,0.000781
grayscale001,35,8,6,14,12,0.00275
iamintheforest,73,21,8,29,12,0.002525
iryanct7,51,34,16,50,11,0.008726
issuefree,68,10,18,28,12,0.002126
jaundiced_baboon,12,5,1,6,15,0.002195
joshdrumsforfun,24,6,8,14,12,0.001516
kingofcrosses,13,5,2,7,14,0.001369
koolaid-girl-40,45,9,5,14,14,0.002847
other_view12,26,7,6,13,13,0.003414
raven19528,12,3,1,4,13,0.001962
reefersutherland91,12,8,5,13,12,0.004364
richqb,11,5,4,9,13,0.001746
rickbubs,11,5,2,7,13,0.001699
sanguinemathghamhain,27,7,6,13,12,0.003091
santathecruz,13,2,3,5,13,0.000831
shadofx,18,5,2,7,13,0.00203
slowowl1984,20,4,0,4,0,0.003803
toolateforfate,10,5,2,7,13,0.002152
trevor32192,97,22,17,39,12,0.005054
ttw81,13,4,3,7,12,0.002019
unscanable,59,20,18,38,12,0.003093
ute-ensil,13,3,1,4,13,0.000775
whiskey_piker,14,4,2,6,13,0.001519
wibbly-water,38,9,5,14,12,0.001158
Dare_Ask_67,18,4,47,51,11,0.000172
AleristheSeeker,48,10,7,17,13,0.001359
Anti_colonialist,14,6,3,9,13,0.002915
Cacafuego,13,5,2,7,13,0.001001
CaptainONaps,22,2,1,3,14,0.000232
Destinyciello,253,52,49,101,12,0.005314
EmotionalSize5586,54,12,10,22,13,0.000707
EmptyDrawer2023,35,14,7,21,12,0.003244
Forsaken-House8685,75,27,14,41,12,0.021274
JuicingPickle,40,15,125,140,11,0.015466
MaloortCloud,15,5,0,5,0,0.001359
MelodiusRA,44,8,3,11,13,0.000415
Monte_Cristos_Count,24,3,1,4,14,0.001388
MrGraeme,22,5,4,9,12,0.002078
Natural-Arugula,51,17,14,31,12,0.002831
NoTomato7740,36,13,6,19,13,0.003021
No_Material7583,10,2,0,2,0,0.000858
NotMyBestMistake,71,23,10,33,12,0.004213
ScrupulousArmadillo,22,8,3,11,13,0.000385
Teddy_The_Bear_,43,12,7,19,12,0.001614
Throwaway7131923,10,5,32,37,11,0.000633
VortexMagus,17,5,1,6,13,0.001683
YossarianWWII,14,3,0,3,0,0.00069
abacuz4,42,11,14,25,12,0.003814
addictedtolife78,22,7,5,12,12,0.000954
deck_hand,15,7,2,9,13,0.00236
huntsville_nerd,27,7,5,12,12,0.002204
jweezy2045,239,29,25,54,12,0.000948
shouldco,55,12,15,27,11,0.002887
skdeelk,22,6,2,8,13,0.001013
DeathStrike56,15,4,11,15,12,0.001602
Agitated-Quit-6148,33,7,9,16,12,0.000177
AluminiumLlama,21,6,4,10,12,0.000486
NegevThunderstorm,23,6,1,7,14,0.002554
No-Dinner-5894,32,4,2,6,13,0.00174
ObsidianKing,16,2,2,4,13,0.000081
True_Ad_3796,12,5,2,7,13,0.001215
Tuvinator,16,3,5,8,12,0.000208
Desperate-Fan695,26,11,25,36,12,0.000826
AgitatedBadger,15,3,3,6,12,0.000116
Arthesia,15,12,2,14,13,0.002868
CartographerKey4618,80,27,21,48,12,0.003963
Gatonom,37,7,3,10,13,0.001724
Hellioning,54,13,0,13,0,0.002683
Past-Winner-9226,23,5,2,7,14,0.000418
VforVenndiagram_,11,5,1,6,13,0.000694
WinDoeLickr,28,8,6,14,13,0.0011
YardageSardage,48,6,2,8,13,0.001458
dejamintwo,17,4,35,39,12,0.000546
eggs-benedryl,27,4,1,5,13,0.000123
funglegunk,20,6,4,10,13,0.000177
Downtown-Act-590,31,18,26,44,11,0.002231
EH1987,34,9,5,14,12,0.002747
HeroBrine0907,19,5,23,28,12,0.00032
Huge-Nerve7518,21,4,3,7,12,0.001849
Km15u,31,5,3,8,12,0.000624
Low_Imagination_1224,12,2,14,16,12,0.000153
Mcwedlav,26,8,2,10,14,0.001908
MediumAids,58,10,7,17,12,0.002726
Pizzaflyinggirl2,11,2,2,4,12,0.000153
Puresuner,29,7,6,13,12,0.000544
RevolutionaryGur4419,160,28,28,56,12,0.010635
Technical-King-1412,36,16,6,22,12,0.002677
TurbulentArcher1253,120,16,15,31,12,0.002735
help_abalone,33,8,1,9,12,0.021667
kinrove1386,306,56,51,107,11,0.005466
DowntownManThrow,44,9,53,62,12,0.000947
Advanced-Ad6210,21,2,0,2,0,0.000314
Aggravating_Lemon631,10,3,0,3,0,0.001411
Argo505,39,2,0,2,0,0.000305
AspirationAtWork,72,10,9,19,13,0.003658
Birb-Brain-Syn,26,13,4,17,13,0.001421
Elegant-Pie6486,26,4,2,6,12,0.000498
Fun_Squirrel_9539,11,2,0,2,0,0.000484
Jakobites,17,5,2,7,13,0.000814
Kotoperek,35,18,9,27,12,0.002874
LookWhatlCanDo,32,3,2,5,13,0.000409
Relevant_Actuary2205,76,19,10,29,12,0.001838
Rude_Lengthiness_101,20,6,7,13,13,0.000498
SpecialistAddendum6,11,1,0,1,0,0.000287
aardvark_gnat,72,18,61,79,11,0.001265
bettercaust,92,26,27,53,12,0.003657
dukeimre,26,10,6,16,12,0.001756
duskfinger67,36,12,5,17,13,0.001108
fascistp0tato,28,4,24,28,12,0.000527
frickle_frickle,28,7,6,13,12,0.002667
fuckounknown,20,5,10,15,13,0.00048
heidismiles,33,13,6,19,12,0.001287
rightful_vagabond,29,4,2,6,13,0.000886
sxaez,22,5,1,6,13,0.00049
vote4bort,78,10,6,16,12,0.000931
vuzz33,37,3,2,5,13,0.000466
Embarrassed-Dress211,11,2,56,58,12,0.000042
Ace0spades808,21,8,5,13,12,0.000669
AdHopeful3801,23,4,4,8,12,0.000494
Affectionate-War7655,27,5,4,9,12,0.001605
Al-Rediph,13,5,1,6,1,0.000256
Antique-Ad-9081,13,5,4,9,13,0.001374
Arstanishe,28,17,10,27,12,0.002842
CallMeCorona1,35,8,4,12,12,0.000825
CocoSavege,57,18,14,32,12,0.002771
HazyAttorney,75,20,15,35,12,0.003347
LordSwedish,11,7,4,11,13,0.000489
MagicalMonarchOfMo,10,2,1,3,1,0.000175
MennionSaysSo,21,13,4,17,13,0.005799
Mrs_Crii,48,14,12,26,12,0.008272
Owlblocks,21,4,3,7,13,0.001552
Particular-Way-8669,13,4,4,8,13,0.000463
Personal-Advance-494,20,6,5,11,12,0.00051
RemoteCompetitive688,51,12,6,18,13,0.003426
SatisfactoryLoaf,10,2,0,2,0,0.00025
Spirited-Awareness31,11,3,1,4,14,0.000186
Stereo_Jungle_Child,41,24,5,29,12,0.004198
SwagginOnADragon69,23,9,5,14,12,0.002567
Teleporting-Cat,13,5,6,11,12,0.000257
The-_Captain,15,13,84,97,11,0.001726
_Richter_Belmont_,35,20,4,24,12,0.001311
chaucer345,19,2,190,192,11,0.000182
eyetwitch_24_7,17,1,0,1,0,0.000175
fox-mcleod,93,26,24,50,12,0.010382
garnet420,21,9,4,13,12,0.000739
ja_dubs,14,8,8,16,12,0.001922
libra00,50,8,7,15,12,0.001966
mishaxz,38,6,2,8,14,0.000786
parsonsrazersupport,25,8,8,16,12,0.000669
rustyseapants,13,5,1,6,14,0.002111
slypool,10,5,4,9,12,0.000914
stereofailure,16,4,4,8,13,0.00069
Even-Ad-9930,16,2,119,121,11,0.000146
--o,31,6,10,16,12,0.001036
10ebbor10,34,11,8,19,12,0.003681
4art4,29,26,10,36,12,0.002586
AcceptablePea262,54,14,9,23,13,0.004046
Accomplished_Tour481,29,9,6,15,13,0.016983
Admirable-Lecture255,11,5,4,9,13,0.003547
Alive-Necessary2119,62,13,12,25,12,0.002946
Angsty-Panda,22,4,5,9,12,0.001131
ApeAF,11,8,4,12,12,0.007859
ArCSelkie37,10,7,5,12,13,0.002002
Baby_Needles,35,13,15,28,12,0.02589
BaguetteFetish,33,17,16,33,12,0.00264
BillionaireBuster93,54,14,29,43,12,0.004171
Brilliant-Lab546,25,12,8,20,13,0.002187
CallItDanzig,28,8,10,18,13,0.002691
CaptCynicalPants,93,44,20,64,12,0.006149
CaptainMalForever,21,5,2,7,13,0.001671
Choperello,30,7,5,12,12,0.001412
Classic_Season4033,12,2,1,3,1,0.000845
CnC-223,54,14,8,22,13,0.004908
Deep-Two7452,17,6,5,11,12,0.001509
Diligent_Pie317,11,8,4,12,12,0.001404
DoeCommaJohn,33,36,6,42,13,0.005372
Extinction00,12,4,3,7,13,0.000869
FatnessEverdeen34,10,2,2,4,14,0.000758
FuckItImVanilla,16,3,3,6,13,0.000771
Hatta00,11,6,4,10,13,0.001476
HugsForUpvotes,23,8,6,14,13,0.002706
HumanDissentipede,16,3,4,7,13,0.000846
I_am_the_Jukebox,64,19,19,38,12,0.003775
Insectshelf3,42,17,14,31,11,0.005945
Jaysank,13,9,0,9,0,0.001982
Leather_Preference67,13,6,5,11,12,0.001835
Maximum_Error3083,20,6,2,8,13,0.001325
Next_Yesterday5931,14,5,1,6,13,0.00244
Obi-Brawn-Kenobi,11,4,4,8,13,0.001484
Past-Community-3871,10,6,2,8,13,0.001585
Planterizer,16,3,4,7,13,0.00093
Pristine_Club_3128,64,13,10,23,12,0.002208
Real-Telephone4077,33,12,5,17,13,0.004512
Rehcamretsnef,18,6,1,7,13,0.00477
RetreadRoadRocket,31,5,3,8,12,0.003422
Reynor247,10,5,1,6,12,0.002291
SLAMMERisONLINE,16,4,3,7,13,0.000799
Sayakai,27,7,5,12,12,0.001679
Sea-Storm375,11,4,2,6,13,0.001015
Several_Leather_9500,10,5,3,8,13,0.001816
SingleMaltMouthwash,28,7,6,13,12,0.004516
Soft_Accountant_7062,83,16,14,30,12,0.004212
Successful-Shopping8,39,5,3,8,12,0.001262
Suitable-Activity-27,22,6,3,9,13,0.000912
TheDrakkar12,19,9,104,113,11,0.001498
The_World_May_Never,46,15,11,26,11,0.001956
ThisOneForMee,14,2,1,3,14,0.000746
X-calibreX,39,8,8,16,12,0.003549
abstractengineer2000,37,8,11,19,12,0.003956
amonkus,13,5,3,8,13,0.002105
badlyagingmillenial,13,2,0,2,0,0.000737
cairnrock1,23,5,5,10,13,0.000831
climbstuff32,13,4,2,6,13,0.000825
dommmm9,11,2,1,3,14,0.000743
fingerchopper,10,4,3,7,13,0.001106
imoutofnames90,11,2,1,3,13,0.000746
jwrig,54,22,12,34,12,0.003769
mormagils,48,17,10,27,12,0.025989
muyamable,16,13,3,16,13,0.002233
neotericnewt,67,17,17,34,12,0.004794
newshirtworthy,11,2,2,4,13,0.000737
permanentimagination,13,2,1,3,14,0.000747
raouldukeesq,29,12,8,20,12,0.005142
tbombs23,13,3,3,6,13,0.001911
xxconkriete,27,11,9,20,12,0.003427
FairDinkumMate,13,7,99,106,11,0.000805
11grim,18,6,3,9,12,0.003129
AnimatorDifficult429,16,3,1,4,13,0.000648
AnxiousChaosUnicorn,23,8,9,17,11,0.002099
Arnaldo1993,27,5,2,7,13,0.001076
AtmosphericReverbMan,44,13,16,29,13,0.003316
BoogerMagnolia,21,5,6,11,12,0.000846
CEO-Soul-Collector,16,7,5,12,13,0.002532
CalLaw2023,86,15,12,27,12,0.00548
ChickerWings,26,10,4,14,13,0.003563
Chocotacoturtle,21,7,5,12,13,0.013866
CodWonderful2045,15,2,0,2,0,0.00135
Colluder,18,5,7,12,13,0.002632
Dave_A480,23,3,1,4,13,0.000652
DisgruntledWarrior,13,2,1,3,13,0.000669
EksDee098,28,6,8,14,11,0.001004
Emotional-Tailor-649,16,5,4,9,12,0.001565
Former_Star1081,22,8,5,13,12,0.004301
FrgTurdeson,65,9,13,22,12,0.002595
Frylock304,48,13,26,39,12,0.002466
Gexm13,23,9,9,18,12,0.001563
GiveMeBackMySoup,30,16,10,26,11,0.005161
Guldur,13,3,1,4,12,0.002001
ImReverse_Giraffe,33,11,10,21,13,0.002216
JohnWittieless,21,10,5,15,12,0.002187
Lagkiller,36,4,5,9,13,0.00094
Lost-Letterhead-6615,12,2,3,5,13,0.001187
Majestic_Horse_1678,12,4,2,6,13,0.001888
Message_10,18,8,4,12,12,0.001046
Obvious_Chapter2082,49,19,12,31,12,0.014819
Olderscout77,28,6,6,12,12,0.02265
PineBNorth85,17,9,9,18,13,0.0023
Pockydo,11,3,2,5,13,0.000795
PrimaryInjurious,81,43,24,67,12,0.008296
Rationally-Skeptical,30,10,5,15,12,0.000697
RequirementRoyal8666,26,11,6,17,12,0.005148
Rusty-Shackleford000,69,13,12,25,12,0.003101
South-Rabbit-4064,45,8,5,13,13,0.018608
Super_Mario_Luigi,18,11,4,15,12,0.005784
T2Drink,11,3,3,6,11,0.000936
ThatOneAttorney,12,6,1,7,13,0.002515
ThatOtherGuyTPM,51,12,14,26,12,0.010233
Thuis001,36,10,8,18,13,0.001372
Writing_is_Bleeding,20,4,8,12,12,0.000729
YouLearnedNothing,47,21,16,37,12,0.004877
ZappSmithBrannigan,31,10,7,17,12,0.003044
Zauberer-IMDB,14,5,4,9,12,0.001195
alaskanperson,21,7,4,11,13,0.002857
atred,25,8,6,14,12,0.005115
captainhukk,19,7,6,13,12,0.002478
deadpool_pewpew,14,4,2,6,12,0.001704
dr_pepper_35,10,7,2,9,13,0.001444
ecafyelims,27,9,5,14,13,0.00157
insaneHoshi,38,11,12,23,12,0.003976
kkdawg22,21,7,6,13,12,0.001916
lordtrickster,17,4,4,8,12,0.002272
mapadofu,21,6,2,8,13,0.00246
mikeber55,15,7,4,11,13,0.006283
mormonatheist21,15,2,1,3,12,0.00065
ranchojasper,15,6,6,12,13,0.004695
revertbritestoan,85,13,14,27,12,0.002135
rollem,22,16,6,22,12,0.007616
sourcreamus,31,7,4,11,12,0.002024
wydileie,39,11,9,20,13,0.004003
Fando1234,10,4,10,14,12,0.000606
No-Mushroom5934,10,4,0,4,0,0.000291
Royal_Negotiation_91,67,23,11,34,13,0.004409
Fickle-Syllabub6730,12,0,15,15,12,0
Anomander,138,20,12,32,13,0.002117
Fauropitotto,54,11,9,20,13,0.000425
InfernalOrgasm,158,19,20,39,13,0.001819
RottenMilquetoast,13,4,0,4,0,0.000549
Treethorn_Yelm,20,4,0,4,0,0.000326
bi_polar2bear,19,4,1,5,14,0.000391
cornholio8675,10,2,1,3,13,0.000197
countrykev,39,14,11,25,12,0.043118
kerouak,12,3,1,4,14,0.000351
lnkprk114,11,6,6,12,12,0.004946
FishFollower74,13,3,9,12,13,0.000178
Impressive-Floor-700,32,5,4,9,14,0.000229
NightflowerFade,10,4,3,7,13,0.026108
amiibohunter2015,11,3,1,4,15,0.021848
checker280,78,23,18,41,12,0.023595
dannypdanger,11,2,2,4,13,0.000477
tehzayay,11,2,1,3,14,0.000206
FlanneryODostoevsky,38,7,248,255,10,0.014799
00zau,13,9,5,14,13,0.001867
4bkillah,11,5,2,7,13,0.001658
Actual_Confusion7140,20,10,10,20,13,0.003352
Adventurous_Ad7442,14,4,4,8,12,0.001909
Alternative_Oil7733,30,7,7,14,12,0.002686
Analyst-Effective,10,3,0,3,0,0.003361
Angel1571,42,19,14,33,12,0.004193
Apprehensive_Song490,25,7,4,11,13,0.002023
Appropriate_Fly_6711,34,3,2,5,13,0.001608
Ayslyn72,18,3,2,5,13,0.001568
BahnMe,11,2,2,4,13,0.001717
Both-Structure-6786,14,9,0,9,0,0.004381
Bottlecapzombi,27,9,7,16,12,0.002975
Bourbon-Decay,20,10,8,18,12,0.028032
Classic-Obligation35,14,4,1,5,13,0.002384
CobraPuts,15,8,5,13,11,0.007921
CosmicLovepats,24,4,1,5,14,0.002934
CosmicSoulRadiation,14,5,2,7,13,0.003838
Darkagent1,23,7,6,13,13,0.002222
DeathMetal007,15,7,6,13,12,0.002315
Destroyer_2_2,47,12,12,24,12,0.002436
DungeonJailer,20,4,2,6,12,0.002907
EclipseNine,28,8,8,16,12,0.002126
Eden_Company,18,7,5,12,13,0.002355
ElATraino,14,2,2,4,13,0.001658
Evilsushione,25,9,10,19,12,0.002275
FetusDrive,59,12,12,24,12,0.003266
Few_Mistake4144,31,9,11,20,12,0.001989
GalaXion24,43,10,18,28,11,0.004597
Garganello,35,7,8,15,11,0.008222
Glorfendail,54,14,10,24,12,0.002521
GrowFreeFood,39,11,12,23,12,0.02753
Honeycrispcombe,21,9,6,15,12,0.002294
Hothera,26,7,5,12,13,0.0031
Illustrious_Ring_517,15,1,0,1,0,0.001559
ImRightImRight,11,4,3,7,12,0.002346
JohnLockeNJ,28,6,3,9,13,0.003337
KaikoLeaflock,10,7,5,12,12,0.003639
Kerostasis,67,23,12,35,12,0.003859
Kr1spykreme_Mcdonald,14,3,1,4,14,0.002774
Large-Flamingo-5128,17,5,5,10,13,0.001659
Leon_Thomas,26,6,2,8,13,0.003398
ManufacturerVivid164,19,5,4,9,13,0.001721
MartyTax,12,2,1,3,1,0.00156
Maximumoverdrive76,31,8,8,16,12,0.002414
Me_U_Meanie,11,4,3,7,13,0.001586
MeowTheMixer,10,4,7,11,12,0.001623
NTXGBR,14,3,2,5,13,0.001655
NeuroticKnight,17,3,3,6,13,0.001637
No-Somewhere-7069,46,6,6,12,13,0.002017
Noctudeit,10,4,1,5,13,0.001799
Odeeum,15,2,5,7,12,0.00189
Ok-Condition-6932,22,4,3,7,13,0.001607
Ok_Swimming4427,24,6,3,9,13,0.002947
Ossevir,10,7,4,11,13,0.002663
Outcast129,19,7,7,14,12,0.003007
PaxNova,35,14,8,22,13,0.003918
PeteMichaud,17,5,1,6,13,0.002393
PopTough6317,27,10,6,16,13,0.00248
PreviousCurrentThing,53,24,27,51,12,0.012925
ProRuckus,71,13,5,18,12,0.004341
Pyrostemplar,11,3,2,5,13,0.002217
ReactionAble7945,77,10,6,16,13,0.002097
RedOceanofthewest,53,13,19,32,12,0.004733
Responsible_Dream282,18,6,5,11,13,0.00234
Rob__T,12,5,4,9,13,0.002804
Ruger1958,11,3,3,6,13,0.001917
Sartres_Roommate,15,6,2,8,14,0.003994
ScalesOfAnubis19,95,24,17,41,12,0.00512
Sea_Section_9861,12,4,0,4,0,0.002927
Sharkbait_ooohaha,23,6,5,11,12,0.003039
SmartYouth9886,23,2,1,3,14,0.001703
SnappyDresser212,15,4,6,10,13,0.002749
Some_Excitement1659,10,3,5,8,12,0.001602
SophonParticle,11,2,0,2,0,0.001855
Sovereign_Black,17,4,3,7,12,0.00162
Spaniardman40,17,5,1,6,14,0.002844
Stopper33,10,8,1,9,13,0.015953
TarumK,25,6,9,15,12,0.003228
Tea-Unlucky,10,9,5,14,13,0.002681
Tea_Time9665,24,3,4,7,13,0.001614
The-Gobba-Ghoul,19,2,5,7,13,0.002705
TheAzureMage,95,21,20,41,12,0.00425
TheRoadsMustRoll,14,2,2,4,13,0.001602
The_Bjorn_Ultimatum,19,7,3,10,13,0.001671
VassalforThy,11,3,1,4,14,0.001869
Wingerism014,16,3,3,6,12,0.001619
Xanith420,39,10,6,16,12,0.001857
airboRN_82,63,7,6,13,12,0.001804
aurora-s,18,4,2,6,13,0.001701
awfulcrowded117,15,5,2,7,14,0.003414
canned_spaghetti85,30,4,3,7,12,0.001915
colt707,17,7,2,9,14,0.003024
crashfrog05,111,26,13,39,12,0.003245
csopinion,10,3,30,33,12,0.002917
desgasser,10,3,1,4,12,0.002032
ethical_arsonist,34,7,3,10,13,0.002491
everydaywinner2,15,9,5,14,13,0.004942
ferdaw95,26,7,8,15,13,0.003232
goldenroman,10,5,4,9,12,0.002671
happyclam94,18,3,1,4,14,0.001562
iamcleek,20,12,2,14,13,0.002183
icecubtrays,13,4,2,6,13,0.002226
imthesqwid,16,6,1,7,12,0.002098
jayzfanacc,12,2,1,3,13,0.001577
jbruce72,12,2,3,5,12,0.001567
jeffwulf,26,4,10,14,12,0.012784
lastberserker,21,7,6,13,12,0.002065
mackinator3,33,16,11,27,12,0.003228
morganational,14,6,5,11,12,0.003339
natelion445,31,6,7,13,13,0.001885
ncolaros,13,5,6,11,12,0.003172
nicksey144,13,5,5,10,12,0.003011
nowthatswhat,30,7,6,13,13,0.002994
olcrazypete,10,6,2,8,12,0.014434
pawnman99,24,8,10,18,12,0.002721
pcgamernum1234,36,13,10,23,12,0.003651
pickleparty16,16,7,6,13,12,0.001862
plummbob,14,3,4,7,12,0.001602
psychosisnaut,17,5,6,11,12,0.003052
rdsuxiszdix,43,5,5,10,12,0.001713
rogun64,12,14,3,17,13,0.015192
s_wipe,35,8,4,12,13,0.001755
seanflyon,27,5,2,7,12,0.00191
seedoilbaths,63,14,114,128,12,0.0183
serene_brutality,21,6,2,8,14,0.002023
serravee,10,3,2,5,13,0.001612
sincsinckp,35,7,6,13,13,0.003279
spectrehauntingeuro,21,7,6,13,13,0.00187
taeerom,26,7,6,13,13,0.003434
tastefulmalesideboob,26,43,46,89,12,0.004353
troycalm,13,4,1,5,13,0.002854
uisce_beatha1,18,1,1,2,13,0.001559
unlimitedzen,18,6,11,17,12,0.001866
unordinarilyboring,31,8,4,12,13,0.004277
whipsmartmcoy,11,4,3,7,12,0.002052
woailyx,31,11,4,15,13,0.003074
xFblthpx,11,4,3,7,13,0.001835
y0da1927,26,6,7,13,12,0.001836
ForgetfullRelms,22,3,5,8,13,0.00017
Bastiat_sea,19,12,7,19,12,0.001902
CarsTrutherGuy,60,18,12,30,12,0.003479
Plastic-Abroc67a8282,18,3,6,9,12,0.001176
PretendAwareness9598,17,10,3,13,13,0.003007
RedMarsRepublic,40,10,5,15,13,0.000862
StopblamingTeachers,22,6,20,26,12,0.000549
cantantantelope,18,12,5,17,11,0.003145
FuturelessSociety,97,24,64,88,12,0.003567
AgreeableMagician893,31,6,3,9,13,0.00071
Big_oof_energy__,11,5,6,11,13,0.001619
Blairians,38,10,3,13,13,0.002054
FockerXC,15,5,7,12,12,0.000568
JSmith666,57,9,7,16,13,0.000725
JadedDruid,17,9,6,15,13,0.000975
Just-Feedback-2223,25,1,0,1,0,0.000331
Northern64,11,3,2,5,13,0.000335
Plus-Plan-3313,11,6,6,12,12,0.000974
QueensOfTheNoKnowAge,13,4,2,6,13,0.000366
Salanmander,12,3,3,6,14,0.000356
Theomach1,59,7,11,18,13,0.000677
Vesurel,26,6,1,7,14,0.001299
Warchief_Ripnugget,23,8,9,17,13,0.000989
couldbemage,41,11,19,30,12,0.001744
furtive_phrasing_,27,5,47,52,11,0.00052
justanotherdude68,10,9,2,11,14,0.001369
rainman943,13,5,3,8,12,0.001553
sawdeanz,29,7,2,9,11,0.002339
someofyourbeeswaxx,12,1,1,2,14,0.000331
torytho,29,7,0,7,0,0.005849
Goggio,60,8,25,33,12,0.002464
Big-Bodybuilder-5035,15,3,5,8,13,0.000141
ChirpyRaven,15,7,1,8,14,0.000397
Giblette101,95,23,32,55,12,0.002604
PM_ME_YOUR_NICE_EYES,93,24,6,30,13,0.00537
SmarterThanCornPop,44,13,7,20,12,0.003152
Thumatingra,122,57,13,70,12,0.006112
bshum95,18,2,1,3,14,0.000113
oremfrien,20,8,10,18,12,0.000168
Haleakala1998,19,3,48,51,12,0.000206
Alternative_Pin_7551,66,16,7,23,12,0.016821
Ancient_Confusion237,52,7,4,11,12,0.001211
CremasterReflex,21,6,4,10,13,0.000926
DebutsPal,48,8,7,15,12,0.000869
GotAJeepNeedAJeep,53,16,9,25,13,0.00095
Maestro_Primus,12,6,4,10,12,0.002048
Mysteriousdeer,16,5,5,10,12,0.000481
No_Initiative_1140,26,6,4,10,12,0.000876
Playful_Ad_6773,13,3,2,5,12,0.000458
SamCam9992,12,9,2,11,13,0.001127
WippitGuud,16,5,3,8,13,0.000671
XenoRyet,105,26,7,33,12,0.005368
Zncon,38,13,13,26,12,0.001329
darwin2500,28,4,5,9,13,0.000708
lordnacho666,22,8,6,14,12,0.001891
onepareil,12,7,7,14,13,0.000523
Healthy_Shine_8587,28,6,268,274,11,0.000433
90daysismytherapy,23,7,6,13,12,0.002221
A_Soporific,24,8,6,14,12,0.002103
Academic_Guitar7372,10,3,0,3,0,0.001205
Acrobatic-Brother232,15,5,3,8,13,0.001445
After_Lie_807,22,14,10,24,12,0.007057
AlternativeDue1958,32,6,5,11,12,0.001244
Anna-Politkovskaya,10,4,2,6,13,0.001252
Anomalous-Materials8,13,6,2,8,13,0.001957
Anonymous_1q,125,32,24,56,12,0.002596
Any-Wheel-9271,17,3,3,6,13,0.001565
Automatic_Tackle_406,27,10,11,21,12,0.001687
Awkward-Estate-9787,70,10,12,22,12,0.002868
BadBoiy33,41,4,3,7,13,0.001226
Beautiful-Climate776,12,2,4,6,12,0.001192
BeeLamb,13,3,3,6,12,0.001176
Bilabong127,13,7,3,10,12,0.001237
BoltThrower28,12,4,2,6,14,0.00191
Buttercups88,10,3,1,4,13,0.002107
CalTechie-55,16,4,2,6,13,0.004812
Candid_Beat8390,28,6,6,12,13,0.001311
ChocFarmer,11,3,1,4,14,0.001515
Commercial_Pie3307,20,7,6,13,13,0.001505
Corrupted_G_nome,53,19,8,27,12,0.002544
CreativeContract2170,20,7,3,10,13,0.00201
DC2LA_NYC,17,7,5,12,12,0.001496
Dark1000,15,6,4,10,12,0.026329
Dazzling_Occasion_47,10,5,2,7,13,0.001698
Doc_ET,25,13,12,25,12,0.001764
EconomistAromatic497,10,3,1,4,13,0.001854
EdliA,17,4,0,4,0,0.001368
Effective_Jury4363,25,12,10,22,13,0.003241
Every3Years,35,6,6,12,12,0.002159
Eyuplove_,49,9,8,17,12,0.001812
FartingKiwi,17,11,4,15,13,0.002829
Fifteen_inches,40,12,10,22,12,0.002934
FreeGazaToday,31,10,6,16,12,0.002177
GarryofRiverton,18,5,4,9,12,0.001407
General_Day_3931,11,2,2,4,12,0.001385
GreatWhiteSalmon,11,3,0,3,0,0.002147
Hatook123,24,15,8,23,13,0.002973
Hellion_444,13,4,5,9,13,0.00124
HungryDepth5918,47,4,2,6,14,0.001555
Ihsan2024,13,3,3,6,12,0.001393
ImNoLawyer,12,5,2,7,13,0.014105
Imaginary-Orchid552,42,21,18,39,12,0.005159
Important_Pattern_85,16,3,4,7,12,0.001197
Infinite_Wheel_8948,28,13,10,23,12,0.003121
Initial_Cellist9240,15,3,1,4,12,0.001468
IslandSoft6212,31,5,4,9,13,0.001312
January_In_Japan,10,4,1,5,13,0.001768
JawtisticShark,26,11,8,19,12,0.001894
Jealous_Tutor_5135,12,2,1,3,14,0.002252
Jew_of_house_Levi,31,7,6,13,13,0.001426
JoJoeyJoJo,58,10,14,24,12,0.001812
Josvan135,70,53,10,63,11,0.004713
Kamamura_CZ,16,1,0,1,0,0.001167
Kingreaper,10,6,3,9,13,0.002306
Kman17,61,30,9,39,12,0.014244
Letshavemorefun,43,8,10,18,12,0.00149
Locrian6669,34,8,7,15,13,0.002071
LowRevolution6175,14,5,3,8,13,0.001343
MagnanimosDesolation,51,7,5,12,12,0.001271
Mazinderan,14,6,8,14,12,0.001811
McdoManaguer,13,4,2,6,12,0.00184
MercurianAspirations,18,10,2,12,13,0.001818
Mother_Sand_6336,36,8,8,16,12,0.003249
MyrddinTheKinkWizard,29,7,5,12,12,0.002789
Neither-Stage-238,11,6,4,10,11,0.001254
NotReadyForTomorrow,13,2,2,4,13,0.00117
Notachance326426,28,7,9,16,11,0.001361
OddCook4909,28,7,7,14,12,0.002036
Ok-Temporary-8243,24,3,4,7,12,0.001266
Ok_Stop7366,10,4,1,5,14,0.002092
Pale-Ad9012,10,3,29,32,11,0.001815
PapaverOneirium,53,22,22,44,12,0.003568
PassionGlobal,20,5,4,9,12,0.002156
Perfect_Security9685,55,7,12,19,11,0.001512
PerspectiveViews,30,11,9,20,12,0.001469
Playful_Programmer91,12,2,2,4,13,0.001172
PuckSenior,74,13,7,20,13,0.00494
RSmeep13,25,13,13,26,12,0.002122
RateEmpty6689,11,3,2,5,12,0.001271
ReOsIr10,32,8,4,12,14,0.001269
Relevant-Expert8740,10,3,2,5,12,0.00147
RiceGold3688,10,7,3,10,13,0.002125
Saargb,21,7,4,11,12,0.001262
SaucyWiggles,10,3,2,5,14,0.001187
Scumdog_312,10,7,8,15,13,0.002003
ShadowSniper69,15,2,1,3,13,0.001207
SimplyPars,10,1,0,1,0,0.001167
Skuggsja86,22,9,7,16,12,0.001709
Slackjawed_Horror,31,6,3,9,13,0.001252
Sloppykrab,14,9,5,14,12,0.002174
Slow-Seaweed-5232,12,7,3,10,12,0.00217
Socialimbad1991,24,8,6,14,12,0.007282
Square_Hat_3994,23,7,5,12,13,0.002574
Standard-Secret-4578,10,4,3,7,12,0.001966
Straight_Letter5819,10,4,5,9,12,0.001737
Sugarrrsnaps,12,3,2,5,13,0.001913
Suspicious-Raisin824,12,3,3,6,13,0.001906
Tanaka917,12,4,0,4,0,0.001235
Telaranrhioddreams,15,4,3,7,13,0.001548
Temporary-Truth2048,18,4,2,6,13,0.00138
TesalerOwner83,25,4,6,10,12,0.00203
The-Grand-Pepperoni,11,3,1,4,13,0.001188
TotaLibertarian,24,8,5,13,12,0.002708
True_Fill9440,10,2,3,5,13,0.001169
UsualPreparation180,10,3,2,5,12,0.003465
Vedic70,30,6,5,11,13,0.001447
Vikings_Pain,10,2,1,3,13,0.001182
Visible_Device7187,16,2,5,7,12,0.001185
Warm_Shoulder3606,10,5,1,6,15,0.001582
WillCode4Cats,12,3,5,8,12,0.001296
WlmWilberforce,11,7,6,13,13,0.002146
Worried4lot,12,3,2,5,13,0.001633
WreckinRich,32,7,6,13,12,0.002224
Wrld-Competitive,10,2,2,4,13,0.001181
Xolver,10,3,2,5,13,0.001208
aasfourasfar,12,2,1,3,14,0.001513
abn1304,21,7,3,10,13,0.001689
aguafiestas,13,3,2,5,14,0.001171
aspiringimmortal,53,7,41,48,11,0.001537
axp187,22,5,3,8,12,0.001504
bfg-best-fried-gandu,14,3,2,5,12,0.001378
bigbadaboomx,51,7,5,12,12,0.001399
bleahdeebleah,18,6,8,14,12,0.007273
bugsmaru,13,12,5,17,13,0.00187
chickensause123,18,1,0,1,0,0.001167
cindad83,12,4,6,10,12,0.001635
comment_i_had_to,29,7,5,12,13,0.001399
daoistic,26,9,7,16,12,0.001755
eldankus,16,4,5,9,12,0.001387
enlightenedDiMeS,13,3,53,56,12,0.001399
eteran,38,7,5,12,12,0.002077
etherealfox420,13,1,0,1,0,0.001167
harambeLover_69,12,2,1,3,13,0.001801
iAmBalfrog,10,3,1,4,14,0.001892
josh145b,68,16,16,32,12,0.003685
kvakerok_v2,12,5,2,7,13,0.002436
kwamzilla,36,12,8,20,12,0.003101
lalahair,27,7,51,58,12,0.002564
mem2100,23,5,7,12,13,0.001325
mini_macho_,14,3,2,5,12,0.001433
mmmsplendid,45,12,9,21,12,0.001617
moderatelymeticulous,15,5,18,23,12,0.00209
modernDayKing,41,11,15,26,12,0.014994
mrcsrnne,15,4,3,7,13,0.015253
nefarious_planet,18,9,4,13,12,0.001359
nickchecking,15,7,6,13,12,0.020811
qTp_Meteor,10,5,3,8,13,0.001406
revankk,23,5,5,10,12,0.001318
revilocaasi,30,10,10,20,13,0.001709
satyvakta,50,15,9,24,12,0.001583
scrambledhelix,29,5,8,13,13,0.001272
sharkbomb,13,2,1,3,14,0.001441
shoesofwandering,16,6,7,13,13,0.001686
shumpitostick,14,12,4,16,12,0.002306
sluuuurp,16,2,1,3,13,0.001311
spicymemesdotcom,31,12,9,21,12,0.003281
spongue,12,2,2,4,13,0.001215
stockinheritance,60,29,29,58,12,0.00345
stopbsingman,23,7,6,13,12,0.00272
subduedReality,12,2,0,2,0,0.00119
teateawea,15,7,5,12,12,0.001316
terminator3456,15,10,4,14,13,0.003151
tittyswan,22,6,5,11,12,0.001732
top0impact,38,8,12,20,13,0.001453
uber_neutrino,10,3,2,5,13,0.001203
vampiregamingYT,17,4,2,6,13,0.00289
walletinsurance,11,2,13,15,12,0.001331
xamxes,11,2,1,3,14,0.00117
zyrkseas97,14,3,3,6,12,0.002648
DarroonDoven,12,4,2,6,12,0.000436
SlipperWheels,82,12,8,20,12,0.001018
Starfleet-Time-Lord,10,5,2,7,13,0.00013
c0i9z,31,9,5,14,13,0.001766
custodial_art,96,26,24,50,12,0.001806
gate18,28,5,2,7,13,0.000513
medical_bancruptcy,17,2,4,6,13,0.000095
AutistAstronaut,25,6,3,9,12,0.00093
Cheshire_Khajiit,44,15,8,23,12,0.005614
GenTwour,22,3,1,4,14,0.000218
Letters_to_Dionysus,39,9,5,14,13,0.00114
Noodlesh89,62,14,12,26,12,0.003666
StormlitRadiance,13,4,1,5,13,0.000541
xvpawel,10,3,2,5,13,0.00023
Fulgore101,14,3,3,6,13,0.000292
NittanyOrange,16,6,3,9,13,0.00037
Quankers,27,5,5,10,12,0.000251
Sea-Chain7394,20,9,6,15,12,0.013401
SteedOfTheDeid,10,6,4,10,12,0.001669
eggynack,78,14,10,24,12,0.001082
h_lance,14,5,3,8,12,0.001487
traanquil,19,5,4,9,13,0.000275
History_Fanatic1993,12,2,22,24,12,0.000371
Charlie4s,57,17,11,28,12,0.002795
Impossible-anarchy,97,32,18,50,12,0.00293
MarkHaversham,40,9,11,20,12,0.000213
Swimreadmed,76,12,9,21,12,0.001677
authorityiscancer222,13,2,0,2,0,0.000321
nhydre,15,7,4,11,13,0.000227
0ldfart,11,3,0,3,0,0.00028
Garblin,23,7,2,9,13,0.001073
fwubglubbel,25,12,5,17,12,0.000743
monkey_gamer,11,3,3,6,14,0.00028
Interesting_Claim414,25,7,92,99,11,0.000234
Adorable_Ad_3478,27,12,7,19,11,0.001433
Appropriate_Owl_91,33,4,4,8,13,0.000694
BrokenManOfSamarkand,13,9,3,12,13,0.001136
CadenVanV,13,5,2,7,13,0.000867
ColTwang333,11,4,3,7,14,0.000419
Cross_examination,10,6,2,8,14,0.001167
Dr_G_E,18,7,3,10,12,0.001038
Efficient_Phase1313,11,5,4,9,13,0.000437
Evening-Skirt731,17,7,2,9,12,0.00205
GrungleMonke,51,9,12,21,13,0.000604
HakuOnTheRocks,10,4,6,10,13,0.000463
Harbinger2001,45,10,11,21,12,0.000792
HiHoJufro,12,5,5,10,13,0.000531
Kilkegard,14,5,3,8,13,0.000827
Lifemetalmedic,13,2,2,4,13,0.000364
Live-Cookie178,15,4,4,8,13,0.000353
Maximus3311,16,3,1,4,13,0.000993
Mediocre-Risk3581,15,6,5,11,12,0.000678
Neat_Rip_7254,32,5,6,11,12,0.000662
P4ULUS,22,3,2,5,13,0.000395
PlusAd4034,23,4,5,9,12,0.000543
Popular_Kangaroo5446,32,13,8,21,12,0.001253
PrettyChillHotPepper,26,6,8,14,11,0.000669
PuffyPanda200,12,9,6,15,12,0.001241
Quarter_Twenty,13,10,7,17,12,0.001015
ReturnPresent9306,15,6,6,12,13,0.002225
Rightricket,26,5,5,10,13,0.001012
Routine-Equipment572,15,5,2,7,14,0.000431
SufficientlyRested,21,6,8,14,12,0.001543
Suitable_Plum3439,10,3,5,8,12,0.000428
TheBouwerie,23,4,6,10,12,0.001139
TomatoTrebuchet,15,4,1,5,13,0.000612
Upset_Gerbil,17,5,3,8,13,0.000375
Weird-Translator6797,15,4,4,8,12,0.000424
What_the_8,18,9,6,15,12,0.001929
Zinged20,15,1,1,2,13,0.000345
asperatedUnnaturally,13,1,3,4,13,0.000345
bakeandjake,11,4,3,7,13,0.00053
bbcczech,15,3,5,8,13,0.000473
cp5184,40,8,11,19,12,0.008264
fghhjhffjjhf,27,4,1,5,13,0.00058
heywhutzup,23,4,4,8,13,0.000509
km3r,19,7,5,12,12,0.000877
lightmaker918,14,5,2,7,13,0.00047
nobaconator,13,5,3,8,12,0.000408
november512,11,4,4,8,13,0.000477
paikiachu,10,3,152,155,11,0.014803
renlydidnothingwrong,14,6,3,9,13,0.00056
rpolkcz,24,6,7,13,12,0.000391
trolletariat69,20,4,2,6,13,0.000391
Jimithyashford,10,3,64,67,11,0.009957
Aggressive-Story3671,32,7,8,15,13,0.001087
BitterGas69,29,11,9,20,12,0.003351
Budobudo,14,4,4,8,13,0.000479
Celebrinborn,27,15,8,23,12,0.002859
Didntlikedefaultname,64,22,18,40,12,0.002041
Essex626,14,1,1,2,14,0.000148
Final-Prize2834,12,7,6,13,12,0.000262
FormerLawfulness6,21,5,7,12,12,0.000975
Grand-Expression-783,16,6,0,6,0,0.000734
Hard_Corsair,13,4,4,8,12,0.000187
Krytan,25,7,3,10,13,0.001965
LocketheAuthentic,21,7,3,10,12,0.00257
Maximum-Lack8642,12,5,2,7,13,0.000648
Nervous_Ganache_9031,11,4,3,7,13,0.00049
NotRadTrad05,15,5,5,10,13,0.000183
Ponce2170,25,9,7,16,12,0.001938
PrimeWolf101,12,1,2,3,13,0.000148
SiPhoenix,26,12,11,23,12,0.001997
Talik1978,95,16,12,28,12,0.004117
Urbenmyth,17,4,0,4,0,0.000282
Various_Succotash_79,107,13,15,28,12,0.000466
Xralius,23,4,2,6,13,0.000284
_robjamesmusic,15,5,4,9,12,0.001484
alohazendo,27,5,4,9,13,0.000399
appealouterhaven,41,15,9,24,12,0.001478
decrpt,23,4,1,5,13,0.000688
grafknives,11,1,0,1,0,0.000148
hotlocomotive,13,6,5,11,11,0.000342
ofBlufftonTown,27,7,8,15,12,0.001071
speedyjohn,20,9,6,15,12,0.001367
todudeornote,17,9,4,13,13,0.008172
Ambiwlans,10,3,4,7,13,0.017769
Famous-Garlic3838,21,6,5,11,12,0.008407
Francois-C,10,2,2,4,13,0.00364
Frank_JWilson,33,14,10,24,12,0.036036
InFearn0,20,8,7,15,13,0.024115
Knight_Machiavelli,61,15,13,28,12,0.007665
OhWhatsHisName,11,4,3,7,13,0.005258
RexDraco,19,3,1,4,13,0.012575
RocketRelm,31,22,17,39,12,0.058572
Sufficient_Steak_839,14,8,5,13,13,0.018082
TBSchemer,11,5,4,9,13,0.008805
Xytak,18,9,9,18,13,0.010412
analogWeapon,17,5,7,12,13,0.027127
baby_budda,14,11,3,14,13,0.038866
cknight13,13,4,2,6,14,0.016314
daretoeatapeach,25,7,8,15,13,0.007152
eldomtom2,26,6,4,10,13,0.006105
kenlubin,14,6,7,13,13,0.017511
medhat20005,15,9,2,11,14,0.031466
nigel_pow,10,5,2,7,13,0.032489
schistkicker,25,12,11,23,13,0.047695
shamrock01,12,7,2,9,13,0.020787
that_husk_buster,12,8,3,11,13,0.040808
thewerdy,11,4,5,9,13,0.018508
warmwaterpenguin,11,3,2,5,13,0.015807
zonearc,12,2,2,4,13,0.004021
1ithurtswhenip1,12,2,1,3,13,0.000674
AlphaBetaSigmaNerd,77,15,14,29,11,0.001842
Apprehensive-Let3348,25,7,9,16,12,0.00066
Bootmacher,53,6,5,11,13,0.000767
BrooklynSmash,19,16,12,28,12,0.001262
CABRALFAN27,23,10,8,18,13,0.002962
Chemical_Big_5118,17,6,3,9,13,0.002485
Co-flyer,23,4,2,6,14,0.001466
Cold_Breeze3,45,12,10,22,12,0.002774
ConundrumBum,10,4,2,6,13,0.001916
DrawPitiful6103,13,3,1,4,13,0.000759
Easy_Language_3186,11,3,1,4,12,0.001927
Expert-Repair-2971,10,2,1,3,12,0.000675
GeekShallInherit,10,2,3,5,13,0.001792
Inside_Jolly,12,1,2,3,13,0.000641
JeruTz,15,8,3,11,13,0.002463
John-for-all,10,4,1,5,13,0.001395
Kaiisim,10,7,1,8,13,0.001302
KingJades,35,10,7,17,13,0.002528
Known_Week_158,11,11,3,14,13,0.002
LackingLack,10,2,0,2,0,0.001792
LordBecmiThaco,23,9,6,15,12,0.001552
Muninwing,28,12,12,24,12,0.001363
OneNoteToRead,32,7,6,13,13,0.001744
Qubit_Or_Not_To_Bit_,60,35,32,67,12,0.020545
ScannerBrightly,15,4,3,7,12,0.000718
TheButtDog,21,5,4,9,13,0.000775
Tiny_Rub_8782,19,3,1,4,14,0.001361
Willing-Time7344,16,8,6,14,12,0.001167
alelp,13,3,6,9,13,0.00067
asselfoley,14,2,1,3,15,0.000644
blade740,13,3,2,5,13,0.00066
j____b____,15,8,2,10,14,0.018853
joittine,38,8,10,18,12,0.000904
kimariesingsMD,39,13,8,21,13,0.001294
movingtobay2019,20,8,9,17,12,0.003106
muffinsballhair,17,7,4,11,12,0.001244
sbenfsonwFFiF,19,6,4,10,12,0.001497
sdric,11,5,3,8,13,0.000763
shugEOuterspace,10,4,3,7,12,0.006874
stewmander,26,7,9,16,12,0.001509
sullythered,25,6,8,14,12,0.000839
Katarack21,10,3,8,11,11,0.010563
BothDiscussion9832,44,22,17,39,13,0.040978
friedgoldfishsticks,58,17,13,30,12,0.029253
1964leeb,11,5,5,10,13,0.006905
AmusingMusing7,20,8,6,14,12,0.012018
AndlenaRaines,10,13,5,18,13,0.021357
Automatic-Flounder-3,28,19,14,33,12,0.03691
ChazzLamborghini,19,15,5,20,13,0.019931
Complex-Field7054,30,11,18,29,11,0.039674
CrawlerSiegfriend,11,6,2,8,13,0.021348
DJ_HazyPond292,15,11,0,11,0,0.046201
DelirielDramafoot,20,9,5,14,14,0.006327
Djinnwrath,14,7,9,16,12,0.013672
False_Celebration626,10,9,4,13,13,0.035853
FancyyPelosi,18,6,8,14,13,0.010756
Finishweird,12,4,1,5,13,0.006034
Fishtoart,11,6,5,11,13,0.017049
Gurpila9987,36,15,12,27,12,0.022919
Honky_Cat,14,11,8,19,12,0.013321
Howhytzzerr,10,7,0,7,0,0.031758
KevyKevTPA,13,3,4,7,13,0.004647
LateralEntry,45,25,18,43,12,0.024966
LeftToaster,11,16,3,19,12,0.038705
Mist_Rising,87,33,43,76,12,0.067039
MrMrLavaLava,22,6,6,12,13,0.027002
NOOBFUNK,12,10,4,14,12,0.028116
NekoCatSidhe,75,26,17,43,12,0.056501
OMGitisCrabMan,10,3,3,6,13,0.012146
RKU69,52,22,21,43,12,0.042038
SantaClausDid911,29,12,11,23,12,0.025252
Signal_Membership268,10,5,3,8,13,0.018618
SkiingAway,14,6,4,10,12,0.036146
Specific-Hand3439,17,4,1,5,14,0.017691
Super-Statement2875,10,4,4,8,13,0.006903
Tw1tcHy,48,12,18,30,13,0.034189
Upstairs-Scratch-927,19,6,4,10,12,0.023064
YnotBbrave,58,26,20,46,12,0.05435
bigdon802,30,7,9,16,12,0.024243
da_ting_go,15,2,2,4,13,0.009372
equiNine,25,15,8,23,13,0.044227
fiktional_m3,39,6,5,11,13,0.005745
goddamnitwhalen,26,15,8,23,13,0.036142
indescipherabled,22,6,11,17,13,0.0203
jethomas5,62,15,20,35,12,0.041695
junkit33,17,8,6,14,13,0.031237
neverendingchalupas,28,11,13,24,12,0.042519
stinkywrinkly,23,6,7,13,12,0.021409
xXxdethl0rdxXx,20,8,4,12,13,0.009804
LaquaviusRawDogg,24,7,14,21,12,0.000385
alwaysright0,51,6,2,8,14,0.000155
Iustis,25,7,3,10,13,0.012325
Prasiatko,20,5,2,7,13,0.003823
Syharhalna,12,4,6,10,12,0.001581
arbitrageME,10,10,3,13,13,0.031318
illegalmorality,39,6,28,34,12,0.021098
rigormorty,12,7,3,10,13,0.006621
Liad3008,29,8,23,31,12,0.000089
Foxhound97_,27,6,3,9,11,0.001283
HotSauce2910,11,3,4,7,12,0.00038
Subtleiaint,17,5,17,22,12,0.000639
glumjonsnow,25,6,6,12,13,0.000329
poorestprince,35,6,0,6,0,0.000684
vreel_,11,4,2,6,12,0.006571
Xiibe,39,12,7,19,12,0.00034
deep_sea2,33,13,5,18,12,0.001024
ygmc8413,57,12,9,21,12,0.00108
Massive-Albatross823,10,2,10,12,13,0.000186
Familiar_Invite_8144,12,4,6,10,13,0.000396
Feyle,72,6,6,12,13,0.000384
JacquesShiran,12,3,2,5,14,0.000297
Waste-Menu-1910,19,4,5,9,13,0.00131
houtex727,13,6,2,8,13,0.000201
shitposts_over_9000,106,12,8,20,13,0.000603
xienwolf,28,5,1,6,2,0.000481
Mijam7,10,0,31,31,12,0
Arkmer,19,9,2,11,13,0.019311
Dmagnum,15,10,4,14,13,0.014291
Intelligent-Sound-85,14,5,1,6,13,0.009483
LowerEar715,10,4,5,9,13,0.002081
NepheliLouxWarrior,18,21,4,25,13,0.028763
Pale-Candidate8860,11,5,0,5,0,0.013153
bjdevar25,36,14,11,25,12,0.036557
judge_mercer,27,10,6,16,13,0.016386
kittenTakeover,20,3,2,5,11,0.002549
xena_lawless,21,3,2,5,14,0.001532
MrsWeasley9,19,7,23,30,11,0.000442
Lumpy-Butterscotch50,93,23,11,34,13,0.00279
RICO_the_GOP,12,4,3,7,13,0.001012
Shewhomust77,20,2,2,4,14,0.000102
bemused_alligators,15,9,4,13,12,0.001026
seattleseahawks2014,37,7,11,18,13,0.000162
snotick,18,5,3,8,13,0.000475
NJBarFly,23,5,8,13,13,0.000166
Jackandahalfass,26,4,1,5,15,0.000323
doriangray42,25,3,2,5,14,0.000445
Bombastic_tekken,11,2,2,4,12,0.000316
BoxForeign8849,14,4,2,6,13,0.00111
ExtremeAd7729,16,2,3,5,13,0.000283
Freeham55,10,7,1,8,12,0.002127
Indecisive-Gamer,12,2,4,6,13,0.000301
Independent_Donut_26,20,2,4,6,12,0.000273
NefariousQuick26,13,2,1,3,14,0.000275
PeculiarSir,10,2,1,3,13,0.000276
Rough-Tension,13,3,4,7,13,0.000461
Trylena,89,22,16,38,12,0.001001
Tzuyu4Eva,13,3,5,8,13,0.000299
WindyWindona,15,7,4,11,13,0.000599
WinstonWilmerBee,11,6,6,12,13,0.000626
WittyProfile,11,4,4,8,12,0.000365
Z7-852,267,43,40,83,11,0.00579
ZeusThunder369,10,3,41,44,11,0.000459
burningbend,11,4,3,7,12,0.000593
dragonfirestorm948,16,2,12,14,12,0.000285
dtbgx,10,4,1,5,14,0.000457
garden_dragonfly,14,2,1,3,14,0.000276
pinksparklyreddit,15,3,2,5,14,0.000291
-Foxer,19,6,6,12,13,0.015212
12_0z_curls,45,14,13,27,12,0.042421
2057Champs__,42,12,11,23,12,0.022164
20_mile,15,5,6,11,13,0.027378
214ObstructedReverie,19,7,7,14,12,0.026738
40WAPSun,15,8,10,18,12,0.031105
4BasedFrens,15,4,5,9,13,0.014654
AM_Bokke,19,10,7,17,12,0.025181
AStealthyPerson,28,4,4,8,13,0.018693
AVonGauss,18,8,4,12,13,0.029226
Adeptobserver1,16,7,6,13,13,0.01857
AdhesivenessCivil581,11,11,4,15,13,0.03278
AgentMonkey,10,3,1,4,12,0.020461
AlexRyang,10,3,5,8,13,0.014708
Alternative_Buy_4000,27,7,5,12,13,0.014898
AntarcticScaleWorm,34,10,7,17,13,0.016181
Appropriate_Leg9113,13,3,0,3,0,0.024723
ArendtAnhaenger,15,8,8,16,12,0.019487
AshleyMyers44,27,12,11,23,13,0.021085
AxlLight,15,7,2,9,13,0.02045
BKGPrints,245,34,26,60,12,0.037089
BUSY_EATING_ASS,10,6,5,11,13,0.021818
BalboaCZ,12,4,3,7,13,0.016437
Black_XistenZ,19,4,8,12,13,0.027786
Bodoblock,42,24,12,36,13,0.033174
Brysynner,10,5,2,7,13,0.014639
Bulugaboy05,12,4,1,5,14,0.024545
BuzzBadpants,14,7,6,13,13,0.030311
Charming_Cicada_7757,11,6,4,10,13,0.036398
CremePsychological77,22,9,8,17,12,0.031393
Crib15,26,4,4,8,13,0.018796
Damnatus_Terrae,13,5,2,7,13,0.026149
DickNDiaz,57,10,14,24,13,0.027614
Dineology,15,10,4,14,12,0.041769
DinkandDrunk,18,10,5,15,13,0.019513
DonatCotten,11,2,2,4,13,0.018236
Eminence_grizzly,13,5,4,9,13,0.036191
Emotional-Box-6835,16,4,4,8,13,0.014262
FawningDeer37,12,9,8,17,13,0.040463
Fuckface_Whisperer,10,3,1,4,13,0.015058
FuguSandwich,13,14,6,20,13,0.02678
GritNGrindNick,12,7,4,11,13,0.01824
Gryffindorcommoner,55,14,12,26,12,0.016046
Gta6MePleaseBrigade,30,14,6,20,13,0.052463
GuestCartographer,18,13,0,13,0,0.030834
HGpennypacker,10,6,6,12,12,0.034249
Hartastic,51,16,23,39,13,0.04542
HiSno,47,18,8,26,13,0.021993
Honestly_Nobody,11,7,7,14,12,0.031075
HowDoIEvenEnglish,23,5,10,15,12,0.020994
HumanContinuity,16,8,6,14,13,0.024224
Idk_Very_Much,15,12,7,19,12,0.039013
Irish_Pineapple,15,10,7,17,13,0.018526
Jazzlike-Wolverine19,11,3,3,6,12,0.028703
Jeffery95,12,3,3,6,13,0.014591
JesusSquid,14,6,7,13,13,0.026361
Jmoney1088,20,9,6,15,13,0.02683
JustAnotherJon,17,3,3,6,14,0.015028
KeyYak4008,49,7,9,16,13,0.026154
Laves_,12,1,1,2,12,0.014004
LettuceFuture8840,73,27,25,52,12,0.063773
LiberalAspergers,18,4,4,8,13,0.026796
Littlepage3130,13,1,4,5,13,0.014004
LouisWinthorpeIII,18,3,8,11,13,0.014468
LukasJackson67,31,9,8,17,13,0.036846
MagicWishMonkey,14,6,5,11,13,0.025871
MarshyHope,11,3,3,6,13,0.022899
Middle_Ad8183,19,7,9,16,13,0.018885
MonaSherry,14,5,3,8,13,0.019221
New2NewJ,19,11,8,19,13,0.024759
No-Ear7988,22,8,8,16,13,0.037297
NoOnesKing,20,7,4,11,13,0.022159
OccamsRabbit,12,5,3,8,12,0.025033
Ok_Bandicoot_814,79,22,23,45,12,0.047367
Ok_Macaroon6155,34,12,8,20,13,0.032951
OnePunchReality,14,5,3,8,14,0.025916
OneReportersOpinion,29,4,4,8,13,0.016706
OptimusPrimeval,10,5,5,10,13,0.016127
Orbital2,13,7,3,10,13,0.016334
PlantComprehensive77,20,9,8,17,12,0.017334
PolicyWonka,15,8,5,13,12,0.029832
PomegranateOld7836,11,4,3,7,13,0.024373
Prestigious_Ad_5825,13,1,3,4,13,0.014004
PrimAhnProper998,18,4,4,8,13,0.014066
QSannael,10,3,1,4,14,0.017032
RamJamR,17,4,2,6,13,0.025945
RareMajority,10,2,2,4,12,0.01405
RealSimonLee,13,3,3,6,13,0.014459
RedApple655321,13,11,5,16,12,0.020408
Responsible-Yak9000,24,6,6,12,12,0.017017
RonaldTurner88,27,10,6,16,13,0.027099
SaintNutella,13,6,2,8,14,0.024765
Salty-Snowflake,15,5,4,9,12,0.023134
Select_Insurance2000,14,8,4,12,13,0.01903
Selethorme,92,11,12,23,11,0.035128
Significant-Cancel70,40,13,8,21,12,0.048052
Significant_Arm4246,56,23,13,36,12,0.03347
Silent-Storms,22,7,5,12,13,0.018438
Snatchamo,37,15,18,33,12,0.025023
SnottNormal,13,5,5,10,13,0.026031
Sofa-king-high,10,2,0,2,0,0.02419
Sptsjunkie,36,23,17,40,12,0.064422
Standupaddict,15,5,4,9,13,0.015236
StedeBonnet1,22,9,7,16,12,0.021887
Storyteller-Hero,22,13,5,18,12,0.047992
Sublimotion,12,4,1,5,1,0.030208
SuperRocketRumble,18,11,6,17,13,0.022379
The-Polite-Pervert,20,13,6,19,12,0.038345
TheNavigatrix,24,6,32,38,12,0.022353
The_Law_of_Pizza,45,22,14,36,13,0.031195
Time_Minute_6036,26,3,272,275,12,0.015837
Tliish,47,12,9,21,12,0.038397
Toadfinger,10,5,3,8,13,0.032221
TorkBombs,22,16,6,22,13,0.021528
Vast_Road7888,31,6,11,17,13,0.017126
VeekaVeeks,15,5,2,7,12,0.05071
Wave_File,30,15,8,23,12,0.036907
Wermys,52,13,14,27,13,0.044531
Which-Worth5641,49,21,17,38,13,0.059568
YogurtclosetOwn4786,18,8,3,11,13,0.019679
addicted_to_trash,13,6,5,11,13,0.017003
apiaryaviary,25,10,8,18,13,0.016791
bigmac22077,18,7,6,13,13,0.019195
braindeaths,17,4,46,50,12,0.014792
chamrockblarneystone,52,17,20,37,12,0.050056
cowmix88,14,12,4,16,14,0.025078
das_war_ein_Befehl,29,19,13,32,12,0.052387
datalicearcher,38,6,4,10,12,0.032105
dragnabbit,11,5,2,7,13,0.0335
dsfox,12,3,3,6,13,0.014716
elmekia_lance,30,14,13,27,12,0.021309
gquax,24,24,12,36,12,0.033675
grinr,12,5,1,6,13,0.027427
indigoC99,11,3,2,5,14,0.014393
ironyinsideme,14,8,6,14,13,0.01893
jumpinjacktheripper,16,4,3,7,11,0.016157
kevbot918,14,10,6,16,13,0.030711
kormer,24,10,8,18,12,0.027518
l1qq,28,22,10,32,12,0.040686
lewkiamurfarther,44,18,19,37,13,0.046779
littleredpinto,14,3,3,6,12,0.025868
mercfan3,17,17,7,24,13,0.041141
mongooser,14,10,5,15,13,0.019921
nanoatzin,19,10,5,15,13,0.028859
ninfan1977,32,8,5,13,12,0.023975
notapoliticalalt,29,11,9,20,12,0.038763
onlyontuesdays77,56,16,12,28,12,0.055717
quizbowler_1,18,3,1,4,13,0.023849
rabidstoat,11,4,5,9,12,0.025237
rcglinsk,12,8,5,13,13,0.027282
sirswantepalm,45,8,42,50,11,0.028617
spam__likely,24,11,13,24,13,0.034053
speedingpullet,23,8,9,17,12,0.018981
stripedvitamin,14,6,5,11,13,0.020324
sunshine_is_hot,105,33,20,53,12,0.028701
t234k,28,12,6,18,13,0.023598
teilani_a,21,5,2,7,12,0.018819
telefawx,20,7,7,14,12,0.017267
the_original_Retro,10,6,66,72,12,0.01742
trace349,25,10,14,24,12,0.032112
ttystikk,14,5,1,6,14,0.036185
umbren,20,4,5,9,12,0.020532
uptokesforall,17,5,5,10,13,0.015238
wellwisher-1,40,20,12,32,12,0.069206
wha-haa,47,19,16,35,13,0.065312
wulfgar_beornegar,35,5,7,12,13,0.016814
yoshi8869,32,9,8,17,12,0.022446
zaplayer20,11,5,5,10,13,0.024881
AtlasThe1st,11,2,1,3,12,0.000467
GarageIndependent114,27,6,2,8,14,0.001541
Hemingwavy,14,4,3,7,12,0.007276
Justame13,27,7,6,13,13,0.001171
Ok_Owl_5403,33,6,6,12,11,0.001114
SeattleBrother75,15,2,0,2,0,0.001343
SpecificConscious809,10,2,2,4,12,0.000373
TetraThiaFulvalene,22,8,5,13,10,0.000374
TheBitchenRav,11,4,4,8,12,0.000348
TheInsomn1ac,11,8,2,10,14,0.000231
hydrOHxide,13,3,5,8,12,0.000277
sumit24021990,42,8,11,19,12,0.000906
Ok-Trade-5937,23,3,21,24,12,0.000039
FearlessResource9785,107,22,16,38,12,0.001276
JaggedMetalOs,17,2,1,3,13,0.000064
Ok-Warning-7494,10,1,107,108,11,0
1331_1331,14,4,3,7,13,0.000715
7thpostman,15,3,2,5,14,0.001193
Ah_Pook,11,4,4,8,13,0.000658
AngryVolcano,30,7,5,12,12,0.001716
Appropriate_Gate_701,26,9,5,14,13,0.001734
BackseatCowwatcher,18,11,6,17,12,0.001236
Bast-beast,32,12,10,22,12,0.001713
Belisarius9818,28,7,5,12,12,0.000902
Boulange1234,14,3,1,4,14,0.00121
CallMeOaksie,14,4,4,8,12,0.000617
CommyKitty,10,6,2,8,13,0.003111
Contemplating_Prison,10,3,2,5,14,0.000811
FreddieMoners,21,6,3,9,13,0.001732
IcyRecommendation781,26,7,6,13,13,0.000792
IndividualSkill3432,13,5,4,9,13,0.000858
IsNotACleverMan,78,16,15,31,12,0.003348
John-Zero,11,3,2,5,13,0.000612
Majestic-Effort-541,17,8,5,13,12,0.000721
No-Ladder7740,24,6,7,13,12,0.001277
PharaohhOG,10,5,4,9,13,0.00149
RedHead-Eng25,16,8,3,11,13,0.002393
Responsible_Music248,10,2,2,4,12,0.000581
Sammonov,24,14,10,24,13,0.014743
SmokingPuffin,11,1,1,2,14,0.000555
Solondthewookiee,36,8,7,15,12,0.001576
Technoxgabber,16,3,2,5,12,0.000874
Throwaway5432154322,31,8,9,17,12,0.011769
Total_Yankee_Death,10,3,3,6,12,0.000899
U_Sound_Stupid_Stop,15,4,6,10,13,0.000662
VikingFjorden,12,3,2,5,13,0.000694
Wayoutofthewayof,13,5,4,9,12,0.00083
XhazakXhazak,26,12,4,16,13,0.001616
Zrakoplovvliegtuig,11,3,4,7,12,0.000727
denyer-no1-fan,17,6,5,11,13,0.001238
forkproof2500,27,4,5,9,12,0.000649
lepoissonstev,28,5,3,8,13,0.000847
polisharmada33,19,6,6,12,13,0.001257
poopy050224,16,2,1,3,12,0.000755
scaurus604,14,2,7,9,12,0.000573
spyrielles,18,3,2,5,13,0.000575
thelaceonmolagsballs,10,4,4,8,13,0.001287
Crafty-Average-586,10,3,0,3,0,0.000937
itsnotcomplicated1,37,11,6,17,12,0.007346
Parzival_1775,21,2,47,49,11,0.000009
Ancquar,11,5,2,7,13,0.012308
DoYouWantAQuacker,10,4,1,5,14,0.000545
Donkletown,27,4,6,10,13,0.000447
Eyespop4866,11,3,1,4,13,0.001505
GoBills585,22,10,3,13,14,0.000746
LowNoise9831,12,2,3,5,12,0.000366
Noob_Al3rt,64,16,17,33,12,0.003526
PhaseFull6026,10,0,10,10,14,0
Allydarvel,13,2,1,3,15,0.00013
ChChChillian,40,3,4,7,14,0.000145
SethGekco,29,4,1,5,14,0.000559
allboolshite,11,2,3,5,14,0.000281
minion531,33,5,1,6,15,0.000882
neodiogenes,65,11,8,19,14,0.001538
saliczar,12,2,1,3,1,0.000297
Delli-paper,88,25,17,42,11,0.00574
WaterboysWaterboy,10,3,1,4,13,0.000199
scorpiomover,15,1,0,1,0,0.000134
Powerful_Falcon_4006,15,0,26,26,13,0
Asmos159,13,4,3,7,14,0.000358
Rombom,53,9,7,16,14,0.000415
Stompya,13,2,2,4,13,0.000218
ThaneOfArcadia,10,1,0,1,0,0.000183
Unusual_Wasabi_7121,10,2,1,3,16,0.000351
Yarddogkodabear,11,1,1,2,1,0.000183
rlbond86,12,4,2,6,14,0.000387
solid_reign,35,6,5,11,13,0.000677
space_monster,11,2,2,4,13,0.000183
ven_geci,21,5,3,8,13,0.000825
PressPausePlay,12,3,39,42,12,0.000297
1SecularGlobe4All,14,3,5,8,12,0.001784
Ambitious-Care-9937,13,3,1,4,14,0.000419
Beljuril-home,11,2,2,4,14,0.000342
DD_Spudman,10,3,4,7,12,0.000339
Delduthling,23,3,2,5,12,0.000521
JRDZ1993,15,3,4,7,12,0.000653
LosingTrackByNow,14,6,4,10,14,0.00049
Mutive,10,3,3,6,13,0.000333
ObviousSea9223,11,2,0,2,0,0.000593
Stunning_Active_8938,55,28,31,59,11,0.004774
TapPublic7599,10,4,5,9,13,0.001049
PsychLegalMind,11,0,237,237,12,0
68plus1equals,19,10,7,17,13,0.016418
AdUpstairs7106,23,8,8,16,13,0.015586
Austin_Peep_9396,11,12,5,17,13,0.024259
Confusedgmr,11,6,5,11,13,0.01726
Dreadedvegas,19,10,4,14,13,0.014257
Dull_Conversation669,22,11,5,16,13,0.041729
Emergency_Driver_487,49,6,5,11,12,0.014
Emergency_Streets,10,5,3,8,13,0.020309
Facebook_Algorithm,14,2,2,4,13,0.010237
Forte845,87,26,28,54,12,0.032911
Gweena,20,4,3,7,13,0.012106
Hot-Hurry3199,21,6,9,15,13,0.013454
Independent_Fox8656,13,6,3,9,14,0.013315
Infamous_Top677,11,3,3,6,13,0.015866
Intro-Nimbus,14,4,1,5,13,0.016199
IrritableGourmet,19,7,7,14,13,0.024951
Laceykrishna,10,3,2,5,14,0.012345
Lucas_Steinwalker,13,3,4,7,14,0.010471
OpeningChipmunk1700,24,9,7,16,13,0.015248
PM_me_Henrika,15,6,5,11,13,0.023156
Pi6,12,8,4,12,13,0.024932
PropofolMargarita,23,3,8,11,12,0.016387
RabbaJabba,39,11,7,18,13,0.025201
SAPERPXX,10,6,2,8,14,0.015521
SammathNaur1600,20,6,4,10,12,0.013963
TaxLawKingGA,18,10,5,15,13,0.022126
Zadow,14,7,8,15,11,0.01251
bfhurricane,20,10,8,18,12,0.015824
celsius100,14,7,5,12,13,0.018955
danappropriate,25,6,5,11,12,0.019733
fairenbalanced,13,4,2,6,13,0.011699
floofnstuff,13,4,5,9,13,0.021405
foilhat44,11,6,4,10,12,0.028714
honuworld,22,6,2,8,14,0.017753
hymie0,11,9,4,13,12,0.016426
ilikedota5,17,7,8,15,12,0.025598
itsdeeps80,62,21,19,40,12,0.043305
jaywst22,20,6,5,11,12,0.02318
johannthegoatman,10,7,3,10,13,0.02446
kerouacrimbaud,23,7,11,18,12,0.011871
link3945,20,6,5,11,13,0.01298
ninjadude93,14,9,4,13,12,0.027093
pharmamess,13,4,8,12,13,0.014002
popeIeo,32,10,6,16,13,0.015674
powerboy20,18,5,2,7,13,0.011939
res0nat0r,20,11,8,19,13,0.035893
rhombecka,11,8,3,11,13,0.03015
rockclimberguy,11,5,3,8,13,0.013688
truthovertribe,57,12,13,25,12,0.028058
weealex,15,10,7,17,12,0.041605
welcome_universe,10,3,3,6,13,0.011413
whater39,71,12,11,23,12,0.011392
zeussays,12,6,4,10,12,0.012822
Agreeable_Car5114,11,6,3,9,13,0.001087
Alternative_Hope6238,10,5,3,8,12,0.001176
Appropriate_Mixer,14,7,5,12,12,0.000827
BeginningMedia4738,19,7,7,14,13,0.000969
CauseAdventurous5623,16,3,2,5,13,0.000888
Consistent_Hurry_603,13,2,2,4,13,0.000719
Crowe3717,13,3,2,5,14,0.000723
Csimiami,15,6,4,10,12,0.001822
DTF_Truck,17,5,3,8,13,0.001492
DewinterCor,10,2,2,4,13,0.000724
Direct_Crew_9949,12,2,2,4,13,0.000738
DopeShitBlaster,13,6,4,10,13,0.001512
EdenSire0,54,7,7,14,13,0.002198
FineDingo3542,15,5,5,10,12,0.001008
Fishin4catfish,12,2,1,3,14,0.001869
Former_Function529,23,6,5,11,12,0.001198
HolyToast,113,21,15,36,13,0.001245
Horselady234,18,9,7,16,12,0.003615
Huge___Milkers,10,5,0,5,0,0.000754
IceTheFoundr,15,6,1,7,14,0.002653
Idrialite,16,4,3,7,12,0.001091
InfidelZombie,11,5,5,10,13,0.000843
Kangaroo_shampoo4U,76,3,2,5,13,0.000785
Key_Cheetah7982,116,25,37,62,11,0.003853
LEDN42,15,4,3,7,13,0.000746
Low_Guide5147,19,6,4,10,13,0.001352
ManliestBunny,14,4,2,6,14,0.000735
MaxwellKillMill,24,5,4,9,13,0.00353
Mister_Way,10,2,1,3,15,0.000992
MooseRyder,16,5,3,8,13,0.000826
No-Broccoli-7606,23,5,7,12,11,0.001391
NoseSeeker,10,7,5,12,12,0.001911
NotYourThrowaway17,15,3,2,5,13,0.000764
Ok_Artichoke_2928,10,3,2,5,13,0.000877
OptimisticRealist__,17,10,2,12,13,0.001876
PopTheRedPill,12,5,2,7,13,0.001053
Shadeylark,29,5,5,10,13,0.003125
SirWillae,13,5,0,5,0,0.001929
SkinnerBoxBaddie,29,6,3,9,13,0.001093
Tengoatuzui,45,7,7,14,12,0.00094
TheMuffler42069,39,4,3,7,14,0.000736
ThoseThatComeAfter,11,4,3,7,13,0.000915
ThrowRAboredinAZ77,21,5,4,9,13,0.000756
TownAfterTown,22,8,7,15,13,0.000853
Unexpected_Gristle,16,5,4,9,13,0.001064
Witty-Rabbit-8225,11,4,1,5,13,0.000861
baltinerdist,16,4,2,6,12,0.000777
banhs5,26,7,5,12,12,0.001403
blyzo,30,13,8,21,12,0.017743
charlesth1ckens,15,8,6,14,13,0.002344
chewwydraper,11,3,2,5,13,0.001011
comeon456,52,26,5,31,12,0.002638
draculabakula,15,6,4,10,12,0.001529
going_my_way0102,36,12,14,26,12,0.003728
isamudragon,18,4,3,7,13,0.000747
moboticus,15,6,5,11,12,0.002814
nighthawk_something,26,5,11,16,12,0.000808
oversoul00,41,7,7,14,12,0.000856
parentheticalobject,14,6,2,8,13,0.002015
savetinymita,11,2,1,3,14,0.000723
slyrent,10,5,5,10,13,0.001242
superswellcewlguy,10,5,3,8,13,0.000953
thefrozenflame21,19,8,5,13,13,0.00219
thegreatherper,28,3,3,6,13,0.000725
thinsoldier,26,12,10,22,13,0.001359
werewulf35,13,3,3,6,13,0.00072
yaboichurro11,25,12,1,13,13,0.002481
DepthExtended,10,1,0,1,0,0.000078
ImProdactyl,11,2,1,3,14,0.000096
Kolo_ToureHH,14,1,0,1,0,0.000078
stringbeagle,10,9,5,14,12,0.001008
Magehunter_Skassi,12,9,4,13,13,0.008865
Significant_Sign_520,11,11,2,13,13,0.018217
closetedwrestlingacc,10,3,4,7,12,0.002603
thegarymarshall,35,3,5,8,12,0.003924
Real-Intention-7998,23,16,35,51,12,0.000838
AnxietyObvious4018,35,14,11,25,12,0.000953
Iconic_Mithrandir,25,14,13,27,12,0.002587
KRAy_Z_n1nja,14,3,2,5,12,0.000288
Pastadseven,12,4,5,9,12,0.000802
StarChild413,32,9,15,24,12,0.002716
nauticalsandwich,26,10,8,18,13,0.001167
poprostumort,37,15,8,23,12,0.001795
urquhartloch,48,14,11,25,13,0.002246
Responsible-Bunch316,32,6,41,47,11,0.000837
Angry_Canadian88,13,6,5,11,12,0.000454
Apprehensive-Fun4181,10,3,1,4,13,0.001117
Charming-Leader-250,17,5,3,8,12,0.002256
L3onK1ng,23,6,6,12,12,0.000587
Muadeeb,16,2,1,3,14,0.000181
Wayyyy_Too_Soon,14,4,1,5,13,0.000841
asafg8,15,5,1,6,13,0.00068
bluepillarmy,13,5,32,37,12,0.000255
turboprancer,11,4,43,47,12,0.000367
Rolly3,22,4,20,24,12,0.000567
Gohab2001,14,6,5,11,12,0.001045
akaleonard,17,4,1,5,13,0.000672
blueplanet96,21,11,8,19,12,0.000876
myusrnmeisalrdytkn,19,5,3,8,12,0.000414
tinylemon128,11,5,2,7,13,0.001721
Crash927,65,15,10,25,12,0.015019
Doodenelfuego,14,4,3,7,14,0.000142
OldSarge02,11,3,6,9,12,0.000149
arrgobon32,36,14,2,16,13,0.001025
delimeats_9678,34,7,7,14,12,0.000425
Eggsformycat,26,11,7,18,13,0.000656
aipac124,10,2,0,2,0,0.000299
bgaesop,32,6,5,11,12,0.000792
dudemanwhoa,17,1,0,1,0,0.00014
GumboSamson,25,5,4,9,12,0.000695
Nick_Beard,31,16,6,22,12,0.000555
NumerousWeather9560,23,10,2,12,13,0.002239
imhugeinjapan89,20,6,4,10,12,0.00168
throw-away-doh,23,4,3,7,13,0.000213
Due_Satisfaction2167,13,5,2,7,13,0.000691
EmilytheALtransGirl,14,3,1,4,13,0.001001
VirtualDingus7069,10,2,2,4,14,0.000281
SuggestionHoliday413,10,1,21,22,12,0.000016
No-swimming-pool,10,1,1,2,14,0.000226
dvolland,13,1,1,2,14,0.000226
followyourvalues,14,2,4,6,12,0.000246
h0sti1e17,14,6,7,13,13,0.000737
ultradav24,51,11,17,28,12,0.002023
Ayjayz,25,8,5,13,13,0.000628
Carlpanzram1916,10,4,2,6,13,0.000291
ErieHog,18,11,6,17,13,0.002095
IwantyoualltoBEDAVE,24,3,4,7,13,0.00024
MeanestGoose,10,4,1,5,14,0.000287
Puzzleheaded_Disk_90,14,4,3,7,13,0.000487
SpecialistBet4656,31,3,5,8,12,0.000594
Spirited-Feed-9927,16,3,1,4,14,0.000365
Sufficient_Run4414,15,4,4,8,12,0.000267
TankyRo,13,4,3,7,13,0.000402
TheAmazingBreadfruit,11,3,2,5,13,0.000264
United_Librarian5491,20,6,7,13,12,0.000247
WearIcy2635,37,12,12,24,12,0.000703
Yuo_cna_Raed_Tihs,17,4,3,7,13,0.000316
amrodd,19,4,5,9,12,0.00045
athe085,28,2,3,5,13,0.00025
bigElenchus,14,8,4,12,13,0.000335
cuntpimp,17,5,2,7,13,0.000261
mutantraniE,12,3,5,8,12,0.000275
quietmanic,17,5,7,12,12,0.000278
spinbutton,24,8,8,16,12,0.000979
tanglekelp,11,3,2,5,12,0.000378
trullaDE,21,14,6,20,13,0.001209
xboxhaxorz,10,3,3,6,13,0.000548
Bitter-Assignment464,18,5,3,8,12,0.007511
DataCassette,10,4,5,9,12,0.001135
FalseBuddha,10,5,3,8,13,0.001163
GkrTV,27,9,10,19,12,0.001976
JeffreyElonSkilling,13,5,4,9,13,0.001883
LankyEvening7548,29,5,4,9,13,0.001145
Lower_Group_1171,15,5,2,7,13,0.002505
LumpBizquik,28,8,13,21,12,0.001486
Nsfwacct1872564,21,5,8,13,12,0.001411
Royalfatty,11,5,4,9,13,0.00121
Secret-Put-4525,23,2,2,4,12,0.001118
Severe-Illustrator87,16,1,0,1,0,0.001085
TBK_Winbar,22,7,2,9,12,0.001309
TuskaTheDaemonKilla,12,4,1,5,13,0.001502
Wade8813,15,3,2,5,14,0.001103
WeakandSlowaf,25,6,5,11,13,0.001482
acesoverking,25,5,27,32,12,0.001167
atamicbomb,12,3,3,6,13,0.001145
cbf1232,38,9,12,21,12,0.00169
deepstaterecords,22,9,10,19,12,0.008306
elCharderino,10,6,1,7,13,0.008227
ezk3626,11,2,0,2,0,0.001381
fps916,15,3,2,5,12,0.00716
jpotion88,21,4,9,13,13,0.001469
maxxell13,12,6,5,11,12,0.001432
nerojt,32,5,7,12,12,0.001601
pile_of_bees,40,11,13,24,12,0.00154
timeless1991,25,5,66,71,11,0.001596
tjboss,10,2,2,4,12,0.001475
wingsnut25,18,6,5,11,12,0.006573
yIdontunderstand,10,2,1,3,2,0.001086
TheMissingPremise,14,3,17,20,12,0.000653
Careful-Painting3214,13,4,2,6,12,0.008164
spicy-chull,14,5,5,10,13,0.001729
TheMrCurious,36,12,14,26,12,0.001932
Fofolito,10,3,0,3,0,0.001709
Impossible_Ad9324,12,5,4,9,13,0.003817
Rastiln,38,21,13,34,13,0.031626
dickpierce69,29,11,4,15,12,0.009087
Mysterious_Ad_7301,11,3,6,9,13,0.003266
Pearberr,14,3,2,5,13,0.003085
Roselily808,10,17,2,19,13,0.007619
SpicyButterBoy,34,8,7,15,12,0.006303
Traditional-Ad-3245,12,2,1,3,13,0.00476
UnusualAir1,14,6,3,9,13,0.01573
WarbleDarble,130,23,32,55,12,0.023457
colako,10,2,2,4,13,0.003218
gburgwardt,33,10,9,19,13,0.016026
gravity_kills,12,6,4,10,13,0.007905
The_Godlike_Zeus,13,0,11,11,13,0
Coygon,12,3,1,4,13,0.0002
meteoraln,12,2,1,3,14,0.000433
nemoomen,11,3,0,3,0,0.00031
snrup1,11,1,1,2,1,0.000156
venuswasaflytrap,28,5,3,8,14,0.000384
Aggressive-Mix4971,13,3,2,5,13,0.000327
FourCardStraight,16,6,1,7,11,0.000436
McKropotkin,13,2,3,5,13,0.000301
Norman_debris,10,2,1,3,15,0.0003
Our_GloriousLeader,11,4,1,5,14,0.000392
TheWorstRowan,14,4,5,9,12,0.000353
barnburner96,12,3,2,5,13,0.00032
cstar1996,30,9,9,18,12,0.000441
iamunknowntoo,11,4,2,6,12,0.000963
redelastic,39,9,11,20,13,0.0014
96suluman,11,3,2,5,13,0.012457
ABobby077,11,5,5,10,13,0.025155
Amoral_Abe,14,16,3,19,12,0.024032
Aneurhythms,20,9,7,16,13,0.020615
Anodized12,13,1,2,3,13,0.011462
BobQuixote,17,5,6,11,13,0.015174
CerddwrRhyddid,23,6,4,10,13,0.020979
CharlieandtheRed,13,8,7,15,13,0.016817
CloudComfortable3284,15,5,7,12,13,0.01438
DMayleeRevengeReveng,31,15,9,24,12,0.029156
Dark_Wing_350,13,2,1,3,13,0.013219
Downtown_Afternoon75,15,5,6,11,13,0.015265
Dunkleosteus666,10,3,2,5,13,0.012677
Either_Operation7586,22,6,11,17,13,0.028205
Electrical-Lab-9593,11,5,3,8,13,0.015264
Electronic_Mango1,20,2,3,5,13,0.011494
EyesofaJackal,10,4,1,5,13,0.014638
Final_Meeting2568,13,5,2,7,13,0.015048
FrostyArctic47,19,7,4,11,13,0.024981
JimDee01,10,3,2,5,12,0.014294
MisterMysterios,22,6,8,14,13,0.016991
MrChow1917,20,10,6,16,12,0.012166
Padonogan,22,5,4,9,13,0.014397
Raythunda125,11,3,2,5,14,0.012079
SafeThrowaway691,16,6,7,13,13,0.022534
Serious_Senator,13,6,6,12,13,0.012675
Ssshizzzzziit,21,6,7,13,13,0.014407
TheMCMC,10,5,3,8,13,0.015203
VA_Cunnilinguist,11,4,4,8,13,0.013033
WATGGU,18,2,4,6,12,0.011593
WaltEnterprises,26,6,2,8,14,0.013993
YetAnotherGuy2,24,9,6,15,13,0.017827
arthur_jonathan_goos,13,3,3,6,13,0.02041
atoolred,10,5,8,13,13,0.013671
bones_bones1,21,14,3,17,13,0.040623
cakeandale,18,16,6,22,13,0.029912
cptjeff,14,8,4,12,12,0.025718
demihope,18,11,6,17,13,0.021763
everything_is_bad,12,8,3,11,13,0.019212
evissamassive,15,3,3,6,13,0.011899
figuring_ItOut12,37,5,4,9,13,0.021059
jadnich,32,4,4,8,12,0.028108
jarchack,26,14,8,22,13,0.023868
josh34583,20,10,8,18,13,0.019674
regolith-terroire,50,21,17,38,13,0.021652
rzelln,13,2,4,6,12,0.011486
sendenten,10,6,5,11,12,0.016768
smartcow360,15,3,3,6,13,0.012537
Bluehen55,19,10,7,17,13,0.01282
Clovis42,10,5,4,9,13,0.006681
Duckfoot2021,32,9,7,16,11,0.016158
Impossible_Pop620,45,8,8,16,13,0.01726
RebornGod,28,6,5,11,12,0.004369
ThatsARatHat,15,4,6,10,12,0.01165
Vaulk7,16,4,3,7,13,0.005056
YakCDaddy,21,3,2,5,13,0.004747
flat6NA,10,4,3,7,13,0.005569
jmtrader2,19,8,6,14,13,0.019654
nyckidd,22,16,8,24,13,0.00924
rookieoo,34,19,13,32,12,0.038067
sardine_succotash,61,24,19,43,12,0.010302
surfryhder,10,2,1,3,12,0.010187
West_Hat7270,23,2,7,9,12,0
Judgement_Bot_AITA,664,1,0,1,0,0.000123
Reasonable-Bad-769,41,7,4,11,12,0.000124
RedditWidow,12,1,0,1,0,0.000123
WhenButterfliesCry,29,4,5,9,11,0.000125
abcdef_U2,13,1,0,1,0,0.000123
Aezora,18,5,2,7,13,0.00051
couverte,10,4,2,6,13,0.00084
ourstobuild,17,3,1,4,13,0.000185
BrownCongee,11,2,2,4,13,0.000425
Fichek,18,3,3,6,12,0.00045
HombreDeMoleculos,22,4,6,10,13,0.002154
MainPlankton9612,12,4,1,5,14,0.002721
fallingknife2,13,5,6,11,12,0.000585
Fredouille77,30,5,10,15,12,0.000702
Garfish16,59,14,13,27,12,0.001329
LateQuantity8009,19,5,2,7,13,0.000976
No-Cauliflower8890,55,8,6,14,13,0.000668
Tacenda8279,10,7,4,11,12,0.001124
angry_cabbie,12,5,3,8,12,0.000709
gingerbreademperor,21,5,2,7,13,0.000424
johnsonjohnson,12,3,0,3,0,0.000324
marbinho,18,4,4,8,13,0.000425
saul_not_goodman,40,11,17,28,12,0.000926
sisnitermagus,10,2,1,3,14,0.000333
StevenGrimmas,12,5,3,8,14,0.000584
megschristina,15,4,1,5,13,0.001462
mnoodleman,15,6,4,10,13,0.001665
ornery_curmudgeon,36,11,12,23,13,0.00166
sumoraiden,30,7,6,13,13,0.001046
Embarrassed_Bake2683,14,3,2,5,12,0.001449
Pinkydoodle2,22,3,4,7,12,0.000394
facefartfreely,34,5,2,7,13,0.000623
mallardramp,27,7,8,15,12,0.001761
A_Duck_Using_Reddit,28,15,7,22,13,0.001205
McAlpineFusiliers,22,2,0,2,0,0.000278
Philstar_nz,35,8,8,16,13,0.000227
ThatFuzzyBastard,17,3,2,5,13,0.000196
WileyApplebottom,17,4,2,6,13,0.0005
jabbanobada,16,2,1,3,13,0.000208
495orange,12,5,2,7,13,0.002959
Carlyz37,15,2,5,7,13,0.002933
ENCginger,13,2,1,3,13,0.003275
James_Fiend,24,4,8,12,12,0.004298
keenan123,16,5,4,9,13,0.006714
GentleKijuSpeaks,27,3,1,4,13,0.000287
GooseyKit,16,5,6,11,12,0.000194
Opposite-Bill5560,15,4,2,6,14,0.000364
Sky-Trash,16,6,8,14,12,0.000452
helpprogram2,15,4,2,6,12,0.000519
38159buch,10,4,4,8,13,0.001255
7692205,10,2,1,3,13,0.001259
AccomplishedBake8351,14,6,7,13,12,0.001584
Apart_Variation1918,27,7,9,16,12,0.001981
Avaposter,32,6,7,13,12,0.003164
Bigthrimbles,25,4,3,7,13,0.001209
BrandonLart,22,6,7,13,12,0.015438
Dorithompson,14,3,1,4,13,0.001278
Doughnut3683,19,2,2,4,13,0.001349
Edens_dark_garden,32,7,4,11,13,0.002261
Farcry5gonnabelit,12,4,4,8,13,0.002826
GoldenEagle828677,80,18,12,30,12,0.002149
Grand-wazoo,20,5,2,7,13,0.001533
ICantCoexistWithFish,46,4,7,11,13,0.001497
JosephJohnPEEPS,12,1,2,3,13,0.001152
Knave7575,18,5,3,8,13,0.001935
LIONS_old_logo,26,6,6,12,12,0.001329
LSF604,37,5,5,10,13,0.002473
Lethkhar,31,9,10,19,12,0.001547
LogensTenthFinger,11,6,3,9,13,0.001317
Mammoth_Sleep_7046,11,4,5,9,12,0.015517
Mordred19,14,1,7,8,13,0.001152
Most-Ad4680,16,4,3,7,12,0.001466
Negative_Jaguar_4138,23,6,6,12,13,0.001269
Proof-Technician-202,17,7,7,14,13,0.001277
RVarki,12,5,4,9,12,0.001631
Rosimongus,28,10,7,17,12,0.002349
SweetJeebus,10,4,4,8,13,0.001227
TSllama,18,5,5,10,13,0.001618
TotalityoftheSelf,31,7,8,15,12,0.001463
Utapau301,18,6,7,13,12,0.0014
Valirys-Reinhald,15,5,4,9,13,0.001364
ahrazz99,10,4,3,7,12,0.0155
bearington,33,15,13,28,13,0.002926
cleanlinessisgodly,14,5,6,11,13,0.001437
coochitfrita,51,13,14,27,12,0.001573
crispy1989,12,7,4,11,13,0.001357
isekai15,13,1,1,2,14,0.001152
jedisushi72,14,3,2,5,12,0.015416
jinjuwaka,21,5,8,13,12,0.001311
justafanofz,11,1,0,1,0,0.001152
revengeappendage,57,15,7,22,12,0.002108
stormy2587,11,5,2,7,13,0.001332
username_6916,16,10,4,14,12,0.003776
vankorgan,28,10,5,15,13,0.001456
vintage2019,16,9,6,15,13,0.005041
vollover,10,3,5,8,12,0.00179
wetshatz,37,6,6,12,12,0.001426
melissaphobia,11,3,2,5,12,0.000585
squirlnutz,12,3,1,4,12,0.000639
Biptoslipdi,73,11,6,17,13,0.002299
Glory2Hypnotoad,30,5,3,8,12,0.001358
HauntedReader,56,12,6,18,12,0.002593
PimplupXD,12,6,2,8,14,0.000378
polyvinylchl0rid,11,2,2,4,13,0.000158
reginald-aka-bubbles,14,3,1,4,15,0.000108
unnecessaryaussie83,13,3,2,5,14,0.000138
Sea_Entrepreneur6204,49,15,10,25,12,0.001056
dsteffee,10,2,85,87,11,0.000161
Angylisis,69,20,16,36,12,0.00269
BonelessB0nes,11,3,1,4,14,0.002421
Broad_Temperature554,10,5,7,12,12,0.00243
FluffyWeird1513,13,5,3,8,12,0.002555
GreatResetBet,14,15,7,22,12,0.003099
HEpennypackerNH,14,3,3,6,12,0.002527
I_like_baseball90,16,3,2,5,13,0.003375
Irdes,31,8,9,17,11,0.002742
MazerRakam,12,3,2,5,13,0.002136
Ok-Autumn,10,2,1,3,1,0.002079
RequirementQuirky468,10,3,2,5,12,0.002311
Taconinja05,10,11,3,14,13,0.008236
VansterVikingVampire,10,2,1,3,13,0.00235
boldandbratsche,31,8,10,18,13,0.00305
postdiluvium,25,11,4,15,13,0.005104
pulsatingcrocs,26,6,7,13,12,0.003421
4p4l3p3,28,4,7,11,12,0.000502
Extension_Hand1326,26,8,8,16,13,0.000839
FitIndependence6187,10,1,0,1,0,0.000274
Hipp0damos,15,6,1,7,13,0.000367
McArthur210,11,2,2,4,14,0.000282
MrVeazey,12,2,2,4,14,0.000281
Only-Butterscotch785,19,6,9,15,13,0.000476
PeoplePerson_57,18,8,8,16,13,0.001709
PoIIux,16,4,4,8,13,0.000919
Supercollider9001,29,8,7,15,12,0.006665
TarantulaWithAGuitar,10,2,1,3,13,0.000426
WanderingAlienBoy,12,6,9,15,12,0.000495
Whatswrongbaby9,21,7,4,11,13,0.000374
anarchistright,17,3,2,5,13,0.000316
formandovega,31,6,7,13,12,0.000535
grobbler21,11,2,1,3,12,0.000328
pinegreenscent,10,5,2,7,12,0.000383
xeere,17,6,5,11,13,0.000743
B1ackHawk12345,14,2,2,4,14,0.000148
Mysterious_Eye6989,20,7,7,14,12,0.001516
ohhhbooyy,11,3,2,5,13,0.000197
EnterprisingAss,15,6,6,12,12,0.000545
Grunt08,42,18,7,25,12,0.001393
Gullible-Minute-9482,27,3,4,7,13,0.000268
deadphrank,12,3,2,5,12,0.000362
joepierson123,20,3,3,6,13,0.000327
le_fez,11,3,0,3,0,0.000268
herejusttoannoyyou,13,1,5,6,15,0.000004
RiskyBrothers,13,2,1,3,14,0.000168
Buzzs_Tarantula,11,2,4,6,13,0.001481
Fattyboy_777,20,5,8,13,12,0.001295
Ion_Unbound,18,6,6,12,13,0.012103
Marchtmdsmiling,39,8,14,22,12,0.004825
metarinka,11,7,2,9,13,0.027486
jman12234,11,1,49,50,12,0.000025
00Oo0o0OooO0,17,11,1,12,13,0.000931
Brief-Percentage-193,13,3,6,9,13,0.000247
GloomyButterfly8751,28,6,4,10,13,0.000765
KFrancesC,29,7,6,13,12,0.000321
Robert_Grave,11,6,1,7,14,0.000523
bingbano,26,10,7,17,13,0.00058
dr_eh,22,4,3,7,12,0.000403
kyngston,14,6,5,11,13,0.000302
memory_of_blueskies,30,7,7,14,12,0.000564
weirdoimmunity,49,8,4,12,13,0.000546
kep_x124,18,0,30,30,12,0
Accomplished-Cat3996,11,3,2,5,14,0.00021
Brainsonastick,12,4,0,4,0,0.000643
ElectronGuru,12,2,0,2,0,0.000168
Introscopia,10,5,4,9,13,0.00048
Oberon_Swanson,16,1,1,2,1,0.000168
PM_ME_UR_Definitions,11,3,0,3,0,0.000321
RoundCollection4196,42,4,3,7,13,0.000294
Treefly916,15,2,0,2,0,0.00032
boytoy421,14,3,3,6,12,0.00051
physioworld,19,2,65,67,11,0.000177
wingspantt,13,2,2,4,13,0.000168
Dazzling_Instance_57,38,8,15,23,12,0.000725
ElReyResident,13,6,5,11,13,0.000596
EvilPutlerBotZOV,13,7,6,13,13,0.000862
Flimsy_Sector_7127,11,2,4,6,13,0.000342
HalfDongDon,11,3,3,6,13,0.000595
HeavyDutyForks,12,6,0,6,0,0.00057
MKing150,29,7,10,17,12,0.000929
Nugtr,12,3,3,6,13,0.00038
Pasadenaian,13,3,2,5,14,0.000736
Primary-Slice-2505,10,5,5,10,13,0.000404
Puzzleheaded_Buy_921,10,9,2,11,14,0.000542
Slow_Principle_7079,14,5,0,5,0,0.000504
Vekktorrr,14,3,2,5,13,0.001627
db1965,18,2,0,2,0,0.000349
icenoid,16,3,6,9,13,0.000415
Dr0ff3ll,16,3,3,6,13,0.000222
Ok_Beat9172,11,5,3,8,13,0.000239
Tricky_Break_6533,29,5,3,8,12,0.000383
jamerson537,33,6,8,14,13,0.002146
man-vs-spider,21,3,23,26,11,0.000026
Competitive_Let_9644,26,4,4,8,12,0.000616
Sea-Volume-4746,35,15,9,24,12,0.000405
engineerosexual,10,2,2,4,13,0.000195
lobonmc,30,10,6,16,13,0.00253
MeanderingDuck,26,7,7,14,12,0.000334
Mono_Clear,37,4,2,6,12,0.001154
Razorwipe,18,8,2,10,14,0.00023
moonkipp_,16,4,15,19,12,0.00008
Equivalent-Pea8907,27,6,6,12,13,0.000263
Kitchen-War242,23,3,2,5,13,0.000734
thelovelykyle,11,2,0,2,0,0.000703
najumobi,11,0,201,201,11,0
Big_Black_Clock_____,18,6,6,12,13,0.012036
Champagne_of_piss,13,6,3,9,12,0.012158
Cranyx,18,5,4,9,12,0.022256
Describing_Donkeys,14,7,5,12,12,0.021853
HideGPOne,16,3,3,6,13,0.011239
In-Brightest-Day,20,10,7,17,13,0.010729
Iwantmypasswordback,10,3,5,8,13,0.009474
Miles_vel_Day,11,11,6,17,13,0.014997
Prestigious_Load1699,31,9,10,19,13,0.015288
Prior_Coyote_4376,31,17,12,29,13,0.020752
R_V_Z,15,10,6,16,14,0.01455
ResidentBackground35,10,8,5,13,13,0.013652
Slicelker,10,8,2,10,13,0.012286
UncleMeat11,27,8,9,17,11,0.01817
absolutefunkbucket,38,4,5,9,12,0.009564
beardsac,14,7,4,11,13,0.011751
foulpudding,21,10,5,15,13,0.017559
kwantsu-dudes,10,2,4,6,13,0.008753
midnight_toker22,11,5,5,10,12,0.012487
miklayn,12,5,4,9,13,0.012253
nickcan,16,4,7,11,13,0.009926
punninglinguist,14,14,2,16,13,0.019931
sarcasticorange,13,4,4,8,13,0.009098
slicerprime,14,9,6,15,13,0.018085
soapinmouth,11,3,3,6,12,0.010891
temujin321,20,6,12,18,13,0.015788
BigbunnyATK,27,7,6,13,13,0.000387
Adiv_Kedar2,31,10,8,18,13,0.001195
AltruisticCoach9217,16,2,1,3,14,0.000637
AmELiAs_OvERcHarGeS,10,7,3,10,13,0.000804
ArCovino,33,8,8,16,13,0.001117
Chompytul,32,6,4,10,13,0.000726
ClickclickClever,15,7,6,13,13,0.000969
Dr-Assbeard,82,9,8,17,13,0.000831
FreyyTheRed,10,3,4,7,13,0.001132
JawnSnuuu,12,3,2,5,13,0.000687
LifeofTino,10,3,2,5,12,0.006599
Live_for_Now,13,3,2,5,13,0.000808
Local_Ad7264,11,5,5,10,13,0.000681
MartinBP,13,7,6,13,13,0.002746
MattVideoHD,10,3,4,7,12,0.000827
MediocreEffectt,13,4,2,6,13,0.000677
MrWoodblockKowalski,14,5,2,7,12,0.003126
No-Coach533,11,5,4,9,13,0.000693
Odd-Bumblebee00,46,7,8,15,12,0.000759
OneEverHangs,11,2,3,5,13,0.000637
PM_ME_A_PM_PLEASE_PM,33,9,9,18,12,0.000849
PeterRum,11,3,2,5,13,0.000798
PhoenixKingMalekith,10,2,1,3,14,0.000642
Powerful-Cheetah6685,10,4,3,7,13,0.000744
Slothnazi,10,4,3,7,13,0.000854
Ssgtsniper,12,4,3,7,13,0.000988
TheEmporersFinest,13,3,4,7,12,0.000639
TheOneFreeEngineer,11,3,4,7,13,0.00067
Top-Egg1266,10,3,4,7,11,0.000772
Zakaru99,31,9,8,17,12,0.000803
actsqueeze,15,5,4,9,12,0.001029
billymartinkicksdirt,56,14,13,27,11,0.001403
breakbeforedawn,60,9,12,21,12,0.000996
charlieto0human,10,3,3,6,12,0.000684
harmoniaatlast,13,3,4,7,13,0.000737
iL0veLittleGirl,143,53,30,83,12,0.004184
ignoreme010101,28,6,5,11,13,0.00073
makeyousaywhut,12,3,2,5,13,0.000673
marxist-teddybear,14,3,4,7,12,0.00084
nidarus,20,7,6,13,13,0.000848
notyourgrandad,41,15,11,26,12,0.001349
oeg2415,39,16,6,22,12,0.002046
soldiergeneal,65,12,11,23,12,0.001104
toomanyshoeshelp,39,19,15,34,12,0.00099
yosisoy,11,2,1,3,13,0.000664
AureliasTenant,42,9,6,15,12,0.000556
Careless_Bat_9226,27,8,5,13,12,0.000507
ChampagneDividends,51,12,11,23,12,0.000425
DarkNo7318,20,5,4,9,12,0.000525
Diveblock,23,1,1,2,1,0.000321
FaithfulPichu,15,2,5,7,13,0.00065
Famous-ish,13,2,1,3,13,0.00033
Former_Indication172,10,4,4,8,12,0.000359
Frooctose,21,3,2,5,13,0.00033
Glad-Talk,14,3,2,5,13,0.000333
Grand_Fun6113,80,10,9,19,12,0.000688
Hunterofshadows,11,2,1,3,13,0.000322
Icy-Mortgage8742,10,4,3,7,12,0.000322
JJSF2021,28,4,2,6,13,0.000567
Karmaze,11,5,5,10,13,0.000702
MCRemix,11,2,1,3,14,0.000322
MobiusCube,30,7,5,12,14,0.000361
StartledMilk,13,2,1,3,14,0.001467
TehNudel,11,2,1,3,14,0.000386
Virtual_Piece,10,3,3,6,13,0.00033
Visible_Pair3017,23,4,4,8,12,0.000398
antiquatedadhesive,10,4,6,10,13,0.000365
illini02,16,4,4,8,13,0.000383
pzerr,11,2,2,4,2,0.000322
quix0te,15,2,2,4,13,0.000325
vbob99,16,4,3,7,12,0.000357
ricknightwood13,11,3,22,25,12,0.000319
Henrik3443,35,4,5,9,13,0.000243
3slimesinatrenchcoat,10,4,3,7,13,0.001529
ArtOfBBQ,28,10,11,21,12,0.001992
BigBoetje,24,6,3,9,13,0.00172
Electrical_Quiet43,13,2,4,6,12,0.001326
Honest_Initiative471,21,5,8,13,12,0.00147
IeyasuMcBob,18,4,4,8,12,0.001286
Imaginary_Exam1068,19,7,8,15,13,0.001355
MeasurementCreepy926,132,15,20,35,12,0.003496
MisfireMillennial,51,5,3,8,13,0.001415
PeepSkate,11,2,1,3,14,0.001153
Scarlet-kenku2500,10,3,1,4,1,0.001175
Seeker_Of_Toiletries,15,3,3,6,12,0.001364
Socialmediaisbroken,10,5,4,9,13,0.001306
Stock-Film-3609,31,7,6,13,13,0.002305
TellItLikeItIs1994,11,3,4,7,13,0.001469
TheFlyingSheeps,17,3,9,12,12,0.001327
TrickyTicket9400,12,12,3,15,13,0.001757
VirtualMoneyLover,56,13,18,31,12,0.002549
anaconda4290,69,5,8,13,12,0.001217
blangenie,14,4,4,8,12,0.00143
chrisfathead1,15,8,3,11,12,0.001606
explain_that_shit,11,10,8,18,12,0.001408
mikevago,12,3,3,6,12,0.001618
ow_bpx,14,3,3,6,13,0.00284
spiteful-vengeance,21,7,9,16,12,0.001436
swallowmoths,13,5,3,8,13,0.00286
AbjectForm5759,14,4,7,11,13,0.001275
DancingWithAWhiteHat,25,11,5,16,13,0.001698
GadgetGamer,11,6,5,11,13,0.001233
Mean_Lawfulness_9781,14,4,4,8,13,0.00118
gorkt,11,3,2,5,12,0.001502
strongerthenbefore20,11,0,34,34,13,0
CalebAsimov,17,3,5,8,13,0.000289
Ottomatik80,19,3,2,5,14,0.000162
PureAntimatter,11,2,1,3,14,0.000429
SRIrwinkill,31,2,4,6,13,0.00017
Woah_Mad_Frollick,14,2,1,3,3,0.000152
actuallychrisgillen,20,2,1,3,15,0.000152
ameis314,28,5,2,7,14,0.000678
bawdiepie,11,3,2,5,13,0.000162
catdude142,39,3,5,8,14,0.000155
chinmakes5,12,6,1,7,13,0.005002
firematt422,34,4,4,8,12,0.000649
grottohopper,11,2,1,3,15,0.000153
hillsfar,10,2,2,4,14,0.000206
thatoneguy54,19,6,3,9,14,0.000622
thelastvortigaunt,12,2,1,3,15,0.000152
MiddleList52,11,3,3,6,13,0.000602
RealJohnBobJoe,48,4,2,6,13,0.000448
mjwza,15,6,2,8,13,0.000605
sophisticaden_,14,2,1,3,13,0.00034
AlienReprisal,17,11,5,16,13,0.012549
GoldenStarsButter,16,3,4,7,13,0.013455
StealUr_Face,11,4,2,6,13,0.005347
TheyGaveMeThisTrain,13,7,3,10,13,0.004715
bearrosaurus,14,9,5,14,12,0.01121
chronberries,28,9,6,15,12,0.006914
Both-Estimate-5641,43,7,16,23,12,0.000553
CrossXFir3,10,1,0,1,0,0.000334
Flymsi,12,3,3,6,13,0.000395
LynnSeattle,39,12,12,24,11,0.002205
Marty-the-monkey,28,4,1,5,12,0.000694
NefariousnessMost660,23,3,6,9,12,0.00037
NonbinaryYolo,14,3,2,5,13,0.000339
ParfaitBurnera,11,3,2,5,13,0.000363
Puzzleheaded_Mix4160,24,6,4,10,13,0.000363
RadiantHC,53,9,14,23,12,0.000821
Salty_Map_9085,21,4,4,8,13,0.000339
Tirriforma,19,5,4,9,13,0.000376
ToSAhri,37,9,11,20,11,0.000638
boredtxan,15,3,3,6,13,0.000344
ellirae,17,5,4,9,13,0.000478
harpyprincess,31,7,8,15,13,0.000742
plantfumigator,12,5,5,10,12,0.000472
trickmirrorball,22,4,2,6,12,0.000401
FractionalFibonacci,11,2,1,3,14,0.000213
GtBsyLvng,14,3,2,5,14,0.000226
Limmeryc,16,5,5,10,12,0.001006
RaspberryLast170,11,3,2,5,12,0.000216
Tommyblockhead20,12,3,3,6,12,0.001234
ghotier,217,30,32,62,12,0.002939
Crew_1996,15,4,5,9,13,0.00026
yelbesed,10,0,2,2,14,0
---AI---,30,7,8,15,12,0.000265
ConsultJimMoriarty,50,19,12,31,13,0.000485
body_oil_glass_view,15,3,1,4,14,0.000016
carterthecomic,37,7,6,13,12,0.000239
marzaksar,14,4,3,7,12,0.000052
Horse__Latitudes,42,3,10,13,12,0.000058
LookAtMeNow247,22,11,10,21,12,0.009879
-HeisenBird-,10,2,1,3,13,0.000013
Bonky147,12,8,4,12,13,0.004425
RegressToTheMean,30,20,10,30,12,0.008051
ides205,27,7,6,13,13,0.010576
-spicychilli-,20,9,2,11,13,0.000305
lonecylinder,46,8,9,17,13,0.000303
00PT,17,4,5,9,12,0.000048
Icy_River_8259,76,14,10,24,12,0.001162
sapphireminds,55,10,9,19,11,0.000802
00rb,29,6,7,13,13,0.000004
Boisemeateater,26,5,1,6,14,0.000056
IdeaMotor9451,12,1,1,2,14,0.000054
Story_Man_75,21,11,4,15,12,0.00045
Laesslie,23,6,6,12,13,0.000245
outestiers,66,13,15,28,12,0.000912
0fluffythe0ferocious,12,0,1,1,12,0
littlebitfunny21,48,7,8,15,11,0.000001
0nlyhalfjewish,31,1,2,3,14,0.000001
LostMyKarmaElSegundo,12,4,5,9,15,0.000029
1-objective-opinion,19,4,4,8,13,0.000438
steponmedaddies,38,5,11,16,13,0.000345
101ina45,14,4,5,9,13,0.00174
Unfounded_archeology,15,4,5,9,13,0.002158
FudGidly,11,2,3,5,13,0.000849
conduffchill,12,5,4,9,12,0.000211
AdministrativeSet419,10,11,4,15,13,0.001688
BitcoinMD,18,6,4,10,12,0.000517
CincyAnarchy,20,10,5,15,12,0.001154
Cytothesis,10,4,2,6,13,0.000423
Deadpoint,18,6,5,11,12,0.000561
Gym_Noob134,10,2,2,4,13,0.000309
JRingo1369,19,4,6,10,13,0.000367
MercuryChaos,12,2,1,3,13,0.000271
Morasain,11,4,4,8,12,0.000386
Nojopar,41,9,11,20,12,0.001238
Overlook-237,20,5,6,11,12,0.00038
PandaMime_421,26,9,9,18,12,0.000567
SilverWear5467,19,4,3,7,12,0.001977
amopeyzoolion,10,2,5,7,13,0.000268
bossmt_2,12,8,3,11,13,0.000313
energirl,16,4,5,9,13,0.000447
hi_imjoey,11,3,1,4,1,0.00045
mrGeaRbOx,30,4,3,7,13,0.000457
pyramidalembargo,17,3,2,5,13,0.000266
tenfolddamage,19,2,2,4,13,0.000266
GiddyChild,12,1,1,2,14,0.000012
68_hi,18,1,2,3,12,0.00039
Cornwallis400,17,9,3,12,13,0.000644
PlayfulRemote9,18,5,5,10,13,0.000172
DidjaSeeItKid,11,1,3,4,13,0.000573
straightcashhomey29,16,1,1,2,13,0.000573
NuncErgoFacite,10,2,1,3,13,0.000428
TexanInNebraska,25,5,5,10,13,0.00022
The_Hungry_Grizzly,11,3,3,6,14,0.000012
cochlearist,15,4,1,5,15,0.000118
ucotcvyvov,19,3,1,4,15,0.000016
Jmcduff5,22,8,4,12,13,0.000674
AdmiralSaturyn,68,33,23,56,13,0.028898
233C,16,6,3,9,13,0.001132
Choano,13,7,4,11,14,0.000042
2apple-pie2,10,2,3,5,13,0.000009
CritterFan28,14,5,5,10,13,0.000116
TheBossOfItAll,26,10,7,17,13,0.000267
2dogslife,26,1,3,4,14,0
BeatificBanana,28,6,4,10,13,0
Imabigdealonredditny,12,1,1,2,1,0
swillshop,35,1,0,1,0,0
BadIdeaSociety,11,7,3,10,13,0.012036
BadNewsSherBear,11,3,6,9,13,0.001717
Salsa_and_Light2,49,9,14,23,12,0.000399
Wombattington,17,3,4,7,13,0.000118
RL203,16,6,3,9,13,0.004737
cpatkyanks24,11,4,1,5,14,0.002147
ThePoppaJ,12,3,2,5,13,0.005293
Malibu921,18,3,3,6,14,0.000095
TheDuckOnQuack,10,4,2,6,13,0.000687
Junior_Razzmatazz164,18,4,3,7,13,0.000073
thatnameagain,28,5,7,12,13,0.00006
Down_D_Stairz,13,8,6,14,13,0.000112
4rch1t3ct,11,4,3,7,13,0.000088
BUUAHAHAHA,21,20,5,25,13,0.001284
Dooey,13,1,1,2,14,0.000004
cballowe,30,15,8,23,13,0.008467
6a6566663437,11,3,1,4,13,0.000303
6data,16,2,4,6,13,0.000012
Ok-Anteater_6635x,15,7,4,11,13,0.000108
Pressondude,13,6,5,11,13,0.00012
rewt127,22,7,7,14,13,0.000243
7625607,12,1,1,2,1,0
Ok_Tonight_3703,11,2,0,2,0,0
Tydeeeee,33,3,1,4,12,0.000696
bezjones,11,1,1,2,12,0.000126
Baselines_shift,29,5,8,13,12,0.006273
nope-nope-nope-nop,35,8,8,16,13,0.007023
ZeBigD23,19,14,7,21,13,0.016399
AOWLock1,28,8,5,13,13,0.000353
HKBFG,11,2,3,5,12,0.000015
flaminhotcheetos_,10,2,1,3,14,0.000037
ASpaceOstrich,12,3,3,6,11,0.000078
Sevourn,48,7,6,13,11,0.0001
datingcoach32,24,4,6,10,11,0.0004
ATotalCassegrain,16,3,2,5,14,0.000033
burnbobghostpants,13,4,5,9,13,0.000019
AVGJOE78,22,7,9,16,12,0.000151
Head_Personality_394,20,4,6,10,13,0.000069
Itzko123,12,3,3,6,13,0.000018
Physical-Dingo-6683,76,31,29,60,11,0.000976
communityneedle,11,10,3,13,13,0.000139
AVeryBadMon,20,5,5,10,13,0.002382
MissMenace101,58,6,20,26,12,0.001729
Xeltar,20,8,12,20,12,0.005758
Fit_Cut_4238,14,4,6,10,12,0.001796
AWildReaperAppears,29,5,5,10,12,0.000075
And_Justice,51,14,11,25,12,0.000499
D_Prime94,10,1,1,2,13,0.000001
NotACommie24,31,7,9,16,12,0.000139
Union_Jack_1,36,6,6,12,12,0.000305
rememberimapersontoo,34,8,2,10,12,0.000001
A_Typicalperson,14,2,2,4,14,0.000045
Riptiidex,21,5,5,10,13,0.000769
A_little_lady,10,1,1,2,13,0
ImpossibleReason2204,65,8,5,13,12,0
Aardwolfington,15,2,2,4,13,0.000083
GiveMeAHeartOfFlesh,40,4,5,9,12,0.000179
bionicfeetgrl,25,8,7,15,13,0.006854
DataTouch12,37,3,2,5,13,0.000083
Acceptable-Remove792,20,3,1,4,14,0.000038
health_throwaway195,26,3,4,7,13,0.000006
Mejari,34,5,11,16,12,0.000038
TurtleTurtleFTW,10,1,1,2,14,0.000011
Xicadarksoul,24,5,6,11,13,0.000206
Minute-Employ-4964,11,3,4,7,12,0.000065
Shepard_Normandy,26,3,3,6,13,0.000036
rollingrock16,12,7,2,9,13,0.001355
way2lazy2care,39,17,15,32,13,0.007097
According-Tea-3014,19,0,1,1,13,0
AccordingMedicine129,11,2,3,5,11,0
SimonPopeDK,24,3,4,7,11,0.000002
chessboxer4,20,3,5,8,11,0.000002
AccountantsNiece,11,3,6,9,13,0.000181
tanatan88,11,9,5,14,14,0.000283
Accurate-Neck6933,21,2,2,4,12,0.000014
Princess-Eilonwy,26,9,4,13,12,0.000006
vanastalem,10,2,3,5,11,0.000002
Criminal_of_Thought,11,6,5,11,13,0.000129
Acrobatic-Narwhal-62,10,2,3,5,13,0.000019
Broseph_Heller,27,14,9,23,13,0.000563
TNine227,28,8,9,17,13,0.000274
drtropo,13,2,3,5,13,0.000055
Acrobatic_Ad5722,10,0,1,1,14,0
regus0307,22,3,2,5,13,0
Acrobatic_Ear6773,10,5,5,10,13,0.000033
Apprehensive_Set_105,16,3,3,6,14,0.000005
BrazilBound25,13,5,4,9,12,0.000027
ItsFuckingScience,10,6,4,10,13,0.000099
ActualDW,11,1,1,2,14,0.000003
AgitatorsAnonymous,12,4,5,9,13,0.002594
AdComprehensive960,18,2,4,6,14,0.000184
Cerulean_IsFancyBlue,11,4,1,5,14,0.000209
Puzzleheaded_Ant3378,18,2,3,5,14,0.000014
ShakyTheBear,10,2,1,3,1,0.000035
youwillbechallenged,26,11,9,20,13,0.011364
DuePersonality8585,16,3,3,6,12,0.000125
QuantumR4ge,21,5,9,14,11,0.000607
AdImmediate9569,17,6,6,12,12,0.000241
Beautiful-Loss7663,39,13,11,24,12,0.000414
Silon17,12,7,3,10,13,0.00009
redditratman,17,8,5,13,13,0.000314
JustMeAndMyKnickas,13,2,2,4,13,0.003101
_Floriduh_,15,10,7,17,13,0.00601
blaqsupaman,12,7,7,14,13,0.006111
Adequate_Images,25,2,2,4,12,0.000035
Brief-Bat7754,14,3,5,8,12,0.000659
Dregride,23,6,7,13,13,0.000341
Mad_Maddin,24,5,11,16,12,0.000248
annabananaberry,46,12,12,24,12,0.000265
Admirable_Ardvark,11,0,1,1,14,0
Dweller201,23,2,1,3,13,0.000007
AdmiralDalaa,13,1,3,4,13,0.000007
DerekVanGorder,13,3,5,8,13,0.000109
InfamousDeer,14,12,6,18,12,0.000202
CaptainoftheVessel,15,7,7,14,13,0.005739
Adorable-Bobcat-2238,14,1,2,3,14,0
QuestionMaker207,10,1,1,2,2,0
clauclauclaudia,14,3,4,7,13,0.000005
Beneficial-Set2738,31,3,4,7,12,0.000075
AdvancedMasterMode,10,2,3,5,13,0.000042
Unique_Statement7811,32,8,9,17,13,0.000316
arrogant_ambassador,19,12,7,19,12,0.000287
AffectionateStudy496,14,3,7,10,12,0.000206
LotsoPasta,11,5,5,10,13,0.000331
SannySen,39,11,8,19,13,0.000399
Affectionate_Top340,21,7,5,12,12,0.003935
Aggressica,12,1,1,2,15,0
Expert_Slip7543,10,1,1,2,14,0
AgileSurprise1966,13,0,1,1,1,0
CozyCoco99,16,1,0,1,0,0
Agile_Menu_9776,10,0,5,5,12,0
Novel_Fox,19,3,3,6,12,0
PikaV2002,30,3,4,7,11,0
TheDarkHelmet1985,47,5,5,10,13,0.000013
keesouth,36,2,1,3,12,0
lifeinwentworth,29,2,4,6,13,0.000006
DeadlyPython79,52,9,13,22,12,0.001247
KJongsDongUnYourFace,14,9,4,13,12,0.000339
michaelcanav,13,5,3,8,12,0.000369
Impressive_Ad_5614,26,6,4,10,13,0.00012
KittyQueen63,50,9,7,16,13,0.000371
Obsessive0551,13,4,3,7,11,0.000029
Agitated_Elephant469,13,4,4,8,13,0.001768
imatexass,17,2,3,5,13,0.000368
MinneapolisJones12,13,6,5,11,12,0.00014
ToranjaNuclear,29,6,8,14,12,0.000239
AhsokaSolo,36,4,5,9,12,0.000232
DJFrostyTips,33,3,3,6,13,0.000098
ImDeputyDurland,18,2,2,4,13,0.000117
Opening_Acadia1843,14,6,5,11,12,0.000178
AidenFested,12,2,2,4,13,0.000007
fourmesinatrenchcoat,15,6,3,9,12,0.000134
AlabasterPelican,11,5,2,7,12,0.000184
faux-fox-paws,96,32,21,53,12,0.001019
Zwicker101,42,7,5,12,13,0.001302
flatscreeen,13,2,2,4,13,0.000176
Streambotnt,12,6,5,11,12,0.000468
bearsnchairs,26,4,6,10,12,0.000091
Alev233,12,2,3,5,13,0.000079
TheSameGamer651,11,4,5,9,12,0.004658
Xanto97,26,14,7,21,13,0.005523
iguacu,10,4,1,5,13,0.006044
CSIBNX,10,3,3,6,13,0.000904
Alien_invader44,14,5,2,7,13,0.00037
Alive-Difference3905,11,2,4,6,12,0.000004
Disastrous_Onion_958,32,4,4,8,12,0.000083
Hodgkisl,13,7,3,10,13,0.000253
happyinheart,31,9,16,25,12,0.000365
AlkatrazzPrime,29,3,3,6,13,0.000115
Past_Scholar3723,18,3,6,9,13,0.000019
AllAFantasy30,12,0,1,1,14,0
barfbat,20,3,4,7,13,0
Allaboutbird,47,9,6,15,13,0
FlipFlopFlappityJack,17,2,4,6,12,0.000004
LiveKindly01,82,15,14,29,12,0.000015
MaeSilver909,10,2,0,2,0,0.000003
Malice_A4thot,12,1,1,2,15,0.000003
adventuresofViolet,36,9,3,12,13,0.000043
Allenobriann,23,5,5,10,13,0.000117
mickeyanonymousse,18,5,5,10,10,0.000215
ogjaspertheghost,43,8,8,16,12,0.000097
Alternative-Cut-7409,10,1,1,2,13,0.00006
Alternative-Redditer,39,5,6,11,12,0.000049
Donutsmell,20,3,0,3,0,0.000004
SuccessfulAd4606,27,3,3,6,13,0.000396
West_House_2085,61,3,5,8,11,0.000004
Alternative-Smile366,10,1,1,2,13,0.000015
TangoJavaTJ,94,29,16,45,11,0.000661
clowncarl,14,6,3,9,13,0.00016
Alternative_End_7174,10,0,1,1,15,0
Ok_Soft_4575,51,10,10,20,12,0.000727
Alternative_Switch39,22,3,6,9,13,0.000019
Puzzleheaded_Ad_5710,29,4,3,7,14,0.000028
RedSpaceman,20,4,6,10,12,0.000063
cheeruphumanity,11,8,4,12,13,0.000241
l_Paddystinian_l,11,4,4,8,13,0.000089
temujin94,16,2,4,6,12,0.000124
Altruistic-Berry-31,18,4,4,8,13,0.000033
BeardedDragon1917,10,1,1,2,14,0.000004
LongjumpingSeaweed36,14,2,2,4,13,0.000049
McKoijion,17,3,3,6,13,0.000087
Whatever4M,11,2,2,4,13,0.000043
DeepShill,12,8,5,13,12,0.006392
AlwaysHigh27,17,3,2,5,14,0.000045
Shmuckle2,16,6,4,10,13,0.000159
Jealous-Factor7345,19,5,5,10,12,0.000144
StobbstheTiger,30,11,8,19,13,0.000309
yeahmanbombclaut,15,4,3,7,13,0.00011
Odd-Zombie-5972,11,4,3,7,13,0.000008
No_Cheesecake_9019,17,3,3,6,13,0.000625
Anameillforge,14,3,2,5,2,0
Historical_Wing3120,14,1,1,2,3,0
makethatnoise,11,2,2,4,2,0
Finklesfudge,16,5,6,11,12,0.000578
Fulg3n,32,7,7,14,11,0.000131
Thriftless_Ambition,22,9,6,15,12,0.016323
magus678,15,4,7,11,13,0.001528
ClueMaterial,35,5,5,10,13,0.000418
Craig-Tea-Nelson,12,4,5,9,12,0.00018
Odd-Influence-5250,11,4,4,8,13,0.000131
Individual642,20,7,7,14,13,0.00011
TheLandOfConfusion,11,2,2,4,13,0.00003
Legitimate_Gas2966,10,1,1,2,13,0.000015
Massive_Wealth42069,12,4,3,7,13,0.000092
Paradoxe-999,36,7,9,16,12,0.000302
Sulfamide,43,10,11,21,12,0.014596
Wellington_Wearer,16,5,6,11,12,0.000194
_zhz_,11,2,4,6,12,0.000061
GSilky,23,4,3,7,13,0.000091
HOLEPUNCHYOUREYELIDS,15,2,3,5,14,0.000003
JonnyAU,13,1,2,3,13,0.000002
Major2Minor,13,1,2,3,14,0.000002
blackkettle,10,2,0,2,0,0.000018
epelle9,27,1,4,5,13,0.000002
teflondung,21,3,3,6,13,0.00022
Anon28301,15,6,6,12,12,0.000063
MadGobot,15,1,1,2,13,0.000008
BoratImpression94,25,5,7,12,12,0.00159
InterestingTheory9,35,4,5,9,12,0.000086
Overall-Ratio-1446,39,7,11,18,12,0.00012
WhiteGold_Welder,13,4,2,6,13,0.0016
runwith,11,1,1,2,13,0.000048
TuggenDixon,23,8,5,13,12,0.000363
wasabiiii,10,2,3,5,13,0.000077
OstentatiousBear,15,8,5,13,13,0.001316
Trauma_Hawks,19,7,6,13,12,0.000604
AnyBudget5507,11,1,2,3,1,0
Savitar5510,24,1,1,2,2,0
Anzai,13,3,3,6,13,0.000659
B9F2FF,19,4,4,8,13,0.000009
Proud-Sandwich8516,15,3,4,7,13,0.000048
Apart-Survey,10,1,4,5,12,0
Commonscents2say,12,3,2,5,12,0
Lmaris,25,6,7,13,12,0
annang,20,3,3,6,12,0
unsafeideas,33,5,3,8,11,0.000023
Rufus_TBarleysheath,23,3,4,7,12,0.000431
Apathetic_Villainess,18,2,2,4,13,0.000199
Technical-Revenue-48,16,5,5,10,13,0.000106
irespectwomenlol,10,7,3,10,13,0.000506
ApetteRiche,12,3,5,8,14,0.000031
Aquiduck,16,1,0,1,0,0.000006
Hefty-Reaction-3028,20,10,8,18,12,0.000448
Minty_Widower,11,2,2,4,13,0.00002
Osr0,10,3,2,5,13,0.00014
Zee216,11,1,2,3,12,0.000006
radred609,17,5,8,13,11,0.000089
Apprehensive-Top3756,11,1,2,3,12,0.000002
Apprehensive_Run238,36,8,5,13,13,0.000024
ArguteTrickster,40,7,8,15,12,0.000288
Gullible-Test8204,17,4,5,9,13,0.000019
Infinite_Collar_7610,13,1,2,3,13,0.000001
whatsitallabout999,10,5,4,9,13,0.000047
ExaggeratedSnails,15,2,2,4,13,0.000195
mambotomato,11,2,2,4,13,0.000006
BlueCollarRevolt,18,4,5,9,12,0.000154
Ndlburner,13,4,3,7,13,0.00006
PhysicalWave454,11,4,3,7,13,0.000024
Archophob,12,3,3,6,13,0.000128
Easy_Masterpiece_605,19,12,5,17,13,0.000471
Biffs_bunny,34,11,7,18,12,0.000374
Rawlott1620,25,6,8,14,12,0.000259
allbusiness512,15,4,4,8,13,0.000095
iTonguePunchStarfish,11,4,5,9,12,0.00005
ArielTheKidd,19,1,2,3,13,0.000004
Aromatic-Victory4210,11,0,3,3,11,0
South_Industry_1953,124,11,7,18,10,0.000001
Time-Tie-231,36,3,0,3,0,0
Wonderful_Two_6710,13,2,0,2,0,0
MakeItCelestial,10,1,2,3,13,0.000009
Ok-Hunt7450,30,4,5,9,12,0.000333
Super_Eagle1198,17,3,3,6,13,0.000044
Thinslayer,11,4,3,7,13,0.000066
AryaStark1313,18,1,3,4,12,0.000001
Bitter-Paramedic-531,16,4,1,5,13,0
Cudi_buddy,12,4,3,7,13,0.000014
Oyster5436,18,4,2,6,11,0.000001
Telcontar77,11,3,6,9,13,0.00296
AskingToFeminists,72,4,4,8,12,0.000226
OldSky7061,33,5,5,10,12,0.000352
leekeater,15,5,4,9,13,0.00022
Asleep_Region,11,2,1,3,13,0
myssi24,13,2,3,5,12,0
traumfisch,22,1,2,3,13,0.000002
SocksRocksDocks,36,5,3,8,13,0.000204
Unfair_Explanation53,15,4,4,8,12,0.000444
Assume_Utopia,13,5,1,6,1,0.000005
BillionTonsHyperbole,14,1,0,1,0,0
AsterKando,15,3,2,5,13,0.000011
CharmCityKid09,14,6,6,12,12,0.000108
Ornithopter1,38,5,8,13,12,0.000067
Theycallmeahmed_,12,8,4,12,13,0.000126
petitememer,10,4,3,7,13,0.000041
Aunt_Anne,11,1,1,2,14,0
Wise_Owl5404,19,7,3,10,13,0.000003
Evil_B2,29,6,5,11,13,0.013611
Rough_Butterfly2932,14,4,6,10,12,0.000228
Nate-dude,12,4,3,7,13,0.000136
Rollingforest757,27,7,11,18,12,0.000166
Avalonisle16,10,2,2,4,15,0
Bittybellie,15,2,1,3,16,0
CandylandCanada,53,5,4,9,14,0
Entire-Ad2058,25,4,5,9,11,0.00036
Aware_Acanthaceae_78,11,0,2,2,12,0
StAlvis,80,16,4,20,11,0.000003
smbpy7,75,5,11,16,12,0
Friendly-Many8202,13,14,2,16,13,0.000765
gemunicornvr,144,9,15,24,12,0.000314
hogsucker,13,8,7,15,13,0.000363
JefeRex,20,6,5,11,13,0.000028
Ptcruz,17,2,4,6,12,0.00021
BJPark,16,7,3,10,13,0.003955
DefaultProphet,15,5,2,7,13,0.002244
NigroqueSimillima,15,3,3,6,12,0.002772
No_Passion_9819,50,2,4,6,13,0.002718
Sea-Document-974,12,1,2,3,12,0.000982
curly_spork,11,5,3,8,13,0.005459
Revachol_Dawn,90,13,15,28,12,0.000533
DumboWumbo073,13,3,4,7,13,0.001198
Background-Cow8401,16,1,1,2,14,0
Possible_Emergency_9,13,2,1,3,13,0
Background-Key-457,12,12,3,15,13,0.000475
Every_Single_Bee,15,4,4,8,12,0.00003
Z86144,14,2,2,4,13,0.000009
BadHabitOmni,21,4,5,9,12,0.008892
Pandaaaa33,10,2,2,4,13,0.004113
Ballatik,10,1,1,2,13,0.000191
BalloonShip,10,0,2,2,15,0
BigBigBigTree,35,10,4,14,14,0.000033
almaperdida99,18,5,1,6,15,0.000026
KingKnotts,63,12,16,28,13,0.0093
BarBryzze,17,3,3,6,14,0.000007
Sensitive_Housing_85,13,3,3,6,13,0.000052
TheFoxer1,14,1,1,2,15,0
mauri9998,38,5,6,11,13,0.000127
Bartok_The_Batty,22,0,2,2,13,0
GoodQueenFluffenChop,11,1,1,2,1,0
Shadow4summer,22,5,9,14,12,0
Budget_Llama_Shoes,32,9,7,16,13,0.00831
hunbot19,16,6,7,13,12,0.000213
dEm3Izan,19,4,6,10,13,0.000105
Bast_OE,11,1,2,3,13,0.000003
BeGoodToEverybody123,21,3,2,5,13,0.000252
YNABDisciple,24,7,3,10,14,0.000554
Be_Kind_And_Happy,18,1,1,2,13,0.00052
LavishnessGeneral,10,1,1,2,14,0
No-Strawberry-5804,13,3,2,5,14,0
Turbulent_Cow2355,43,8,9,17,12,0.000023
FinalSealBearerr,46,8,12,20,12,0.000437
SinesPi,11,2,3,5,12,0.000044
zacsxe,12,2,1,3,14,0.00009
Beginning_Cupcake_45,12,4,7,11,13,0.000145
idontknowhow2reddit,28,21,4,25,13,0.002086
north_canadian_ice,11,6,4,10,13,0.000367
park777,18,2,7,9,12,0.000026
BigMcLargeHuge8989,12,5,4,9,13,0.00019
keepin-it-sleezy,15,4,4,8,13,0.000065
ergo_incognito,21,6,3,9,13,0.000094
Best_Pants,17,4,3,7,12,0.000091
DreamofCommunism,18,2,4,6,12,0.000005
Better-Needleworker6,15,3,3,6,11,0.000217
BidRevolutionary945,11,1,1,2,14,0
NeatNefariousness1,15,1,2,3,13,0
Oishiio42,36,10,7,17,12,0.000319
Zequen,25,9,4,13,12,0.000935
Big-Imagination4377,27,3,4,7,14,0
ConflictGullible392,83,6,2,8,14,0.000002
Exotic-Knowledge-243,24,3,3,6,14,0
Similar_Pineapple418,15,6,2,8,15,0
Big-Maintenance2544,11,1,5,6,13,0.000015
pump1ng_,13,3,4,7,12,0.000026
ButterscotchIll1523,11,2,3,5,13,0
sunlightanddoghair,10,1,1,2,15,0
Just_Nefariousness55,10,1,2,3,14,0.000004
Colley619,10,3,2,5,14,0.000115
BigGreenBillyGoat,24,1,1,2,15,0
gdognoseit,18,1,2,3,14,0
BigLilLinds,19,0,1,1,14,0
CertainGoon,11,2,1,3,13,0
BigMax,15,1,1,2,1,0
NefariousnessSweet70,13,1,1,2,1,0
LotionedBoner,12,4,6,10,13,0.000176
wheres_my_hat,22,6,5,11,12,0.011224
Jaymoacp,12,8,5,13,12,0.000261
Competitive_Jello531,17,3,4,7,13,0.000024
Rare-Ad-8087,12,3,4,7,12,0.000016
mangababe,18,7,7,14,11,0.000224
Critical-Buy-8677,22,5,4,9,12,0.000185
Cynthesyss,17,5,3,8,13,0.000136
Frientlies,14,2,2,4,13,0.000102
Quiet_Fan_7008,11,4,3,7,13,0.000161
Sparrowphone,27,5,4,9,12,0.000188
VPackardPersuadedMe,12,4,2,6,13,0.000149
pearl_harbour1941,28,2,2,4,13,0.000108
BillyBobJangles,15,2,3,5,15,0.000001
Ok-Question1597,12,2,2,4,14,0.000005
Workingclassstoner,10,2,2,4,15,0.000009
cwaterbottom,11,2,0,2,0,0.000096
Rhomya,14,5,5,10,13,0.000335
username_blex,26,7,10,17,12,0.000096
shadesofnavy,18,4,7,11,13,0.000232
Possible-Tangelo9344,30,4,4,8,12,0
Rindan,11,2,2,4,12,0.002625
Waterwoo,18,5,7,12,13,0.003638
trabajoderoger,25,7,8,15,13,0.000196
NonsensePlanet,10,3,2,5,13,0.001292
SilverTumbleweed5546,15,3,3,6,12,0.000073
BlooregardQKazoo,16,1,1,2,14,0.000001
More_Mind6869,45,8,8,16,13,0.000311
Bludiamond56,33,2,2,4,12,0
RelativePickle8333,11,1,2,3,13,0
StructEngineer91,10,1,4,5,11,0
LeRoyRouge,26,5,5,10,13,0.008049
StampMcfury,12,8,5,13,13,0.003297
Vegetable-Two-4644,16,7,6,13,12,0.000834
Happy_Tip_2091,15,4,1,5,13,0.018033
Pale_Zebra8082,12,1,1,2,13,0.010545
Remarkable_Aside1381,13,3,6,9,13,0.011294
Santosp3,12,3,2,5,13,0.01266
SoggyGrayDuck,16,8,7,15,13,0.017224
StopStealingMyShit,19,5,4,9,13,0.012288
_Age_Sex_Location_,12,1,6,7,12,0.010545
firewatch959,27,4,8,12,12,0.003746
BobbieMcFee,11,0,1,1,14,0
Nameless_consult,11,3,2,5,13,0.000007
Useful-Back-4816,24,2,6,8,13,0.000004
FrickinLazerBeams,45,9,11,20,13,0.000179
Bolt_EV,12,1,1,2,14,0.000447
BoobySlap_0506,16,0,2,2,12,0
Pandora2304,19,2,4,6,11,0
SurroundTiny,10,4,2,6,13,0.000126
Both_Bear3643,13,2,5,7,12,0.000238
ChihuahuaNoob,32,5,7,12,12,0.000533
Br0wnieSundae,13,0,2,2,14,0
Brave-Silver8736,12,1,2,3,14,0.000002
WVUEnchilada,24,4,3,7,13,0.0001
BraveOpinion3289,11,3,3,6,13,0
CarlEatsShoes,11,1,2,3,12,0
Jocelyn-1973,10,4,0,4,0,0
NobleNop,28,3,5,8,13,0
Pip-Pipes,13,2,3,5,13,0.000005
Brikish,11,3,4,7,15,0.000001
Cyberpunk2044,24,1,0,1,0,0
SideEmbarrassed1611,13,1,1,2,16,0
Trawling_,16,3,8,11,12,0.000074
Darkmayday,21,5,5,10,13,0.000171
Bronze_Rager,13,2,3,5,13,0.000165
Openmindhobo,12,3,2,5,12,0.000286
bidenxtrumpxoxo2,10,2,2,4,13,0.000085
IEATASSETS,26,5,4,9,13,0.000115
im-obsolete,14,6,4,10,13,0.000256
EveningImaginary1380,12,4,4,8,12,0.000214
Financial_Change_183,11,4,2,6,13,0.000143
BuHoGPaD,12,3,5,8,11,0.00001
Swimming-City-5001,105,14,5,19,10,0.000006
mrspyguy,10,6,2,8,12,0.000087
owls_and_cardinals,17,6,3,9,12,0.000001
Repeatitpete,20,11,8,19,13,0.003908
Stunning-Equipment32,15,4,2,6,14,0.0021
Zestyclose-Cat-1093,21,3,3,6,13,0.001145
BurtMSnakehole,29,3,4,7,13,0.000003
Dependent-Canary-514,17,5,3,8,12,0.000003
OutSourcingJesus,22,6,2,8,14,0.000154
architect___,10,2,4,6,13,0.000278
mikefick21,32,2,6,8,12,0
ButterLettuth,11,2,1,3,13,0.000679
Somebody_81,32,4,7,11,12,0
Mrs_Noelle15,10,4,3,7,13,0.000148
Sm3x,18,6,5,11,13,0.000335
lily-prince,12,2,3,5,14,0.00003
CHiuso,11,3,3,6,13,0.00004
COskibunnie,18,3,3,6,16,0
Moogatron88,14,1,1,2,17,0
Temporary_Row_7572,10,3,3,6,16,0
WearyMatter,10,3,2,5,15,0.000006
Hungry-Struggle-1448,57,11,15,26,12,0.001027
thedamnoftinkers,10,1,1,2,13,0.000039
Calaveras-Metal,25,4,5,9,12,0.000123
Steamed_Memes24,13,4,4,8,13,0.000152
mossed2012,10,4,3,7,13,0.000052
CallMeMrPeaches,11,2,2,4,13,0.000003
ellathefairy,12,4,3,7,13,0.000003
Calm-Purchase-8044,24,4,2,6,16,0.000039
ImprovementPutrid441,16,1,1,2,17,0
maychoz,10,2,3,5,15,0
Calm_Marsupial3123,25,5,3,8,13,0.00001
Kitastrophe8503,36,13,8,21,12,0.000007
Mrminecrafthimself,16,3,5,8,12,0
ThePhilVv,36,12,13,25,13,0.000055
Candid-Narwhal-3215,23,2,1,3,16,0.000003
SallyKait,11,1,2,3,15,0
coleman57,18,1,1,2,14,0.000021
CandidateNew3518,16,4,7,11,12,0.000085
Most_Finger,12,3,2,5,12,0.000101
Counther,19,1,1,2,15,0
KaliTheBlaze,32,6,6,12,13,0
Low_Armadillo3366,10,1,2,3,14,0
CanoodlingCockatoo,46,7,12,19,11,0.000041
Direct-Bread,10,4,4,8,13,0.000065
OwnEntertainment701,20,3,6,9,12,0.000006
PsychologicalLuck343,10,4,3,7,12,0.000011
TFOLLT,22,2,2,4,12,0.000007
roskybosky,34,5,7,12,12,0.000011
wiseduckling,11,3,0,3,0,0.000006
Major-Platypus2092,21,4,3,7,13,0.000102
raerlynn,10,3,2,5,13,0.000446
redroserequiems,35,5,6,11,13,0.000086
KoldPurchase,13,8,5,13,13,0.002496
tlopez14,20,11,9,20,12,0.009432
Careless_Cicada9123,11,4,2,6,11,0.000481
throwawaytalks25,154,15,12,27,10,0.000319
Mundane-Currency5088,29,3,2,5,11,0.000004
CarmenDeeJay,14,2,4,6,11,0.000022
Fresh_Caramel8148,15,2,0,2,0,0
Objective-Arugula-17,18,5,4,9,12,0.00004
Usrname52,23,7,2,9,12,0
Cazzah,13,7,4,11,13,0.00008
Kithslayer,17,3,3,6,14,0.000048
Prysorra2,11,3,6,9,12,0.00212
CellistOk5452,13,0,1,1,1,0
Accidental_Sage,10,3,0,3,0,0
CerealExprmntz,17,3,2,5,13,0.000139
Certain-Definition51,13,2,3,5,14,0.000008
punta_del_diablo,14,5,4,9,13,0.000095
Stunning-Drawing8240,15,3,4,7,14,0.000003
ChadWestPaints,13,2,4,6,13,0.004408
courtd93,30,6,7,13,12,0.000202
Humble-Progress8295,10,2,4,6,13,0.000009
DevA248,38,11,15,26,12,0.000299
JellyfishSolid2216,18,7,8,15,13,0.00009
Pac_Eddy,13,4,4,8,12,0.000042
SkunkApeForPresident,12,3,4,7,13,0.000009
Charming_Key2313,14,0,1,1,14,0
Charming_Variation76,10,0,3,3,13,0
JeanSchlemaan,12,1,0,1,0,0
pottersquash,120,20,10,30,12,0.000009
wecouldhaveitsogood,11,3,2,5,13,0
CheapEstimate357,10,0,1,1,14,0
CheezeLoueez08,39,4,5,9,12,0
agoldgold,12,6,2,8,13,0
jmking,11,1,2,3,13,0
ladancer22,10,2,3,5,11,0
CherryblockRedWine,17,1,2,3,15,0
OrindaSarnia,24,2,2,4,14,0
meekonesfade,13,1,0,1,0,0
Chinohito,11,3,2,5,13,0.000195
amf_devils_best,13,4,5,9,13,0.000109
Fattydog,18,6,3,9,14,0.000022
Tripsy_mcfallover,24,4,3,7,14,0.000023
hamletswords,18,6,4,10,13,0.000194
Choice-Valuable313,10,2,4,6,15,0.000001
jbarneswilson,12,1,0,1,0,0
kjaiwiz,32,3,0,3,0,0
shiggyhisdiggy,22,4,4,8,14,0.000016
uTop-Artichoke5020,25,2,1,3,16,0
Chronoblivion,14,4,2,6,13,0.000451
CivilMath812,26,5,6,11,11,0.000674
Top-Cupcake4775,26,11,7,18,10,0.00015
efnord,13,4,4,8,13,0.000308
ClaraClassy,22,6,3,9,13,0.000002
Discount_Mithral,20,2,4,6,13,0
Tall-Newt-407,12,1,3,4,14,0
Classic_Bet1942,25,2,6,8,14,0.000003
Jolandersson,13,4,3,7,13,0.000015
Particular_Daikon127,13,2,1,3,15,0.000001
honeybee2894,15,3,1,4,15,0.000023
ta0029271,15,4,4,8,14,0.000001
alyxmorganvo,11,3,1,4,15,0
Lambfudge,10,4,4,8,12,0.000426
DarkSoulCarlos,14,1,1,2,12,0.005955
FredUpWithIt,16,5,5,10,12,0.007852
Gertrude_D,18,9,3,12,12,0.013122
Publius82,16,4,5,9,12,0.010337
ShuukBoy,14,2,1,3,13,0.006219
Statman12,18,6,4,10,12,0.008233
antisocially_awkward,19,7,7,14,11,0.007515
googagingaaaa,11,3,3,6,12,0.006483
rockstar588,10,2,2,4,12,0.006062
whomda,10,3,2,5,12,0.007848
CloudAdditional7394,37,4,6,10,13,0
No-Acanthisitta-2973,15,2,1,3,13,0
NotTravisKelce,21,3,4,7,14,0
SinglePermission9373,29,2,2,4,12,0
Unfair_Finger5531,62,10,11,21,12,0.000004
gahidus,13,2,3,5,14,0
specialkk77,12,3,3,6,14,0.000004
HiddenSage,11,2,3,5,13,0.000179
KingAggressive1498,36,8,11,19,11,0.000315
Meii345,19,7,4,11,12,0.000625
Only____,12,1,2,3,12,0.00002
Coffee-and-puts,12,1,1,2,14,0.00001
Cold-Palpitation-816,12,1,4,5,13,0.000242
CollectionStraight2,12,1,6,7,12,0.000001
constructioncranes,14,5,3,8,13,0.000025
jess_the_werefox,13,2,0,2,0,0.000005
CptHrki,11,3,1,4,14,0.00006
CombAny687,10,1,1,2,13,0.000023
CombinationRough8699,33,3,8,11,13,0.000086
Elias_Beamish,10,4,4,8,13,0.000128
SpaceCowboy1929,19,4,3,7,14,0.000021
Comfortable-Way-8029,18,2,2,4,14,0.000065
Unlikely-Distance-41,14,5,6,11,13,0.000022
Queen-of-meme,11,1,2,3,13,0.000004
zomanda,10,1,1,2,13,0.000024
Competitive_Tale_799,28,2,3,5,13,0.000002
Individual_Ad_9213,14,2,0,2,0,0
MACRS_or_Break,48,5,5,10,12,0.000001
oop_norf,31,5,5,10,12,0.000002
xtra819,26,3,6,9,12,0.001696
Complex-Present3609,10,3,6,9,12,0.000195
ComprehensiveSet927,13,0,1,1,13,0
ComputerChemist,11,3,3,6,13,0.00026
midcen-mod1018,11,1,1,2,15,0
thegeniuswhore,32,5,5,10,13,0
Conscious_Bet_2005,15,1,1,2,1,0
Conscious_Raisin_436,16,2,5,7,12,0.000536
Consistent-Dinner799,11,1,1,2,1,0
Worth-Season3645,46,5,1,6,1,0
Scooney92,13,3,2,5,13,0.000014
knifeyspoony_champ,10,3,4,7,13,0.000042
Content-Valuable-489,16,0,2,2,12,0
ScarletNotThatOne,137,13,4,17,11,0.000006
r_coefficient,13,1,3,4,11,0
Content_Doughnut4590,12,4,4,8,13,0.000116
justeatyourveggies,12,3,2,5,14,0.000009
Coreyporter87,17,0,2,2,13,0
Correct_Cupcake_5493,39,6,3,9,13,0.00045
liquoriceclitoris,11,3,4,7,12,0.00013
Costiony,10,2,2,4,13,0.000002
labcoat_samurai,10,2,2,4,14,0
CouchieWouchie,11,2,2,4,14,0.000019
CoverCharacter8179,11,2,2,4,14,0
Cowabungamon,11,1,1,2,1,0
RoyallyOakie,26,3,0,3,0,0.000003
CracklierKarma9,18,1,2,3,14,0.000001
Ok-Significance2978,28,3,7,10,13,0.000004
chimingbell,12,4,3,7,12,0.00015
TrumpetDuster,14,3,1,4,13,0.000306
Crazyandiloveit,12,4,4,8,11,0.000001
Ok-Calligrapher1345,11,1,1,2,12,0
grammarlysucksass,23,5,4,9,12,0.000028
CreatineAddiction,29,2,2,4,14,0.000005
Jartblacklung,13,1,1,2,15,0.000002
Crepes_for_days3000,13,2,2,4,13,0.000014
InvestigatorOk7015,25,4,3,7,14,0.000013
roguesabre6,10,4,0,4,0,0.000019
CrimsonCartographer,20,3,4,7,13,0.0001
Dapper-Emergency1263,10,1,1,2,14,0.000003
CrimsonKnight_004,10,2,2,4,13,0
Heavy-Top-8540,19,6,7,13,13,0.000009
dachuggs,13,2,1,3,13,0.000003
EntWarwick,10,1,1,2,13,0.000021
Monotonosaurus,12,4,4,8,12,0.000112
morgaine125,17,4,1,5,14,0.000001
Cultural-Budget-8866,13,2,2,4,14,0.000002
Educational-Sundae32,10,2,2,4,13,0
yourlittlebirdie,11,1,1,2,15,0
suitupyo,19,8,3,11,13,0.004657
Cute-Boobie777,11,3,5,8,13,0.000075
CwazyCanuck,10,1,2,3,12,0.0002
Cyber_Guy1988,11,3,5,8,13,0.001182
RevolutionarySpot721,13,2,2,4,13,0.000007
RandomizedNameSystem,13,4,2,6,13,0.000721
superskink,13,2,2,4,13,0.002307
DBFool2019,29,3,6,9,13,0.00002
JDMultralight,18,2,4,6,13,0.000016
Level_Ad9278,39,6,6,12,12,0.000754
DINNERTIME_CUNT,15,0,1,1,13,0
kurrganinterrogator,23,1,2,3,14,0.000001
DJ_Velveteen,11,3,3,6,12,0.000027
No_Bottle7859,17,3,3,6,12,0.000101
henosis-maniac,18,2,3,5,13,0.000046
Magic_Man_Boobs,12,5,4,9,13,0.000184
Front-Finish187,15,3,4,7,13,0.00008
DaEccentric,17,2,2,4,13,0.000034
DarkCrawler_901,15,1,1,2,14,0.000002
Dabalam,11,1,3,4,11,0
amrjs,52,5,5,10,14,0
lihzee,26,11,1,12,15,0
flying87,11,7,6,13,12,0.005122
Dangerous_Prize_4545,12,1,2,3,12,0
DapperDlnosaur,10,5,4,9,14,0.001131
DuckDouble2690,11,3,3,6,14,0.000325
DarkMarxSoul,23,2,2,4,14,0.000001
EchoingSimplicity,17,3,3,6,13,0.000022
sereniteenoww,10,2,2,4,12,0.00003
DarthJarJarJar,19,5,4,9,13,0.00395
DarthRedYoga,36,2,1,3,1,0
Jerseygirl2468,28,1,0,1,0,0
DaveChild,21,2,5,7,12,0.000071
keyboardwari0r69,17,5,10,15,12,0.000529
paultheschmoop,10,4,5,9,13,0.002498
DazzlingFruit7495,38,3,3,6,13,0.00031
DazzlingLanguage5774,42,4,6,10,11,0
JPDL,10,2,3,5,11,0.000001
Katressl,19,5,7,12,11,0.000009
Purple_Wizard,23,6,6,12,13,0.000129
One-Salamander-1952,24,4,5,9,13,0.000049
Pixelology,16,5,6,11,13,0.000416
amitball,13,5,4,9,12,0.000288
bayesian_horse,29,5,9,14,12,0.000068
wtfgrancrestwar,16,3,3,6,13,0.000436
RogueCoon,20,3,4,7,13,0.000188
Dear_Machine_8611,10,0,1,1,13,0
Dear_Solid3470,12,3,4,7,13,0
Impossible_Rain_4727,11,2,0,2,0,0
Mmm_lemon_cakes,15,2,3,5,13,0
OkSecretary1231,15,3,7,10,12,0
YoshKrawdot,11,3,3,6,14,0
Decent_Cheesecake_29,10,4,5,9,12,0.000036
iamwolfe,18,5,1,6,13,0.000072
Decent_Front4647,25,2,2,4,13,0
DecoratedDeerSkull,10,1,1,2,12,0.000002
DefNotARussiaBot,10,2,2,4,13,0.000737
lilelliot,11,2,4,6,13,0.000739
DefiantDistance5844,10,4,4,8,13,0.000174
redhillbones,30,9,14,23,12,0.000172
Delcane,11,1,1,2,14,0.000032
Delicious-Design527,10,2,4,6,13,0.000004
SophiaRaine69420,14,2,5,7,13,0.000014
WaterNerd518,14,3,3,6,12,0.000136
ishtar_the_move,17,3,4,7,12,0.000348
silence9,13,2,2,4,13,0.001411
Landoco,10,7,1,8,13,0.001002
Far_Physics3200,33,2,6,8,12,0
Radish00,14,9,5,14,13,0.000402
Ok-Emu-2881,14,2,2,4,13,0.000455
ZozMercurious,13,3,6,9,12,0.000269
slo1111,14,3,3,6,13,0.001344
Intelligent_Read_697,14,6,6,12,12,0.000218
No_Comfortable_3148,18,7,4,11,12,0.000526
Lopsided_Thing_9474,14,4,3,7,12,0.000033
Weak-Virus2374,12,2,3,5,12,0.000085
DevinTheGrand,13,3,3,6,13,0.000069
Dheorl,17,2,1,3,15,0.000031
Local_Painter_2668,25,3,4,7,14,0.000006
No_Assignment_9721,13,3,3,6,13,0.000091
PleaseDontBanMe82,13,4,2,6,13,0.000099
VivaLaRory,14,3,3,6,13,0.000074
moccasins_hockey_fan,10,4,3,7,13,0.000286
Difficult-Chard9224,11,1,1,2,1,0
Rare-Writer-9635,13,3,3,6,13,0.000061
MaiTaiMule,12,4,4,8,13,0.000188
xfvh,32,8,9,17,12,0.000594
DirectAntique,12,4,2,6,14,0
DisarestaFinisher,11,2,3,5,12,0.000275
Disastrous-Nail-640,23,4,3,7,13,0
IJustWantADragon21,16,4,4,8,13,0.000003
OrthogonalPotato,13,6,3,9,13,0.000021
Relevant_Bed6893,14,2,3,5,13,0.000002
Simple_Pianist4882,31,4,5,9,13,0.000046
citrus_cinnamon,23,3,2,5,14,0
Discussion-is-good,15,1,3,4,12,0.000107
Dismal-Daikon-1091,16,0,1,1,14,0
Distinct-Temp6557,14,5,4,9,13,0.000107
DivorceIncoming123,40,7,3,10,13,0
Jun1p3rsm0m,16,4,4,8,14,0
babjbhba,11,4,4,8,13,0.000001
Dizzy_Needleworker_3,32,2,9,11,13,0
ApprehensiveBook4214,17,1,0,1,0,0
HotSatin,13,2,1,3,14,0
Public-Vegetable-671,12,1,0,1,0,0
Slaator,17,4,3,7,12,0.000002
Specialist_Value_804,12,1,2,3,14,0
Trevena_Ice,25,6,1,7,1,0
DjangoBojangles,10,2,2,4,14,0.000337
piqueboo369,11,4,4,8,13,0.003487
cleverone11,12,2,2,4,13,0.000029
wildfirerain,11,2,2,4,12,0.000245
DogEnthusiast3000,11,1,2,3,15,0
btafd1,16,3,2,5,14,0.00001
sacredblasphemies,14,2,1,3,16,0.000411
DogsOnMyCouches,11,2,1,3,12,0.000375
DonQuigleone,14,2,2,4,12,0.000033
UNisopod,27,6,4,10,13,0.000286
DorsalMorsel,12,6,2,8,12,0.000429
DotCottonCandy,16,8,6,14,13,0.000316
Foyles_War,15,7,7,14,12,0.00036
ManufacturerSea7907,28,5,5,10,12,0.000278
Overton_Glazier,15,6,6,12,12,0.00026
followedbymeteor,16,1,1,2,13,0.000108
MissIncredulous,14,4,4,8,13,0.000113
radialomens,10,2,1,3,12,0.000228
DrWaffle1848,17,2,1,3,1,0.000288
Several_Razzmatazz51,10,4,0,4,0,0.000293
ladylondonderry,12,4,4,8,13,0.000304
Doxjmon,14,2,2,4,13,0.000032
cmecu_grogerian,12,2,3,5,12,0.000148
stiljo24,10,1,2,3,14,0.000007
homurainhell,10,1,4,5,13,0.000118
Violet_Perdition,11,2,1,3,1,0.000149
urnever2old2change,29,8,8,16,13,0.003319
JCMGamer,17,6,6,12,12,0.000414
DragonSeaFruit,11,1,1,2,13,0
ThisWillAgeWell,50,6,4,10,12,0
DragonWyrd316,26,2,3,5,15,0
Fearless_Spring5611,26,5,1,6,15,0
No_Conversation_5661,19,3,2,5,14,0
kawaeri,12,3,3,6,14,0.000002
Dragonmancer76,11,2,2,4,14,0.000001
nvveteran,12,1,1,2,15,0
Particular_Solid9008,11,4,5,9,12,0.000284
DrunkAlbatross,12,1,1,2,13,0.000083
Manaliv3,21,3,6,9,14,0.000064
pedrito_elcabra,12,2,4,6,13,0.000098
Dry_Prompt3182,10,0,1,1,1,0
Dukklings,38,3,3,6,12,0
LupineVenom,16,2,2,4,13,0
Dull_Banana1377,18,1,2,3,13,0
LouisV25,11,4,4,8,14,0
WabbitCZEN,12,3,5,8,12,0
PopIntelligent9515,18,11,12,23,12,0.000498
GoldH2O,21,3,6,9,12,0.000001
EDRootsMusic,22,4,5,9,12,0.000389
EVOSexyBeast,10,4,3,7,13,0.000472
Life_Repeat310,13,2,2,4,13,0.00001
TheGhostofJoeGibbs,16,7,5,12,13,0.000195
communist_slut42,10,1,1,2,14,0.000001
Economy-Emu-4689,17,1,1,2,13,0
pikminlover20,15,6,4,10,12,0
elocin1985,11,4,3,7,12,0.000059
midorikuma42,12,3,5,8,13,0.00026
Gygsqt,34,9,11,20,13,0.000553
emp-sup-bry,22,6,5,11,13,0.001811
haterofslimes,18,2,4,6,13,0.000045
ishmaellius,10,2,2,4,13,0.000084
Educational-Pop-3351,19,0,1,1,13,0
Effective-Birthday57,16,3,1,4,11,0.00001
EggOkNow,17,4,5,9,12,0.000004
ModernZombies,11,6,2,8,13,0.000011
MzSea,18,4,5,9,13,0.000001
Stucklikegluetomyfry,14,2,4,6,11,0
iOawe,10,3,3,6,13,0
spid3rham90,34,5,5,10,14,0.000001
SpecificPay985,20,6,3,9,12,0.000204
k2svpete,26,3,2,5,15,0.000208
ElEsDi_25,26,4,4,8,13,0.000063
When_hop,10,2,0,2,0,0.000033
Eldriscp,12,5,4,9,12,0.000202
raptor-chan,14,4,5,9,11,0.000227
saltedmangos,13,4,5,9,12,0.000939
SlurpingDischarge,59,10,8,18,13,0.000291
EmceeSuzy,47,10,6,16,12,0.000002
Fickle-Cabinet3956,18,3,4,7,13,0
Gingerpyscho94,10,2,2,4,12,0.000002
flowerybutterfly96,24,1,0,1,0,0
allhailthehale,11,1,4,5,13,0.000105
Kibbles-N-Titss,20,1,1,2,14,0.000009
EmployAltruistic647,10,1,2,3,13,0.000027
Yntol,12,5,5,10,13,0.000359
Engine_Sweet,11,3,3,6,12,0.000026
Enki4n,12,2,2,4,12,0.000347
EonPeregrine,11,3,3,6,13,0.000627
Equal-Ad3814,13,0,1,1,14,0
EquipmentSpecific262,24,1,2,3,12,0.000001
Rozenheg,12,1,2,3,13,0.000003
Lenyngrad,29,5,4,9,13,0.000109
Equivalent_Length719,31,3,3,6,14,0.000001
Firestorm42222,21,2,2,4,14,0.000003
Key_Zucchini9764,15,1,1,2,15,0
chickadee_1,15,6,4,10,13,0.00028
vht3036imo,24,6,6,12,13,0.000433
EruDesu90,12,1,1,2,1,0
GrapefruitNo9284,12,3,1,4,1,0
EssayFunny1670,12,1,1,2,12,0
mightymite88,24,5,6,11,13,0.000253
FluffyB12,16,3,5,8,12,0.000225
Ok_Objective8366,14,1,0,1,0,0
ShipComprehensive543,14,3,1,4,13,0.000001
Expensive_Yam_2222,25,3,3,6,13,0
SykesLightning,14,1,1,2,14,0
Individual_Umpire969,11,2,2,4,13,0
Extension-Issue3560,16,3,1,4,15,0
Temporary-Stay-8436,26,6,5,11,12,0.000229
Extreme_Sector_6689,13,3,2,5,14,0
opelan,26,2,3,5,13,0
Eyesofmalice,14,3,4,7,13,0.000128
bfwolf1,48,7,9,16,12,0.000168
FL_Duff,12,2,3,5,12,0.000004
RennietheAquarian,27,4,5,9,12,0.000004
PrecisionHat,24,8,8,16,13,0.000463
ToLiveInIt,11,2,4,6,13,0.002637
FairyCompetent,32,1,3,4,12,0
Witty-Draw-3803,14,2,1,3,13,0.000001
LordGerdz,13,6,4,10,13,0.000968
False-Fall-6995,13,1,1,2,13,0
Falsequivalence,11,3,2,5,12,0.000324
Famous-Ad-9467,12,4,3,7,14,0.000006
imperfect9119,21,3,0,3,0,0.000013
Fancy_Introduction60,16,0,1,1,15,0
Traditional-Bag-4508,14,1,1,2,14,0
StargazerRex,27,2,6,8,13,0.00001
ThrowRACoping,39,6,5,11,13,0.000012
Waterworld1880,19,3,6,9,12,0.000108
JaySpunPDX,10,2,2,4,15,0.000002
sir_mrej,33,5,4,9,13,0.000194
username_redacted,10,4,1,5,14,0.000281
Faust_8,10,1,1,2,15,0.000004
_ParadigmShift,16,2,3,5,13,0.000034
thesestormyseas,10,1,2,3,13,0.000032
Feeling-Visit1472,14,0,2,2,13,0
OLAZ3000,12,1,1,2,1,0
StuffedSquash,11,1,3,4,12,0
FemBoyGod,20,1,3,4,13,0.000004
Grish__,19,1,3,4,13,0.000039
Important_Suspect681,16,5,7,12,13,0.000508
Riceowls29,38,3,4,7,12,0.000083
luckyhunterdude,12,1,1,2,14,0.000003
SteelLt78,12,1,2,3,14,0
TheCowboyIsAnIndian,11,1,2,3,14,0.000196
Ulthanon,10,2,2,4,14,0.000196
Final7C,15,4,3,7,13,0.000002
Interesting-Pea-1714,22,1,3,4,12,0
Superdudeo,11,2,2,4,14,0
redditsuckspokey1,11,1,1,2,14,0
Ostlund_and_Sciamma,10,1,3,4,13,0.000175
burz,15,4,4,8,12,0.000257
Financial_Bowl9440,10,2,1,3,14,0
i_was_a_person_once,24,5,6,11,13,0
Fine-Sherbert-140,12,2,1,3,1,0.000007
Fine_Road_3280,14,0,1,1,16,0
Meghanshadow,10,1,1,2,15,0
First-Industry4762,10,1,2,3,13,0.000002
Fit-Act2056,11,2,2,4,13,0.000008
Wayfarer285,17,3,3,6,12,0.000048
thebottomblocks,22,4,3,7,13,0.000055
unitedshoes,20,4,9,13,12,0.000013
Flapjack_Ace,11,2,2,4,11,0.00181
ary31415,12,3,3,6,13,0.001789
noah7233,19,6,5,11,13,0.001839
Flashy-Lunch-936,17,1,4,5,12,0.000049
Fleeting_Dopamine,22,3,3,6,13,0.000121
QR4201,21,6,6,12,12,0.000138
Shot-Vacation2469,24,6,10,16,12,0.000219
paadugajala,12,3,3,6,12,0.001321
FrangipaniMan,10,1,2,3,13,0.000009
Foofieness,16,0,1,1,16,0
ravenHR,11,1,1,2,13,0.000013
Signal_Ad_7959,12,2,2,4,13,0.000001
Ready-Recognition519,14,4,4,8,11,0.000538
sailorbrendan,13,3,2,5,13,0.000361
Foxlikebox,11,1,1,2,13,0.000001
Fragrant-Banana-2695,13,0,1,1,14,0
FragrantPiano9334,17,2,4,6,13,0.000008
Free_Storage_1088,13,1,3,4,14,0
OriginalSchmidt1,13,3,3,6,13,0
roseofjuly,20,6,9,15,13,0.000009
Top-Bootylover,13,3,3,6,12,0.000081
Womblue,10,3,3,6,13,0.000179
settleslugger,12,1,1,2,13,0.000088
Glitchy_XCI,28,5,8,13,13,0.00036
Thoughtful_Ocelot,14,2,6,8,12,0.000198
dbandroid,14,5,4,9,13,0.000251
mangongo,24,4,5,9,13,0.000257
Fumbles329,13,1,1,2,13,0
Fun-Holiday9016,11,0,1,1,13,0
Rosevkiet,15,7,2,9,12,0.000287
The_FriendliestGiant,13,4,2,6,13,0.000449
Galious,18,2,2,4,12,0.000132
Striking_Computer834,10,1,1,2,14,0
bigdograllyround,14,3,3,6,13,0.000042
throwawayaway388,12,4,3,7,13,0.000106
Kenichi2233,23,7,3,10,13,0.000133
ferbje,33,4,8,12,12,0.000199
Gauntlets28,13,2,4,6,13,0.000001
PomegranateBasic3671,12,1,1,2,14,0.000007
housearachna,24,5,4,9,13,0.00002
GeneConscious5484,14,2,2,4,14,0.000007
GeorgeHarris419,12,1,2,3,13,0
Icy_Raspberry5456,15,1,3,4,13,0
OtherMarciano,17,1,1,2,13,0.000022
QuesoStain2,13,7,4,11,13,0.001368
MithosYggdrasill1992,57,1,11,12,11,0
mark_ik,24,4,4,8,13,0.000125
PromptStock5332,16,4,5,9,13,0.000121
GoNads1979,11,1,1,2,13,0.00007
GodMan7777,45,3,3,6,13,0.000003
Inevitable_Bit_9871,14,3,3,6,13,0.000046
No_Emphasis4360,13,1,1,2,14,0
GodkingAustin,14,1,4,5,13,0.000002
GodtheBartender,15,6,8,14,12,0.000066
Safe-Intern2407,14,2,2,4,13,0.000003
Zipz,11,2,2,4,13,0.000002
thedorknightreturns,26,7,11,18,12,0.000083
yawannauwanna,14,3,2,5,14,0.000004
OmniTalentedArtist,13,2,2,4,13,0.000165
aguruki,21,3,5,8,13,0.000126
GoingAllTheJay,10,1,1,2,13,0
Kosmopolite,19,3,2,5,13,0.000234
dullaveragejoe,13,4,1,5,16,0.00001
bigboobswhatchile,10,5,5,10,12,0.000451
GoldenLiar2,12,3,4,7,13,0.000056
Goldreaver,12,0,1,1,13,0
Curious_Eggplant6296,15,2,0,2,0,0
PiersPlays,13,2,3,5,13,0.00001
Spite-Organic,14,2,5,7,13,0.000015
biteme4711,12,6,3,9,13,0.000288
panna__cotta,34,7,5,12,12,0.000454
LSATDan,11,2,2,4,13,0.000066
MrPoopMonster,12,3,5,8,12,0.000112
Individual_Row_2950,20,1,2,3,14,0.000008
Green-Dragon-14,11,2,1,3,1,0
Street-Length9871,16,1,1,2,1,0
GroundbreakingAd6354,13,2,2,4,12,0.0002
Tristan_Gabranth,16,2,2,4,13,0.000007
GroundbreakingBag164,12,3,4,7,13,0.000076
Grymflyk,11,1,1,2,12,0.000078
SartorialDragon,38,1,6,7,11,0
MelissaMiranti,24,4,6,10,12,0.000101
GunMuratIlban,14,1,1,2,14,0.000001
The_Zacain,21,2,2,4,13,0.000019
NotGalenNorAnsel,12,4,3,7,12,0.000192
abetterlogin,26,4,2,6,1,0.000084
The-Nice-Writer,10,2,2,4,12,0.000448
Hairy-Dream4685,19,1,1,2,12,0
Sorry_I_Guess,43,2,4,6,11,0
neurointervention,27,5,5,10,13,0.000635
HallowedGardens,10,1,1,2,14,0
Self-Aware,10,1,2,3,13,0
HammerOn57,28,1,1,2,13,0
Hamuel,12,4,4,8,13,0.000237
Prepared_Noob,12,3,3,6,13,0.000102
TintedApostle,12,2,3,5,14,0.001113
frederick_the_duck,12,3,3,6,12,0.000263
WrongCase7532,35,2,8,10,11,0.000007
Hautamaki,10,5,5,10,12,0.009875
JoeSavinaBotero,14,4,2,6,12,0.005628
HazelCheese,16,3,3,6,13,0.001118
Hazeygazey,17,1,1,2,16,0.000001
Wild-Spare4672,11,2,2,4,15,0.000001
Lpunit,10,5,4,9,13,0.000173
Healthy_Brain5354,20,2,3,5,12,0
MrBlizter,29,4,4,8,12,0
Twig-Hahn,13,1,3,4,13,0
jugglinggoth,15,2,2,4,11,0
Iricliphan,14,3,2,5,14,0.00002
Worldly-Confusion759,11,3,2,5,14,0.000019
Helen_A_Handbasket,10,3,3,6,13,0
milly_moonstoned,12,4,3,7,14,0
Ok-Recipe5434,11,3,4,7,13,0.000076
ta_mataia,32,4,6,10,11,0.000391
HendriXP88,14,2,5,7,12,0.000005
Hey-Just-Saying,14,2,2,4,13,0
Kathrynlena,17,2,1,3,14,0
crocodile_in_pants,10,2,2,4,13,0.000014
HiddenRouge1,10,2,2,4,14,0.000394
Tall-Professional130,22,4,7,11,12,0.00034
Hostilis_,10,1,1,2,1,0
Kaaji1359,10,2,1,3,1,0.000002
PearlStBlues,21,2,1,3,13,0
Hugo28Boss,11,5,4,9,12,0.000611
Hour_Smile_9263,31,4,8,12,11,0.000011
whorl-,15,4,2,6,11,0.00001
LordVericrat,10,5,4,9,13,0.000032
theroha,29,4,2,6,14,0.000069
IDVDI,14,4,7,11,13,0.000114
The_Amazing_Emu,20,4,4,8,12,0.000072
IHaveBoxerDogs,10,1,1,2,1,0
ToldU2UrFace,13,1,1,2,1,0
Objective_Air8976,25,2,0,2,0,0
IanArcad,11,1,3,4,13,0.000036
IceCreamBalloons,13,2,3,5,13,0.000006
Randy_Watson,12,1,2,3,13,0.000689
IchiroTheCat,11,0,2,2,12,0
Top-Entertainer2546,17,2,0,2,0,0
WVPrepper,13,1,0,1,0,0
xhevnobski,30,3,3,6,12,0.00018
upfastcurier,10,1,2,3,13,0.000173
IgnoranceIsShameful,19,1,1,2,13,0.000001
trthorson,11,6,3,9,14,0.000051
ValitoryBank,12,2,5,7,12,0.000613
wedgebert,16,3,5,8,12,0.003231
IllIlIlIlIlIll,11,1,1,2,13,0.000076
Ill_Industry6452,11,0,1,1,1,0
Wild_Ticket1413,10,1,0,1,0,0
RsonW,12,4,3,7,13,0.000106
Suspicious_Tank_61,12,3,3,6,13,0.000105
AbFab-alicious,14,1,0,1,0,0
MostlyGhostlyPost,10,1,1,2,13,0.000329
kenzieisonline,10,1,2,3,12,0.000329
ashmortar,15,9,6,15,13,0.000374
Vegtam1297,13,4,3,7,14,0.000079
ImportantOnion9937,21,3,3,6,12,0
Nymph-the-scribe,12,3,4,7,12,0
JustACWrath,10,5,3,8,14,0.000263
land_and_air,14,2,2,4,13,0.000024
Impossible-Cod-323,15,1,2,3,13,0.000031
smol9749been,16,5,5,10,11,0.000036
baklazhan,10,1,1,2,15,0.000001
Impressive_Design177,15,1,1,2,1,0
Snoo_90208,10,1,1,2,1,0
In_A_Spiral,18,2,2,4,13,0
PetiteDreamerGirl,11,1,2,3,14,0.000023
Troysmith1,10,2,3,5,13,0.000481
Inevitable_Entry6518,14,0,1,1,15,0
Infamous-Purple-3131,15,0,2,2,13,0
Mother_Welder_5272,14,3,2,5,14,0.000299
InnerBlacksmith1208,12,3,2,5,2,0
drewmana,11,1,1,2,3,0
slackerchic,21,4,2,6,2,0.000026
Interesting-Shame9,15,1,1,2,13,0.000024
Successful-Silver485,14,2,3,5,13,0.000018
Mental-Combination26,15,6,4,10,12,0.000476
Otherwise-Win7337,14,2,3,5,12,0.000351
Interesting_Team5871,12,0,1,1,1,0
1962Michael,36,2,0,2,0,0
Internal-Giraffe-124,10,2,2,4,14,0
BerneDoodleLover24,12,1,0,1,0,0
Otherwise-Tie-7459,19,2,7,9,12,0.000019
Jawyp,17,3,4,7,13,0.001814
InterstitialDefect,15,1,2,3,1,0
improbsable,11,2,0,2,0,0.00003
IntolerantModerate,11,3,3,6,13,0.000061
redknit,13,1,1,2,14,0.000006
Xepherya,10,5,4,9,13,0.00022
NoInsurance8250,17,4,4,8,12,0.00028
Only_Raccoon9397,18,3,3,6,13,0.000028
JAMONLEE,32,4,6,10,13,0.000373
Purple_Feedback_1683,18,2,2,4,13,0.000026
gittlebass,10,1,1,2,14,0.000019
JC_Hysteria,14,0,1,1,13,0
JacobStills,10,0,4,4,13,0
savingforresearch,19,1,2,3,13,0.000012
Jalphorion1,15,3,3,6,14,0.000463
Top-Profile-4570,14,3,4,7,13,0.000458
totally-hoomon,10,1,4,5,13,0.000001
JamSkully,12,3,3,6,13,0.000003
PreparationAdvanced9,13,5,5,10,13,0.004107
RedPandaReturns,10,4,4,8,14,0.000076
itsacalamity,17,4,2,6,15,0.000159
Jealous-Contract7426,29,1,2,3,12,0
Sad-Country-9873,22,3,3,6,11,0
TalkToHoro,26,3,2,5,12,0
lebannax,10,1,3,4,13,0.000004
Jesssica_Rabbi,27,1,1,2,15,0
Jlchevz,13,0,1,1,14,0
No_Effort5896,11,1,2,3,14,0.000028
JohnCalvinSmith,10,1,1,2,13,0
Johnclark38,10,1,1,2,14,0.000024
shivux,25,3,3,6,13,0.000063
JonnyRobertR,32,1,1,2,14,0.000004
Salazarsims,27,2,2,4,13,0.000012
JorgiEagle,10,0,1,1,1,0
chickpeahummus,11,3,0,3,0,0.000006
mattyoclock,27,8,12,20,11,0.00045
MountainHigh31,16,8,4,12,12,0.000464
Remote_Difference210,11,2,1,3,15,0
PenImpossible874,27,4,9,13,13,0.004812
s-b-mac,18,2,3,5,13,0.000006
JunktownRoller,29,1,3,4,13,0.000017
JustSomeCells,17,2,3,5,13,0.000061
Thin-Image2363,11,1,6,7,12,0.000089
KCarriere,14,2,4,6,13,0.000078
Kadajko,10,1,1,2,15,0.000003
Kaisha001,11,2,2,4,13,0.000039
Rude_Technician4821,10,1,1,2,14,0.000003
The_White_Ram,16,2,2,4,13,0.000153
Knight0fdragon,21,2,2,4,12,0
PurpleWeasel,15,2,1,3,14,0
W0nderingMe,22,1,2,3,13,0
Kami_Sang,30,4,4,8,12,0
Needs_Perspective269,17,1,0,1,0,0
MysteriousFootball78,10,4,0,4,0,0.000058
Key-Loquat6595,11,3,2,5,12,0.017749
Key-Philosopher-2788,13,3,3,6,13,0.000124
Key-Pickle5609,12,0,2,2,13,0
Nodaker1,13,5,3,8,13,0.000475
Key_Ingenuity_4444,11,1,1,2,13,0.000076
Kikikididi,15,1,4,5,12,0
teenageIbibioboy,10,1,1,2,13,0.000023
KimB-booksncats-11,36,0,1,1,1,0
Dittoheadforever,27,3,0,3,0,0.000047
Smart-Status2608,25,4,5,9,12,0.000024
favorable_vampire,18,4,6,10,12,0.000022
TheGreatBenjie,12,1,2,3,13,0.000045
sheds_and_shelters,15,2,2,4,12,0.000062
Kingnimrod212,11,0,3,3,13,0
Odd-Spirit9829,10,2,3,5,13,0.000036
Upstairs-Teach-5744,14,1,2,3,14,0.000027
Klutzy_Property83,14,0,1,1,15,0
Klutzy_Routine_9823,13,3,2,5,13,0.000039
Least_Key1594,13,2,3,5,13,0.000041
elderly_millenial,14,7,7,14,13,0.00174
Kotor-Knowledge-7964,22,5,3,8,13,0.000145
Revolutionary-Copy97,10,1,1,2,14,0.000004
chicfromcanada,11,1,1,2,14,0.000007
Kurati-sa-Kariba,12,1,1,2,14,0.000004
KyleDutcher,18,2,2,4,13,0.001152
LILwhut,13,0,1,1,13,0
ReadLocke2ndTreatise,30,6,6,12,13,0.00021
ShadesOfTheDead,11,4,4,8,13,0.000555
vvalkyri3,10,3,3,6,13,0.000191
turtleduck,23,4,3,7,13,0.000049
Not_Yet_Italian_1990,19,2,6,8,12,0.000343
edwardludd,14,4,3,7,12,0.004853
LdiJ46,15,5,2,7,15,0.00003
j0179664,12,2,2,4,14,0
LetterheadBubbly6540,19,1,1,2,14,0
Letters_from_summer,15,2,1,3,13,0
lemon_charlie,38,5,6,11,12,0
Level_Amphibian_6249,10,1,2,3,2,0
lycrashampoo,21,4,1,5,1,0
LottieOD,11,1,1,2,13,0
MissionYam3,12,2,1,3,13,0
MortgageMiserable307,15,3,4,7,13,0
OkManufacturer767,36,1,2,3,13,0
kittywyeth,17,2,4,6,12,0
LivingLikeACat33,12,1,4,5,12,0.000006
bizarre_coincidence,14,4,5,9,13,0.00004
zookeepier,16,4,5,9,13,0.000072
indoorsy-exemplified,12,2,3,5,13,0.000004
squigs,13,3,2,5,11,0
terrika_has_spoken,20,2,1,3,13,0
thisisstupid0099,16,1,3,4,13,0
Local-Hornet-3057,12,1,3,4,13,0.00002
jackparadise1,10,1,0,1,0,0
Longjumping-Plant617,13,1,1,2,14,0.000001
kozak65,15,2,3,5,13,0.000004
TheRemanence,14,2,4,6,13,0.000011
MaybePrudent3877,15,4,2,6,12,0.000064
Loud_Ad_9187,14,0,1,1,12,0
wickybasket,10,2,1,3,15,0
Low-Box9924,13,0,1,1,14,0
rjtnrva,18,5,6,11,13,0.00027
ladiesPlusLlc,12,2,5,7,12,0.000066
Lows-andHighs,14,0,3,3,14,0
PreviousPin597,25,1,0,1,0,0
tf2coconut,11,3,3,6,12,0.000313
Siukslinis_acc,16,2,3,5,13,0.000088
enterthewoods1,20,2,2,4,14,0.000067
No-Assistant-1948,19,2,3,5,13,0
MS-07B-3,11,1,2,3,13,0.000003
MacaroonSad8860,12,1,3,4,11,0.000002
automaks,11,1,1,2,14,0.000009
unbelizeable1,30,6,9,15,11,0.000043
ZhopaRazzi,16,3,2,5,12,0.001118
cptn9toes,13,1,1,2,14,0.000006
octocatty,42,2,2,4,13,0.000072
MaleficentPizza5444,22,1,2,3,13,0
Queen_Sized_Beauty,10,2,2,4,12,0
MalekithofAngmar,14,1,2,3,14,0.000004
Toppoppler,20,3,4,7,13,0.000045
creamsodapoo,18,3,1,4,14,0
mikadouglas1,13,4,1,5,13,0.003106
Mandrake_Cal,16,0,1,1,14,0
MarionberryPlus8474,14,1,1,2,13,0.000028
TheDesertShark,11,2,2,4,14,0.000045
Maschamari,11,0,1,1,1,0
Shepathustra,13,1,3,4,13,0.000002
real-bebsi,24,5,6,11,12,0.000047
jimmyxtang,17,5,4,9,12,0.000065
Meddling-Kat,16,1,1,2,1,0
ninjatahu,24,1,1,2,1,0
Vredddff,13,2,3,5,13,0.000016
MediocreSizedDan,13,2,4,6,13,0.000101
Square-Bite1355,13,2,4,6,13,0.000046
Melanie-1431,12,0,1,1,13,0
giraloco,11,5,3,8,13,0.000155
MezzoFortePianissimo,14,1,6,7,13,0.002121
MidwestNormal,25,0,2,2,2,0
MikeLinPA,14,3,4,7,12,0.000427
MindFreedom1978,13,1,1,2,14,0.000002
anondaddio,26,3,3,6,13,0.000016
MisterRound,12,1,1,2,14,0.000002
Mistybrit,13,3,5,8,12,0.000082
silverpixie2435,27,4,6,10,13,0.000056
VordovKolnir,35,3,2,5,13,0.000002
perplexedtv,10,3,4,7,13,0.000002
goddessofspite,12,1,0,1,0,0
PalmTreePhilosophy,17,1,4,5,13,0.000002
ToddlerOlympian,15,1,3,4,15,0.000002
_Dingaloo,11,1,1,2,15,0.000002
Money-Possibility606,13,2,2,4,16,0
LookAwayPlease510,10,1,0,1,0,0
WholeAd2742,27,1,0,1,0,0
pinkpink0430,17,1,3,4,13,0
Virtual_Technology_9,21,3,4,7,12,0.000455
Wattabadmon,16,2,3,5,12,0.000312
girldrinksgasoline,19,5,11,16,12,0.000227
Puzzleheaded-Face181,11,1,1,2,13,0
MrE134,11,3,3,6,13,0.000984
PushThePig28,11,3,2,5,13,0.00001
MrsDoylesTeabags,10,1,1,2,15,0.000003
NeedForSpeed98,11,3,2,5,12,0.000098
Mundane-Mud2509,22,5,5,10,13,0.000098
TemporaryThink9300,12,1,1,2,14,0.000002
Raephstel,32,4,4,8,13,0.000093
kiwipixi42,33,2,7,9,12,0.000819
MysteriousDig4656,33,1,2,3,13,0
Throat_Ancient,11,2,3,5,13,0.000057
MystifiedByPeople,22,0,5,5,13,0
TheTurtleShepard,15,5,4,9,14,0.000003
rb-j,16,2,5,7,13,0.001539
answer_giver78,16,3,4,7,13,0.000175
NSlearning2,11,1,2,3,13,0.000007
NYDancer4444,15,1,2,3,13,0
pieville31313,13,1,1,2,14,0
Neat-Ostrich7135,20,0,2,2,13,0
thechaoticstorm,27,4,1,5,12,0
thatvampigoddess,10,2,2,4,12,0.000009
Neither_Charity_2779,10,1,4,5,12,0.000001
TheBeardedDuck,22,5,5,10,13,0.000042
Nervous-History8631,12,0,1,1,14,0
Ninja333pirate,10,2,3,5,11,0.000021
No-Assignment5538,53,5,5,10,12,0
No-College4662,22,2,1,3,1,0
PeachBanana8,16,1,1,2,14,0
definitelynotjava,15,2,4,6,13,0
oliviamrow,13,2,1,3,1,0.000004
No-Theme4449,11,1,2,3,13,0.000003
ComprehensiveBand586,19,1,0,1,0,0
Queasy_Artist6891,14,3,3,6,12,0.000247
No-Potential-7242,30,2,1,3,12,0
stroppo,10,2,2,4,11,0
No-Relation5965,11,3,3,6,13,0.000642
No-stradumbass,19,3,5,8,13,0.000177
No_Airport2112,10,1,3,4,13,0.000068
point_of_you,10,1,1,2,13,0.000004
No_Macaroon_9752,10,2,4,6,13,0.000191
No_Neighborhood_632,16,1,1,2,17,0
meeps1142,11,1,2,3,16,0
NobodyKillsCatLady,20,1,0,1,0,0
Uubilicious_The_Wise,34,5,4,9,12,0
space_force_majeure,11,2,2,4,13,0.000088
Several-Adeptness-83,27,2,2,4,14,0
Sugah-Mama,14,1,1,2,15,0
walkinwater,31,1,3,4,11,0
Novel_Surprise_7318,22,1,1,2,14,0
TriggerWarning12345,11,1,2,3,13,0
NtsParadize,11,0,2,2,12,0
NuYawker,18,1,1,2,14,0.000055
RevolutionaryYam2147,14,2,1,3,13,0
ScaryButterscotch474,41,3,3,6,13,0
OG-Brian,14,1,1,2,17,0
Environmental_Art591,11,3,0,3,0,0
ravia,14,1,0,1,0,0
rosegoldblonde,10,1,2,3,13,0
tosser9212,19,1,3,4,12,0
OneEye3360,10,3,4,7,12,0.000295
Obvious-Arrival2571,15,0,1,1,1,0
ViolaVetch75,28,1,0,1,0,0
Wonderlostdownrhole,13,1,1,2,14,0
Ok-Acanthaceae5744,11,1,3,4,13,0.000003
PrivilegeCheckmate,28,1,3,4,14,0.000004
Ok-Debate3920,13,1,2,3,13,0.001159
Ok-Presentation-2068,13,2,1,3,1,0
ike7177,17,2,1,3,1,0
Ok-Raspberry7884,11,3,3,6,12,0.000001
iilinga,11,2,2,4,16,0
Ok-Simple5493,27,1,2,3,15,0
OkGazelle5400,10,0,1,1,13,0
shelwood46,37,1,5,6,12,0
trollcitybandit,17,2,2,4,14,0.000211
Old-Pear9539,10,3,3,6,13,0.00044
Sammy4152015,14,2,2,4,13,0.000033
On_my_last_spoon,10,2,1,3,14,0
khizar4,15,1,2,3,13,0.000017
OrdinaryWords,12,0,3,3,12,0
hiddenkobolds,10,4,0,4,0,0.000004
Organic_Start_420,31,3,3,6,12,0
ScopeIsDope,11,2,2,4,13,0
Psychonaut1008,14,1,2,3,14,0
gifhyatt,11,1,1,2,14,0
reddituserperson1122,19,1,1,2,13,0.000006
apophis-pegasus,12,3,2,5,13,0.000035
OwlCaptainCosmic,10,1,1,2,2,0
Raptor_197,13,1,2,3,1,0
QueueOfPancakes,18,3,2,5,13,0.000024
diminishingpatience,17,1,0,1,0,0
epichuntarz,18,1,4,5,12,0
SeeRecursion,20,2,2,4,13,0.000343
Pascale73,13,0,2,2,11,0
munche,23,5,3,8,12,0.000715
Peefersteefers,11,1,3,4,13,0.000014
PeelingMirthday,12,3,1,4,13,0
PerAsperaDaAstra,19,2,2,4,13,0.000081
PerfectReflection155,11,2,1,3,13,0.000056
Persis-,17,1,2,3,13,0.000014
Playful-Trip-2640,13,6,6,12,12,0.000406
Phanes7,11,2,2,4,13,0.000137
testtest867,12,2,1,3,13,0.00002
Phyltre,11,3,4,7,13,0.00004
notafuckinmarine,11,2,2,4,14,0.000062
Supernova-Max,39,1,2,3,12,0
Accomplished-Park480,11,2,0,2,0,0.000025
PinkNGreenFluoride,21,0,1,1,1,0
Snarky75,10,4,0,4,0,0
PinkPandaHumor,17,0,3,3,13,0
Twenty_twenty4,17,2,4,6,13,0.000043
Pkfrompa,11,0,1,1,1,0
WiseDeparture9530,13,1,0,1,0,0
PlasticLab3306,33,0,4,4,13,0
Ploutophile,12,2,5,7,12,0.0001
Plus_Ad_9181,30,0,1,1,14,0
ilGeno,17,2,3,5,12,0.001533
THExLASTxDON,15,6,5,11,13,0.005877
PoolQueasy7388,22,2,3,5,14,0.000001
RWBYsnow,14,1,0,1,0,0
PotentialDig7527,11,0,1,1,1,0
Constant_Host_3212,19,1,0,1,0,0
tnrdmn,11,1,1,2,13,0.000153
dalekrule,13,2,1,3,15,0.000145
PrinceArchie,11,2,3,5,11,0.000008
Deep-Okra1461,89,2,0,2,0,0
Pristine_Volume4533,17,1,1,2,1,0
SavingsRhubarb8746,12,2,0,2,0,0.000026
ProofJournalist,20,1,1,2,15,0.000003
PublikSkoolGradU8,13,1,1,2,15,0.000005
Puzzleheaded-Ad7606,16,0,1,1,15,0
PuzzleheadedTrash131,22,2,4,6,12,0.000201
Radiant_Gene1077,17,1,1,2,15,0
RainfallsHere,19,3,3,6,13,0
RequestSingularity,18,2,4,6,14,0.000008
uttersolitude,10,2,2,4,13,0
RaleighTS,24,0,1,1,16,0
RammsteinFunstein,17,1,2,3,12,0
SnooChipmunks770,40,2,3,5,13,0.000003
Random_Association97,13,0,1,1,14,0
RazzmatazzOk2129,15,0,1,1,13,0
Zeydon,11,1,1,2,14,0.000008
Realistic_Mud_4185,13,1,3,4,13,0
Recent_Nebula_9772,22,0,1,1,15,0
zealot_ratio,17,1,1,2,15,0.000002
RespondCharacter6633,21,2,2,4,13,0.000002
freakydeku,10,1,3,4,12,0
reactorfuel,27,2,2,4,14,0
Responsible_Rich_284,12,1,1,2,12,0
UnfttrrdMlvlnc,10,1,3,4,13,0.000027
apri08101989,12,2,3,5,13,0.000184
sh1tpost1nsh1t,11,2,1,3,13,0.000067
splurtgorgle,19,5,6,11,13,0.000089
StockAdeptness9452,13,2,2,4,13,0.000294
michaelas10sk8,14,3,4,7,13,0.000036
k_princess,11,1,1,2,15,0.000003
Rotten_gemini,17,0,1,1,1,0
RumRunnerMax,15,1,2,3,13,0.00109
Sad-Paramedic-8523,26,4,5,9,13,0.000265
Spiel_Foss,19,1,5,6,13,0.000954
Samanthacino,12,2,2,4,13,0.00003
xXdontshootmeXx,11,1,1,2,14,0.000048
Whole_Database_3904,10,3,2,5,15,0
sirthunksalot,13,4,3,7,14,0.000022
angelerulastiel,11,1,2,3,14,0
olderguy6432,22,1,0,1,0,0
Scenarioing,16,0,4,4,12,0
BlondDee1970,26,1,0,1,0,0
SceneNational6303,10,0,2,2,13,0
Sea-Nerve-8773,10,0,2,2,13,0
ServelanDarrow,62,0,2,2,13,0
Individual_Metal_983,12,1,0,1,0,0
ServiceDragon,11,1,1,2,15,0
joe_s1171,13,1,2,3,13,0
Viola-Swamp,10,2,3,5,11,0
captainwhatserface_5,13,4,3,7,13,0
SheWhoLovesSilence,12,3,3,6,13,0.00004
damo1112,19,3,5,8,13,0.000033
SunshineThunder101,14,2,2,4,12,0.000214
SigSauerPower320,14,0,2,2,12,0
Slight-Improvement84,15,2,2,4,14,0.000036
Significant-Berry-95,11,0,1,1,12,0
SoMuchMoreEagle,11,3,2,5,15,0
Simon-Says69,15,0,4,4,12,0
Single_Cancel_4873,10,1,1,2,15,0
Skull_Bearer_,12,3,3,6,13,0.000066
jrssister,27,3,3,6,12,0.000201
Spare_Ad5009,47,3,0,3,0,0
fitandhealthyguy,12,1,3,4,13,0
SlovenlyMuse,10,0,1,1,12,0
Total-Habit-7337,45,1,1,2,14,0.000017
Smart-Afternoon-4235,11,1,2,3,14,0.000003
Snoo93629,10,1,1,2,14,0.000057
SnooPets8873,10,0,1,1,13,0
Solid-Musician-8476,26,1,1,2,3,0
Think-Variation2986,10,3,3,6,11,0.000001
Space_Pirate_R,10,1,2,3,13,0.000001
Specialist-Owl2660,28,0,1,1,1,0
Specialist-Rise1622,18,3,1,4,1,0.000057
Symbiotic_flux,14,1,1,2,1,0
KatzAKat,14,1,0,1,0,0
SpiritedLettuce6900,16,0,2,2,15,0
Sprmodelcitizen,10,1,1,2,15,0.000001
ashkesLasso,13,2,3,5,13,0.000838
Squaaaaaasha,11,1,1,2,1,0
findmeauname,12,1,1,2,13,0.000116
turbografx_64,16,2,3,5,13,0.000466
simcity4000,12,1,4,5,11,0.000026
toothychicken,10,2,1,3,14,0.000039
fizzmore,14,2,1,3,13,0.000056
Stingre1956,11,0,2,2,13,0
Stock_Sun7390,10,0,1,1,13,0
Stormtomcat,25,1,4,5,11,0
StrikingExcitement79,18,0,2,2,12,0
Playful-Mastodon9251,11,1,0,1,0,0
WillowGirlMom,26,1,2,3,12,0.000001
Sufficient-Win-1234,10,1,1,2,14,0.000034
SunMoonTruth,16,0,1,1,15,0
juwruul,14,1,3,4,14,0
Sure-Lingonberry-283,19,4,5,9,12,0.000123
_Calmarkel,15,3,3,6,13,0
notyourmartyr,10,2,2,4,13,0
SwedishDad01,10,0,1,1,14,0
nolife159,12,1,3,4,13,0.000016
SweetMaam,22,2,1,3,1,0
Valkrhae,10,1,1,2,1,0
TALKTOME0701,17,1,5,6,13,0
Team503,11,4,5,9,13,0.000037
Elegant_Bluebird_460,17,1,0,1,0,0
aaeme,20,2,3,5,12,0.000018
waldleben,13,3,4,7,12,0.000086
TankieErik,10,1,1,2,15,0
allprologues,16,2,5,7,12,0.000155
stex85,20,1,1,2,13,0.000011
Thatredheadwithcurls,23,0,3,3,14,0
brutishbloodgod,15,1,1,2,14,0.000005
Wise-Opportunity-294,10,3,3,6,13,0.000069
TheOpinionIShare,13,0,4,4,13,0
goldgoldfish,14,1,0,1,0,0
ThePurplestMeerkat,23,0,1,1,1,0
KayItaly,16,1,0,1,0,0
TheTrueCampor,17,1,3,4,14,0.000011
maiingaans,12,1,1,2,15,0
The_Artist_Dox,16,0,2,2,13,0
Theistus,18,2,1,3,1,0.000003
mmmeadi,21,1,1,2,1,0
Thermicthermos,12,1,1,2,14,0
jakeofheart,22,2,2,4,12,0.000062
Tight_Jaguar_3881,20,2,6,8,12,0.000002
lmchatterbox,15,2,2,4,13,0
awbradl9,12,2,2,4,14,0.000064
Traditional-Swan-130,11,0,5,5,11,0
Walktothebrook,10,1,0,1,0,0
TrainOfThought6,12,1,3,4,13,0.000021
TrelanaSakuyo,11,2,2,4,14,0
amongthepillows,20,1,1,2,1,0
TrexPushupBra,13,2,3,5,14,0.000061
space_cult,21,2,2,4,14,0.000061
Trouble_Walkin,14,1,1,2,15,0
thatrandomuser1,20,3,4,7,14,0
Lumpy_Ear2441,13,1,0,1,0,0
mayasux,10,3,2,5,12,0.000626
ImAMorty777,18,1,0,1,0,0
U8337Flower,24,3,3,6,13,0.000108
mcbriza,10,2,1,3,14,0.000015
UnbreakableAlice,26,2,2,4,15,0
writinwater,13,1,3,4,14,0
lemickeynorings,16,3,4,7,12,0.001054
alliwantistacoss,30,4,5,9,12,0.000001
anotherdropin,16,2,3,5,13,0
multipocalypse,45,1,5,6,11,0
utriptmybitchswitch,10,1,1,2,13,0
blackglum,10,3,3,6,13,0.000024
Universeintheflesh,12,1,5,6,12,0.000428
Usual-throwaway7076,14,2,2,4,14,0
Wise_Session_5370,52,1,2,3,15,0
ded517,16,1,3,4,13,0
gr8dspro,11,2,1,3,13,0
VanityOfEliCLee,10,0,1,1,2,0
Verticalsinging,20,0,1,1,15,0
zeeelfprince,14,1,1,2,14,0
Chelonie4,21,1,0,1,0,0
Lurking_87,28,1,0,1,0,0
WeAreAllMycelium,13,1,1,2,15,0.000078
Embarrassed_Loss_584,20,1,0,1,0,0
katiemorag90,10,1,2,3,12,0
Wide-Speaker-7384,12,1,1,2,15,0
WildMaineBlueberry87,25,1,1,2,15,0
WinterAdvantage3847,11,0,1,1,15,0
Totallynaturalvibes,13,1,0,1,0,0
Wwwwwwhhhhhhhj,10,1,2,3,12,0.000003
asamue16,10,1,0,1,0,0.000003
air_walks,10,1,1,2,14,0.000006
YawningDodo,15,1,2,3,13,0
whoreallycarz,16,1,0,1,0,0
doesanyofthismatter,10,1,1,2,12,0.000182
serial_teamkiller,10,1,3,4,12,0.000182
sustainthenoise,10,2,3,5,13,0.000058
molten_dragon,10,1,1,2,14,0.000015
bakedbaker319,14,2,3,5,12,0
_Morgi_the_Corgi_,11,2,2,4,14,0
whiskerrsss,10,1,3,4,13,0
_phish_,12,1,2,3,13,0
nottrumancapote,12,1,1,2,14,0.000001
a3wagner,10,1,1,2,14,0
mle_eliz,15,1,1,2,2,0.000001
danniperson,15,1,0,1,0,0
forestrox,12,2,2,4,15,0
amaxen,12,1,2,3,13,0.000428
tcdaf7929,44,1,2,3,14,0
WileCoyote83,18,1,0,1,0,0
anglflw,15,1,1,2,11,0
hadesarrow3,24,4,6,10,13,0
aperture413,14,2,2,4,14,0.000072
helion_ut,27,1,2,3,12,0.000207
bakerfaceman,11,2,3,5,13,0.000052
ballisticks,11,0,2,2,13,0
foreverAmber14,13,2,3,5,12,0.000027
the_buddhaverse,16,1,2,3,12,0.004846
bladex1234,10,1,3,4,12,0.000068
butts-kapinsky,11,0,1,1,13,0
captain-burrito,10,1,3,4,13,0.000373
carsonthecarsinogen,14,1,2,3,14,0.000008
copropnuma,10,2,3,5,13,0.000079
d-cent,17,1,1,2,13,0.000029
dbmermels,17,1,1,2,15,0
kathop8,12,1,0,1,0,0
mystad,12,2,6,8,12,0.002242
jacquidaiquiri,17,2,3,5,13,0.000076
entirelyintrigued,10,0,1,1,13,0
epicmooz,10,2,2,4,13,0
flimflam_machine,24,1,2,3,14,0.000099
fluffybabbles,10,0,3,3,11,0
friendlily,17,1,1,2,15,0.000001
fyrdude58,12,0,1,1,2,0
poIym0rphic,10,1,2,3,14,0.000251
geredtrig,10,0,1,1,15,0
shrug_addict,10,1,1,2,13,0.000057
half_way_by_accident,15,0,5,5,13,0
hardman52,15,1,1,2,13,0.000092
the_LLCoolJoe,12,1,3,4,14,0
iambecomesoil,30,0,1,1,14,0
igwbuffalo,11,0,1,1,12,0
internet_commie,10,1,1,2,14,0.000056
issy_haatin,12,0,2,2,14,0
stewshi,13,1,1,2,13,0.000244
satanic_androids,11,2,3,5,13,0.000082
jiminygofckyrself,11,1,2,3,13,0
johnwcowan,10,2,5,7,13,0.000417
yellowhatb,12,1,1,2,13,0.00291
kidcudi115,13,1,1,2,13,0.001443
veartchess,11,2,2,4,12,0.00023
Spare_Butterfly_213,24,1,0,1,0,0
getfukdup,16,1,0,1,0,0
llordlloyd,14,1,5,6,13,0.000899
maralagosinkhole,11,0,1,1,14,0
markov_antoni,12,0,1,1,13,0
memphisjohn,12,1,1,2,15,0.00004
moo-chu,25,1,3,4,12,0
tarahlynn,15,1,6,7,13,0
Mysterious_Luck4674,10,1,0,1,0,0.000004
nacho_hat,34,0,1,1,2,0
nextnode,18,1,3,4,14,0.000033
ninetofivehangover,13,0,1,1,14,0
none74238,10,1,2,3,13,0.000979
numbersthen0987431,17,0,3,3,13,0
PhotoForward2499,14,1,0,1,0,0
phtcmp,13,1,1,2,14,0
pfundie,11,0,3,3,13,0
phoenix823,19,1,1,2,14,0
thatVisitingHasher,12,1,1,2,14,0.000006
Over_Bus9361,39,1,0,1,0,0
k23_k23,71,1,0,1,0,0
NoGuarantee3961,10,1,0,1,0,0
scarletwellyboots,12,0,2,2,12,0
Dante2377,11,1,0,1,0,0
tinyhermione,26,1,1,2,13,0.000428
Appropriate-Bar6993,19,1,0,1,0,0
allieadventurer,21,1,0,1,0,0
IndividualGain4653,13,1,0,1,0,0
sreno77,13,0,2,2,13,0
sunny_suburbia,22,0,2,2,16,0
Nester1953,20,1,0,1,0,0
windershinwishes,14,1,2,3,13,0.000492
2060ASI,10,0,0,0,0,0
5PeeBeejay5,10,0,0,0,0,0
77x88x88x77,13,0,0,0,0,0
AProperFuckingPirate,10,0,0,0,0,0
Adelucas,12,0,0,0,0,0
Aggravating_Teach210,12,0,0,0,0,0
AllHailTheHypnoTurd,10,0,0,0,0,0
AmItheAsshole-ModTeam,33,0,0,0,0,0
Anchuinse,13,0,0,0,0,0
Anxious-Routine-5526,21,0,0,0,0,0
Anxious_Article_2680,13,0,0,0,0,0
Asleep_Lettuce_5723,11,0,0,0,0,0
AvailableWhereas8832,10,0,0,0,0,0
AvocadoJazzlike3670,15,0,0,0,0,0
BattMruno33,14,0,0,0,0,0
Be-My-Enemy,19,0,0,0,0,0
Beachboy442,12,0,0,0,0,0
BeckyDaTechie,17,0,0,0,0,0
Better-Turnover2783,21,0,0,0,0,0
Bluewaveempress,11,0,0,0,0,0
Brave-Fun-7984,11,0,0,0,0,0
CablePuzzleheaded497,18,0,0,0,0,0
Careless-Ability-748,35,0,0,0,0,0
Character-Twist-1409,10,0,0,0,0,0
Charlea1776,11,0,0,0,0,0
CheekPowerful8369,12,0,0,0,0,0
Civil_Environment858,13,0,0,0,0,0
ClassicCommercial581,15,0,0,0,0,0
Clean_Permit_3791,10,0,0,0,0,0
Codenamerondo1,32,0,0,0,0,0
Cold_Victory7398,12,0,0,0,0,0
ConsciousApartment48,10,0,0,0,0,0
Consistent_Proof_772,11,0,0,0,0,0
Cool-Group-9471,10,0,0,0,0,0
CrabbiestAsp,10,0,0,0,0,0
DakTyree3141,11,0,0,0,0,0
DarkSkyKnight,10,0,0,0,0,0
DashJackson,11,0,0,0,0,0
Dear_Ad_9640,10,0,0,0,0,0
DiceyPisces,10,0,0,0,0,0
DinaFelice,10,0,0,0,0,0
DoyoudotheDew,12,0,0,0,0,0
DragonFireLettuce,12,0,0,0,0,0
Dramatic-Emphasis-43,14,0,0,0,0,0
DriftingLily9,19,0,0,0,0,0
Due_Cricket1885,10,0,0,0,0,0
EdelwoodEverly,13,0,0,0,0,0
ElectricMayhem123,150,0,0,0,0,0
ElemWiz,10,0,0,0,0,0
Empress_cat_1981,23,0,0,0,0,0
EnLaSxranko,11,0,0,0,0,0
EndsIn-ing,18,0,0,0,0,0
Error_404_403,17,0,0,0,0,0
Exact_Cantaloupe_408,11,0,0,0,0,0
Exciting-Peanut-1526,13,0,0,0,0,0
Farvas-Cola,61,0,0,0,0,0
Fast-Penta,10,0,0,0,0,0
Few_Employment5424,11,0,0,0,0,0
Few_Engineering_4710,12,0,0,0,0,0
Final_Candle7759,10,0,0,0,0,0
FlashyHabit3030,18,0,0,0,0,0
Floating-Cynic,11,0,0,0,0,0
Foodielicious843,11,0,0,0,0,0
Formal_Cap_1324,15,0,0,0,0,0
FoxyDepression,11,0,0,0,0,0
FranksFrankThoughts,10,0,0,0,0,0
Fun_Possession3299,19,0,0,0,0,0
Gabby_Craft,12,0,0,0,0,0
GeekyPassion,10,0,0,0,0,0
General_Relative2838,11,0,0,0,0,0
Glittering_Set6017,10,0,0,0,0,0
Glum_Designer_4754,16,0,0,0,0,0
Gold-Delay6362,10,0,0,0,0,0
Goodnight_big_baby,23,0,0,0,0,0
GothPenguin,29,0,0,0,0,0
GrumpyScot61,14,0,0,0,0,0
HOAKaren,11,0,0,0,0,0
HappyGardener52,15,0,0,0,0,0
Haunting_Shelter8003,11,0,0,0,0,0
HiddenThinks,10,0,0,0,0,0
Human_Ad_6671,24,0,0,0,0,0
Illustrious_Ad_4558,10,0,0,0,0,0
Impossible_Smile4113,14,0,0,0,0,0
Infinite-Cat-Peep,11,0,0,0,0,0
International-Fee255,21,0,0,0,0,0
JGalKnit,18,0,0,0,0,0
Jazzlike-Bird-3192,11,0,0,0,0,0
JohnFresh669,16,0,0,0,0,0
JustWowinCA,12,0,0,0,0,0
Kittymeow123,12,0,0,0,0,0
LaMisiPR,11,0,0,0,0,0
Labradawgz90,11,0,0,0,0,0
Lancasterbation,17,0,0,0,0,0
Latin_Stallion7777,12,0,0,0,0,0
Latter-Refuse8442,11,0,0,0,0,0
LawyerDad1981,23,0,0,0,0,0
Legal-Profile-183,16,0,0,0,0,0
Legolaslegs,28,0,0,0,0,0
Less_Instruction_345,10,0,0,0,0,0
LhasaApsoSmile,13,0,0,0,0,0
Live-Enthusiasm5422,11,0,0,0,0,0
Longjumping-Job-2544,11,0,0,0,0,0
LordShadows,12,0,0,0,0,0
Loud-Climate5927,10,0,0,0,0,0
Loud_Box8802,10,0,0,0,0,0
M312345,13,0,0,0,0,0
Ma-Hu,11,0,0,0,0,0
Magdovus,18,0,0,0,0,0
Mediocre-Studio2573,13,0,0,0,0,0
Medusa_7898,30,0,0,0,0,0
MiLowe35,11,0,0,0,0,0
MildAsSriracha,12,0,0,0,0,0
Mina_Girl,10,0,0,0,0,0
Mindless_Giraffe4559,12,0,0,0,0,0
Mission-Patient-4404,16,0,0,0,0,0
MisterFrancesco,10,0,0,0,0,0
Mr_Ariyeh,13,0,0,0,0,0
MyCatSpellsBetter,13,0,0,0,0,0
Mysterious_Salt_247,16,0,0,0,0,0
Mystery-Ess,10,0,0,0,0,0
Neohaq,28,0,0,0,0,0
New-Manufacturer263,12,0,0,0,0,0
NinjaHidingintheOpen,17,0,0,0,0,0
No-Giraffe49,11,0,0,0,0,0
NoComputer8922,10,0,0,0,0,0
NoHorseNoMustache,24,0,0,0,0,0
NoOneEverSeems2SeeMe,36,0,0,0,0,0
No_Mention3516,18,0,0,0,0,0
North81Girl,10,0,0,0,0,0
Ok-CANACHK,11,0,0,0,0,0
Ok-Trainer3150,11,0,0,0,0,0
OrcOfDoom,10,0,0,0,0,0
Ornery-Wasabi-473,10,0,0,0,0,0
Outrageous-Arm1945,11,0,0,0,0,0
Outrageous-forest,26,0,0,0,0,0
PM-me-in-100-years,10,0,0,0,0,0
Pale_Height_1251,12,0,0,0,0,0
PaperGoodsAddict29,11,0,0,0,0,0
PeopleAre2Strange,15,0,0,0,0,0
Peskypoints,24,0,0,0,0,0
PipingTheTobak,12,0,0,0,0,0
Plumbus-aficianado,19,0,0,0,0,0
Potential-Power7485,13,0,0,0,0,0
PrestigiousFace6756,13,0,0,0,0,0
Primary_Grass5952,20,0,0,0,0,0
ProfessorDistinct835,15,0,0,0,0,0
ProfessorYaffle1,28,0,0,0,0,0
Psychological-Work85,10,0,0,0,0,0
Puppet_mistrezz,10,0,0,0,0,0
Puzzled_Feedback_840,12,0,0,0,0,0
QL58,11,0,0,0,0,0
QubitEncoder,13,0,0,0,0,0
R4eth,18,0,0,0,0,0
Radijs,10,0,0,0,0,0
RandiLynn1982,10,0,0,0,0,0
RandomModder05,14,0,0,0,0,0
Rare_Sugar_7927,21,0,0,0,0,0
Real-Dragonfruit-585,28,0,0,0,0,0
RecalcitrantMonk,13,0,0,0,0,0
Remarkable-Cry7123,12,0,0,0,0,0
Reverse_Quikeh,12,0,0,0,0,0
RevolutionaryCommon,10,0,0,0,0,0
RiddLA311,19,0,0,0,0,0
Riker_Omega_Three,11,0,0,0,0,0
Rinerino,11,0,0,0,0,0
Rocketeer57,15,0,0,0,0,0
Ruebee90,10,0,0,0,0,0
Runns_withScissors,10,0,0,0,0,0
SadieDiAbla,12,0,0,0,0,0
Sea_Researcher7410,10,0,0,0,0,0
ShannaraRose,29,0,0,0,0,0
Shoddy-Potential5727,11,0,0,0,0,0
Silent_Advantage6138,14,0,0,0,0,0
SlinkyMalinky20,19,0,0,0,0,0
SnausageFest,38,0,0,0,0,0
SnooSprouts6437,10,0,0,0,0,0
SomeoneYouDontKnow70,11,0,0,0,0,0
SpaTowner,11,0,0,0,0,0
Spare_Necessary_810,21,0,0,0,0,0
SpecialModusOperandi,20,0,0,0,0,0
Specialist_Job9678,13,0,0,0,0,0
Spinnerofyarn,13,0,0,0,0,0
Squirrels-love-me,10,0,0,0,0,0
SubstantialQuit2653,10,0,0,0,0,0
SummerHill2130,13,0,0,0,0,0
SuspiciousCod1090,25,0,0,0,0,0
Sweetsmyle,15,0,0,0,0,0
SydowJones,16,0,0,0,0,0
TangerineCouch18330,16,0,0,0,0,0
TeenySod,10,0,0,0,0,0
TemptingPenguin369,37,0,0,0,0,0
Thari-97,11,0,0,0,0,0
TheNerdofLife,26,0,0,0,0,0
The_Demosthenes_1,17,0,0,0,0,0
Thebestfamily628,10,0,0,0,0,0
Thick_Ad_9729,13,0,0,0,0,0
Throwawaylife1984,21,0,0,0,0,0
Tinkerpro,10,0,0,0,0,0
Weird-Roll6265,16,0,0,0,0,0
Wise_Entertainer_970,15,0,0,0,0,0
WolfChasingTheMoon,15,0,0,0,0,0
Working_Cloud_909,10,0,0,0,0,0
WtfChuck6999,12,0,0,0,0,0
YakSlothLemon,11,0,0,0,0,0
actualchristmastree,23,0,0,0,0,0
akelita,12,0,0,0,0,0
amore-7,18,0,0,0,0,0
anglican_skywalker,21,0,0,0,0,0
bababooeey_exe,10,0,0,0,0,0
bexkali,10,0,0,0,0,0
bokatan778,11,0,0,0,0,0
bopperbopper,15,0,0,0,0,0
boundmaus,10,0,0,0,0,0
briomio,10,0,0,0,0,0
burrito_napkin,10,0,0,0,0,0
catladyclub,13,0,0,0,0,0
cheekmo_52,13,0,0,0,0,0
clinicalia,11,0,0,0,0,0
completedett,34,0,0,0,0,0
cyrilhent,11,0,0,0,0,0
davehal2001,12,0,0,0,0,0
felice60,15,0,0,0,0,0
flynena-3,23,0,0,0,0,0
garyt1957,12,0,0,0,0,0
ghoul-gore,11,0,0,0,0,0
giuliabricot,14,0,0,0,0,0
gloryhokinetic,26,0,0,0,0,0
goldenfingernails,11,0,0,0,0,0
gruesse98604,20,0,0,0,0,0
hadMcDofordinner,11,0,0,0,0,0
ilcuzzo1,15,0,0,0,0,0
incospicuous_echoes,26,0,0,0,0,0
itzmetheredditor,13,0,0,0,0,0
julesk,27,0,0,0,0,0
kaorizma,10,0,0,0,0,0
kellykebab,10,0,0,0,0,0
kiwimuz,17,0,0,0,0,0
knight_shade_realms,10,0,0,0,0,0
lavasca,11,0,0,0,0,0
lilpikasqueaks,49,0,0,0,0,0
lovescarats,11,0,0,0,0,0
neon_crone,10,0,0,0,0,0
nofallingupward,15,0,0,0,0,0
omrixs,13,0,0,0,0,0
onethomashall,12,0,0,0,0,0
opine704,11,0,0,0,0,0
oswhistle,19,0,0,0,0,0
ploud1,11,0,0,0,0,0
princess_melancholy,10,0,0,0,0,0
pwolf1111,11,0,0,0,0,0
rangerstranger9472,18,0,0,0,0,0
razvanght,10,0,0,0,0,0
redeadhead,11,0,0,0,0,0
reredd1tt1n,10,0,0,0,0,0
rosythorn_,10,0,0,0,0,0
see-you-every-day,12,0,0,0,0,0
shammy_dammy,10,0,0,0,0,0
similar_name4489,13,0,0,0,0,0
sjplep,10,0,0,0,0,0
stiletto929,10,0,0,0,0,0
taliaf1312,11,0,0,0,0,0
tboy160,11,0,0,0,0,0
tdifen,10,0,0,0,0,0
thechipperhalf,11,0,0,0,0,0
theguy_12345,10,0,0,0,0,0
thenexttimebandit,10,0,0,0,0,0
thenord321,23,0,0,0,0,0
thfemaleofthespecies,11,0,0,0,0,0
watain218,10,0,0,0,0,0
wayward_painter,12,0,0,0,0,0
we-vs-us,10,0,0,0,0,0
xwhyterabbitx,12,0,0,0,0,0
