id,engagement,indegree,outdegree,degree,eccentricity,authority
12bEngie,38,7,72,79,11,0.003412
10thAmdAbsolutist,391,69,83,152,11,0.008592
AberforthSpeck,11,4,0,4,0,0.001848
AnLoingseach,11,2,2,4,12,0.000402
AutoModerator,1943,71,0,71,0,0.118055
BarleyWineIsTheBest,80,12,10,22,11,0.002331
Budget_Trifle_1304,10,7,3,10,11,0.001336
Commercial-Print-,27,5,4,9,12,0.00044
Conscious-Function-2,35,13,4,17,12,0.003775
DeltaBot,1045,66,38,104,11,0.02347
Difficult_Minute8202,15,2,1,3,14,0.001023
DoesMatter2,16,6,4,10,12,0.000905
DryEditor7792,21,7,0,7,0,0.005241
False_Appointment_24,30,19,6,25,12,0.001852
FarConstruction4877,37,9,2,11,12,0.003193
GermanPayroll,23,18,7,25,12,0.002321
HexspaReloaded,21,4,21,25,12,0.001246
Holiman,10,2,1,3,1,0.00039
HumansMustBeCrazy,10,4,1,5,15,0.000717
ImmortalAgentEta,19,9,4,13,13,0.002232
Inferno_Zyrack,22,12,7,19,11,0.003708
Johnnadawearsglasses,18,7,4,11,11,0.003919
Key-Practice-2336,10,3,1,4,13,0.000701
LimeDramatic4624,10,4,4,8,13,0.000411
LisleAdam12,48,16,15,31,12,0.004513
Matsdaq,10,5,5,10,12,0.002229
Mental-Cupcake9750,19,4,0,4,0,0.003358
Morthra,171,64,60,124,10,0.011973
Mvpbeserker,19,9,5,14,12,0.004743
NaturalCarob5611,67,26,12,38,11,0.006409
Nofanta,29,4,1,5,1,0.001293
Phage0070,43,7,5,12,12,0.001668
Potential_Wish4943,45,26,15,41,11,0.004319
Ramguy2014,28,8,5,13,12,0.00216
Rare-Discipline3774,13,5,0,5,0,0.001618
RiverCityWoodwork,31,20,6,26,12,0.004795
Shadow_666_,10,5,3,8,12,0.011094
Sure_Acanthaceae_348,25,8,3,11,13,0.004741
SweatyAnimator6189,10,2,1,3,16,0.00039
TPSreportmkay,108,22,9,31,13,0.004835
Technical_Goose_8160,20,10,6,16,12,0.018617
WanderingSpearIt,62,9,3,12,13,0.001685
Wooden-Ad-3382,46,13,10,23,12,0.00195
ZorgZeFrenchGuy,15,9,5,14,13,0.001745
a_rabid_anti_dentite,12,5,3,8,13,0.000772
azuredota,22,8,5,13,13,0.001474
caseybvdc74,16,3,34,37,12,0.00041
changemyview-ModTeam,3697,73,2,75,14,0.026223
darthmcdarthface,50,16,11,27,12,0.003722
enemy884real,12,4,0,4,0,0.00289
hillswalker87,35,13,13,26,12,0.004318
ihatepasswords1234,79,13,19,32,12,0.001692
jbslaw1214,34,7,6,13,12,0.00046
legal_opium,12,5,6,11,12,0.003498
lifeisabowlofbs,73,30,49,79,11,0.006919
nogooduse,21,10,9,19,12,0.005391
nrcx,25,6,6,12,12,0.000782
ozneoknarf,16,3,2,5,12,0.002182
saintsithney,15,4,5,9,11,0.000567
thebossmin,31,11,3,14,11,0.013045
tidalbeing,27,5,2,7,14,0.000711
wolacouska,12,6,5,11,13,0.002763
212312383,28,11,32,43,12,0.006199
Beneficial-Diet-9897,30,5,3,8,12,0.000512
Beyond_Reason09,11,5,3,8,13,0.001573
DrNogoodNewman,30,14,8,22,12,0.001554
Foulis68,48,10,6,16,13,0.001663
Gurrgurrburr,14,2,4,6,12,0.001688
Happy-Viper,29,5,2,7,12,0.000841
Hypekyuu,42,10,5,15,12,0.002587
Inner_Butterfly1991,41,14,9,23,12,0.003253
Jaded_Jerry,22,17,0,17,0,0.005586
Madrigall,29,10,5,15,12,0.001201
Nrdman,352,33,15,48,12,0.005425
ParticularBreath8425,14,8,4,12,12,0.001532
Regalian,24,4,1,5,13,0.001443
Roadshell,78,23,9,32,12,0.002505
RulesBeDamned,38,18,5,23,12,0.004792
TheSauceeBoss,78,24,14,38,12,0.005177
ZoomZoomDiva,98,23,16,39,12,0.0034
azarash,12,6,4,10,12,0.001383
curiouslyjake,69,22,8,30,12,0.003365
davidml1023,54,16,9,25,13,0.00119
iosefster,11,3,2,5,12,0.000397
lolexecs,11,5,4,9,13,0.012557
premiumPLUM,49,11,2,13,12,0.002
the_1st_inductionist,65,10,4,14,12,0.000884
81forest,11,5,28,33,11,0.00145
ATLEMT,12,5,1,6,13,0.000899
AresBloodwrath,11,4,2,6,12,0.000199
BuskerDan,11,4,2,6,13,0.000145
Cactuswhack1,31,21,4,25,11,0.001653
DrFabio23,12,3,1,4,12,0.00018
FerdinandTheGiant,62,17,18,35,11,0.002926
IT_ServiceDesk,66,29,9,38,12,0.004537
KaiBahamut,72,21,21,42,12,0.002495
Mashaka,86,14,0,14,0,0.006659
Mysterious_Cum,11,2,1,3,14,0.000118
ProfessionalLurkerJr,20,9,9,18,10,0.001466
SmokeySFW,20,3,0,3,0,0.000146
Successful-Cat9185,10,1,2,3,12,0.000114
SupervisorSCADA,34,6,4,10,12,0.000899
TheMan5991,28,5,4,9,12,0.000302
Thin-Management-1960,16,4,0,4,0,0.000677
YouJustNeurotic,55,12,6,18,12,0.002875
deftonite,20,9,4,13,12,0.002363
flairsupply,73,22,5,27,13,0.004296
vsv2021,21,8,6,14,12,0.002365
8NaanJeremy,34,7,33,40,11,0.000805
47ca05e6209a317a8fb3,17,13,2,15,13,0.002118
ButterscotchNo1546,62,7,7,14,12,0.001056
Douchebazooka,11,3,2,5,13,0.00028
Downtown-Campaign536,17,6,1,7,13,0.000907
Dry_Bumblebee1111,152,48,8,56,13,0.008317
Fabulous-Suspect-72,155,23,21,44,12,0.002568
Falernum,67,18,7,25,13,0.003701
LucidMetal,119,36,23,59,11,0.004971
Ohjiisan,28,5,2,7,14,0.000592
Ok-Round-1473,39,9,6,15,12,0.000438
Potential_Being_7226,10,5,3,8,12,0.000205
ScytheSong05,11,5,2,7,13,0.000513
Significant_Stand_17,20,2,2,4,13,0.000143
Slime__queen,26,7,5,12,11,0.000747
bifewova234,10,4,0,4,0,0.000481
heroyoudontdeserve,45,12,12,24,11,0.000667
misanthpope,33,12,9,21,12,0.001387
sh00l33,42,12,7,19,11,0.002422
washingtonu,11,5,3,8,12,0.009685
yyzjertl,126,42,11,53,11,0.005947
zxxQQz,24,15,14,29,11,0.001592
AlexandrTheTolerable,15,6,49,55,12,0.029058
Alive_Shoulder3573,80,15,15,30,12,0.034873
Ana_Na_Moose,36,11,8,19,12,0.039216
Ashmedai,78,27,31,58,12,0.090803
BRAINSPLATTER16,26,5,5,10,12,0.004339
Buck_Thorn,15,5,3,8,13,0.016664
Delta-9-,55,19,17,36,11,0.054482
Edgar_Brown,19,6,3,9,13,0.01465
Fargason,84,16,17,33,12,0.026104
Fluffy-Load1810,14,7,2,9,13,0.027468
FrozenSeas,19,12,8,20,12,0.031046
Hyndis,28,9,9,18,12,0.036381
IleGrandePagliaccio,31,7,4,11,12,0.023225
IniNew,43,20,15,35,12,0.065955
Interrophish,123,26,38,64,11,0.080804
IntrepidAd2478,32,19,15,34,12,0.043013
Jen0BIous,29,3,1,4,12,0.00444
Kaleb_Bunt,12,5,0,5,0,0.004221
KurtisRambo19,12,6,5,11,13,0.01483
MaineHippo83,112,44,37,81,11,0.062502
ManBearScientist,80,25,23,48,12,0.064165
Moccus,95,35,38,73,12,0.06694
NorthernerWuwu,24,9,7,16,12,0.038352
Nothing_Better_3_Do,109,54,29,83,11,0.096388
Objective_Aside1858,166,74,353,427,11,0.072323
Omari-OTL,11,3,2,5,13,0.002468
PoliticalDiscussion-ModTeam,203,15,0,15,0,0.078852
Sageblue32,64,20,22,42,12,0.055316
Sarmq,28,5,4,9,12,0.018236
StanDaMan1,15,9,7,16,12,0.023638
TheMikeyMac13,65,26,15,41,12,0.046182
UnfoldedHeart,99,37,33,70,12,0.074468
WhiteWolf3117,10,3,2,5,11,0.012319
XXXCincinnatusXXX,24,9,5,14,12,0.028775
anti-torque,66,18,25,43,12,0.060429
baxterstate,146,45,22,67,12,0.091389
bl1y,509,94,115,209,12,0.107942
clios_daughter,21,5,5,10,12,0.00294
clorox_cowboy,10,4,5,9,12,0.004387
kingjoey52a,49,31,8,39,12,0.036704
mskmagic,37,11,7,18,12,0.027829
neosituation_unknown,16,15,0,15,0,0.017876
skyfishgoo,34,11,5,16,12,0.047861
sllewgh,147,18,13,31,11,0.016054
sunfishtommy,18,11,12,23,11,0.033931
theyfellforthedecoy,58,30,25,55,12,0.07067
AncienTleeOnez,21,5,28,33,12,0.011051
Far_Realm_Sage,27,17,3,20,12,0.069419
JDogg126,45,22,12,34,12,0.045497
ManOfLaBook,10,2,2,4,13,0.001238
Roadside_Prophet,12,9,5,14,12,0.007273
RobotAlbertross,19,9,2,11,11,0.047577
Rook_lol,10,9,3,12,12,0.018833
Slam_Bingo,13,5,2,7,14,0.012956
SlowMotionSprint,34,12,11,23,11,0.052095
TheOvy,25,15,6,21,12,0.039571
ThePensiveE,29,13,6,19,11,0.046631
The_B_Wolf,63,19,12,31,11,0.02078
__zagat__,68,19,27,46,11,0.053082
drdildamesh,18,5,4,9,12,0.020243
infiniteninjas,14,3,2,5,13,0.015226
kenmele,15,3,1,4,12,0.011071
mrjcall,116,35,20,55,12,0.09073
peetnice,16,7,7,14,12,0.016462
satyrday12,57,31,21,52,12,0.081087
tosser1579,43,21,7,28,13,0.03993
vesselofwords,13,6,6,12,12,0.023699
Awesomeuser90,31,2,177,179,11,0.000486
-ReadingBug-,40,11,10,21,11,0.046054
-SOFA-KING-VOTE-,75,23,13,36,12,0.029854
123yes1,17,5,4,9,13,0.010116
1QAte4,17,22,5,27,13,0.053538
303Carpenter,12,8,5,13,13,0.032743
8to24,89,54,28,82,12,0.082378
ANewBeginningNow,18,12,0,12,0,0.041807
AT_Dande,11,8,4,12,12,0.035888
Aazadan,15,8,8,16,12,0.036372
Ashamed_Job_8151,18,8,7,15,12,0.044308
Aureliamnissan,20,5,5,10,12,0.023744
Balanced_Outlook,68,20,33,53,12,0.04128
Bishop_Colubra,10,5,3,8,13,0.009643
BluesSuedeClues,285,90,250,340,11,0.129673
CellularSavant,14,6,2,8,12,0.022361
ChepaukPitch,10,2,3,5,13,0.007952
ClockOfTheLongNow,776,161,162,323,10,0.164161
Comfortable-Policy70,14,6,5,11,12,0.039495
Corellian_Browncoat,40,20,18,38,12,0.048758
Cursethewind,13,3,4,7,12,0.019009
DBDude,136,47,34,81,11,0.05161
DCBuckeye82,17,5,5,10,12,0.010548
DarkExecutor,14,6,5,11,12,0.01506
Donut-Strong,10,9,1,10,12,0.018347
DrPlatypus1,21,7,3,10,12,0.009907
Eric848448,44,20,14,34,11,0.045639
Factory-town,224,44,54,98,11,0.102422
FallOutShelterBoy,10,8,5,13,12,0.032532
Fit-Order-9468,61,10,5,15,13,0.008308
Fragrant-Luck-8063,34,12,10,22,12,0.034347
GarbledComms,14,10,5,15,13,0.011062
GiantPineapple,28,14,7,21,12,0.030358
GoldenInfrared,25,6,7,13,12,0.010847
GrandMasterPuba,30,12,9,21,12,0.037001
GreatConsequence7847,11,5,5,10,12,0.010269
Hapankaali,49,13,10,23,12,0.046988
HardlyDecent,38,21,10,31,12,0.06255
HeloRising,43,12,6,18,12,0.037698
I-Here-555,57,29,19,48,12,0.062921
I405CA,215,70,37,107,11,0.111447
IceNein,47,30,18,48,12,0.043483
Ill-Description3096,127,41,36,77,12,0.032596
InNominePasta,22,16,9,25,12,0.043566
JKlerk,189,47,36,83,12,0.112915
JQuilty,29,10,9,19,11,0.032119
JohnSpartan2025,12,4,80,84,12,0.033641
JonDowd762,28,14,14,28,12,0.042927
JuniorFarcity,21,12,10,22,12,0.020615
Key_Day_7932,10,6,4,10,12,0.048583
Kronzypantz,86,23,105,128,11,0.049648
LagerHead,10,2,4,6,11,0.009489
LanaDelHeeey,49,22,13,35,12,0.027258
Lanracie,43,14,5,19,12,0.056531
Leather-Map-8138,68,22,12,34,11,0.089245
Lefaid,17,7,19,26,12,0.01185
LifesARiver,13,5,4,9,12,0.038597
MatthewRebel,12,7,2,9,12,0.025221
Mend1cant,19,10,4,14,12,0.027087
MiddleAndLeg_,10,2,0,2,0,0.011282
MorganWick,44,14,17,31,12,0.041362
MurrayBothrard,77,35,26,61,12,0.062361
NoExcuses1984,43,14,17,31,12,0.038658
NomadicScribe,11,5,3,8,13,0.009796
Nulono,30,6,10,16,13,0.027004
Only_Economics7148,15,2,0,2,0,0.016497
Ornery-Ticket834,59,18,13,31,11,0.058068
Outrageous-Pay535,16,7,7,14,12,0.023334
Personage1,10,5,5,10,12,0.020577
PhiloPhocion,11,6,3,9,13,0.034317
Polyodontus,144,32,39,71,11,0.033298
Potato_Pristine,15,7,7,14,12,0.032271
RCA2CE,196,51,31,82,12,0.109369
Raichu4u,17,9,54,63,11,0.032793
Riokaii,49,18,13,31,11,0.077187
Rivercitybruin,65,31,9,40,12,0.079717
SagesLament,11,7,6,13,12,0.009773
Sapriste,47,16,10,26,12,0.036302
Scatman_Crothers,13,9,9,18,12,0.01341
ScoobiusMaximus,27,13,6,19,11,0.035603
ScoutsHonorHoops,11,3,2,5,13,0.009082
ScreenTricky4257,20,7,3,10,12,0.024809
Serious-Top7925,22,14,10,24,12,0.036421
Spackledgoat,11,5,4,9,13,0.012841
Splenda,35,14,9,23,12,0.059587
SpoofedFinger,18,10,5,15,13,0.031683
TheTrueMilo,28,14,14,28,12,0.051842
ThemesOfMurderBears,21,12,9,21,12,0.062014
Tired8281,13,3,1,4,13,0.019425
Vast-Information4565,12,3,4,7,14,0.007907
VodkaBeatsCube,239,42,43,85,11,0.103865
WISCOrear,15,12,4,16,12,0.038305
WavesAndSaves,75,48,110,158,11,0.077168
Wetness_Pensive,17,7,7,14,11,0.023221
XxSpaceGnomexx,14,6,2,8,12,0.033849
Y0___0Y,38,31,12,43,12,0.055236
Zagden,48,29,20,49,12,0.057487
airbear13,25,5,3,8,13,0.023006
badnuub,13,4,5,9,13,0.01964
barchueetadonai,29,9,12,21,12,0.039872
benfromgr,15,5,3,8,13,0.027244
betty_white_bread,51,9,14,23,12,0.009719
bruce_cockburn,15,5,3,8,12,0.025023
calguy1955,32,16,7,23,12,0.038074
callmejay,24,9,7,16,12,0.010567
chiaboy,55,13,11,24,12,0.039373
cromethus,24,13,5,18,12,0.048156
curien,44,14,11,25,12,0.037386
davethompson413,10,6,2,8,13,0.015884
ddoyen,13,9,5,14,12,0.028867
digbyforever,17,11,3,14,12,0.018193
discourse_friendly,190,54,48,102,12,0.081922
eggoed,26,11,6,17,12,0.025186
epsilona01,60,23,16,39,12,0.071376
etoneishayeuisky,47,8,5,13,11,0.037167
frisbeejesus,31,22,14,36,12,0.058832
gregaustex,23,19,5,24,11,0.059717
hblask,35,12,8,20,12,0.031356
jetpacksforall,102,30,31,61,12,0.069047
jinxbob,10,6,3,9,13,0.017553
jmnugent,21,11,7,18,13,0.020361
just_helping,175,49,61,110,11,0.107317
kinkgirlwriter,44,16,11,27,12,0.063229
luminatimids,17,9,4,13,12,0.040352
maybeafarmer,11,3,0,3,0,0.028485
mcgunner1966,54,17,15,32,12,0.04589
morrison4371,20,8,4,12,12,0.046936
mortemdeus,10,7,3,10,13,0.02359
mycall,16,12,7,19,13,0.047738
mypoliticalvoice,11,2,0,2,0,0.016497
news_feed_me,13,6,1,7,13,0.038232
nylockian,15,7,3,10,12,0.020446
phoenix1984,17,9,5,14,12,0.021481
pliney_,13,7,3,10,12,0.022323
ptmd,19,3,4,7,12,0.012325
reasonably_plausible,25,14,9,23,12,0.038598
roehnin,15,7,6,13,12,0.033563
semideclared,77,20,25,45,12,0.050649
siberianmi,25,17,8,25,11,0.040992
silverionmox,145,25,25,50,11,0.021639
socialistrob,36,11,11,22,12,0.031571
the_calibre_cat,106,24,33,57,11,0.068407
theresourcefulKman,20,7,4,11,13,0.025785
ttown2011,177,69,48,117,11,0.09452
wereallbozos,11,4,3,7,12,0.02034
yo2sense,28,11,9,20,12,0.038771
youcantexterminateme,10,1,1,2,13,0.007753
zayelion,41,10,3,13,12,0.026023
DanforthWhitcomb_,182,46,55,101,12,0.067478
ERedfieldh,41,13,6,19,12,0.051951
ItsAGoodDay,10,3,1,4,12,0.002821
Sarlax,32,12,8,20,11,0.026985
WingerRules,22,12,9,21,12,0.033781
Basic_Cockroach_9545,23,7,25,32,11,0.000714
Alan5953,12,3,2,5,13,0.000403
Cultist_O,29,8,7,15,12,0.000814
Dyn-O-mite_Rocketeer,17,3,2,5,13,0.000233
ElysiX,26,8,3,11,13,0.002298
Level-Ladder-4346,11,7,2,9,13,0.000931
Ok_Border419,16,4,4,8,12,0.001526
SINWillett,12,4,4,8,13,0.000157
StillLikesTurtles,29,8,4,12,11,0.001558
TemperatureThese7909,63,35,4,39,12,0.006815
TonySu,12,6,3,9,13,0.001944
Uhhyt231,83,11,5,16,12,0.002232
horshack_test,68,8,4,12,13,0.001674
ninja-gecko,43,16,8,24,12,0.002475
ralph-j,69,14,1,15,13,0.002338
rgtong,13,3,3,6,12,0.000158
the_brightest_prize,31,8,4,12,12,0.001375
-dag-,23,9,7,16,12,0.032258
0WatcherintheWater0,23,14,12,26,12,0.038929
1ameve,14,4,6,10,12,0.021566
3xploringforever,20,6,12,18,11,0.042438
AdumbroDeus,12,5,5,10,11,0.020107
AmigoDelDiabla,32,13,11,24,12,0.035753
Appropriate_Ear6101,13,5,4,9,12,0.023951
Banes_Addiction,19,14,7,21,12,0.0464
Big-Willingness3384,11,7,6,13,12,0.040712
Bimlouhay83,11,4,2,6,13,0.011202
BitterFuture,176,35,42,77,11,0.059719
BotElMago,86,24,17,41,11,0.042352
BrainDamage2029,23,21,13,34,11,0.039596
Brickscratcher,60,18,17,35,11,0.047879
CelestialFury,27,9,7,16,12,0.031111
Cluefuljewel,37,11,6,17,12,0.055275
ComprehensiveHold382,13,5,2,7,12,0.021538
Davec433,22,12,5,17,12,0.014921
DeadlySpacePotatoes,19,6,5,11,12,0.013325
Delanorix,55,26,11,37,12,0.047688
Domiiniick,12,8,2,10,13,0.023894
Done327,16,10,2,12,13,0.042093
Dr_CleanBones,49,19,17,36,11,0.032796
Flor1daman08,138,30,35,65,11,0.048434
FreeStall42,53,16,18,34,12,0.051084
FreedomPocket,12,3,3,6,12,0.012667
Funklestein,70,24,13,37,12,0.068586
GabuEx,17,11,3,14,12,0.021485
GitmoGrrl1,12,2,4,6,13,0.010605
Grumblepugs2000,16,4,2,6,13,0.011511
GuyInAChair,57,17,14,31,12,0.056577
Ill_Decision2729,26,13,9,22,11,0.057945
Inevitable-Ad-9570,16,3,3,6,13,0.011431
InquiringAmerican,10,5,1,6,13,0.01579
ItsMichaelScott25,27,10,9,19,12,0.0546
Jake0024,79,17,15,32,11,0.01268
Kevin-W,47,14,17,31,12,0.054736
KevinCarbonara,53,18,17,35,12,0.05395
Kuramhan,64,37,26,63,11,0.084501
Leopold_Darkworth,24,17,13,30,12,0.043813
LifeScientist123,10,4,4,8,13,0.013896
LolaSupreme19,22,4,1,5,13,0.025085
Mishigots,11,2,1,3,12,0.014777
Mjolnir2000,16,14,6,20,12,0.047493
Mrgoodtrips64,34,17,13,30,12,0.054964
Mztmarie93,42,16,23,39,11,0.038918
New_Seaweed_6554,18,9,5,14,12,0.041686
NoAttitude1000,81,15,15,30,11,0.044724
Ok_Juice4449,11,4,4,8,12,0.024241
Optimal_Let7233,17,4,5,9,13,0.011246
Petrichordates,98,46,34,80,12,0.068853
PinchesTheCrab,22,8,10,18,12,0.052672
PoliticalJunkDrawer,14,10,4,14,12,0.015818
Positronic_Matrix,10,7,4,11,13,0.024923
Rhoubbhe,20,7,5,12,12,0.049735
Robot_Alchemist,25,7,8,15,12,0.012091
Savethecannolis,23,7,12,19,12,0.041717
SchuminWeb,32,11,14,25,12,0.046861
SparksFly55,72,37,29,66,12,0.052905
StromburgBlackrune,16,8,2,10,12,0.027205
Successful-Extent-22,29,6,11,17,12,0.025803
Tadpoleonicwars,39,6,6,12,11,0.014152
TheBigGoat44,17,9,6,15,13,0.017419
TheGOPisTheDeepState,10,4,1,5,13,0.01482
TheMadTemplar,10,6,4,10,11,0.02744
TheZarkingPhoton,14,6,6,12,12,0.038668
The_Awful-Truth,26,10,70,80,12,0.026992
Utterlybored,31,16,9,25,12,0.048612
Weak-Elk4756,14,6,1,7,13,0.016442
Za_Lords_Guard,24,8,11,19,12,0.022982
akcrono,13,4,6,10,12,0.011531
alexmikli,10,6,8,14,13,0.023434
almightywhacko,33,18,5,23,13,0.067744
au-smurf,12,6,5,11,12,0.014819
ballmermurland,74,27,28,55,11,0.066963
billpalto,74,27,8,35,11,0.087575
burritoace,32,14,10,24,11,0.060213
candre23,47,19,12,31,11,0.058449
cat_of_danzig,21,8,4,12,13,0.012071
che-che-chester,17,6,6,12,13,0.020934
chiclets5,15,3,2,5,13,0.0274
clarkision,12,4,2,6,12,0.025371
clintCamp,20,11,8,19,12,0.053512
coskibum002,48,18,14,32,11,0.060175
daniel_smith_555,29,9,5,14,13,0.046898
dravik,21,15,7,22,12,0.030779
eh_steve_420,66,17,29,46,11,0.054707
ewokninja123,25,7,6,13,13,0.02409
foul_ol_ron,14,8,5,13,13,0.027273
frostyflakes1,10,4,3,7,13,0.03431
getawarrantfedboi,23,14,8,22,12,0.044082
gonz4dieg,18,13,8,21,12,0.040217
hairybeasty,13,4,0,4,0,0.037748
harrumphstan,31,15,11,26,11,0.040635
hereiswhatisay,14,3,2,5,13,0.036012
hryipcdxeoyqufcc,14,4,4,8,12,0.013413
j_ly,13,6,8,14,11,0.019738
jmac31793,13,7,4,11,12,0.023482
lionhearted318,35,18,10,28,12,0.02213
mia_elora,13,4,3,7,13,0.028354
mleibowitz97,10,7,4,11,12,0.017972
mosesoperandi,20,7,6,13,12,0.024978
navkat,19,7,7,14,13,0.03689
notpoleonbonaparte,15,7,4,11,13,0.016228
novagenesis,60,17,17,34,12,0.03236
o-Valar-Morghulis-o,11,3,5,8,12,0.022328
pgriss,20,15,10,25,11,0.040061
pomod,27,12,7,19,11,0.03311
punktualPorcupine,13,7,5,12,12,0.025559
reaper527,26,5,2,7,13,0.045102
repeatoffender123456,37,15,10,25,12,0.032614
slayer_of_idiots,113,37,16,53,12,0.048032
some1saveusnow,18,10,9,19,12,0.044494
spacegamer2000,13,6,2,8,13,0.01714
stoneimp,18,10,8,18,11,0.012413
swagonflyyyy,47,19,13,32,11,0.061067
thatthatguy,15,5,0,5,0,0.015043
thewoodsiswatching,13,7,3,10,13,0.019109
unknownpoltroon,19,13,9,22,12,0.038849
willowdove01,10,2,1,3,14,0.010618
wip30ut,18,7,7,14,12,0.038303
zackks,10,4,4,8,13,0.031731
zaoldyeck,178,56,51,107,12,0.074283
Boring_Clothes5233,16,6,11,17,12,0.002552
AldousKing,15,7,1,8,14,0.002126
BaronNahNah,17,4,0,4,0,0.001053
PushPopNostalgia,27,5,4,9,13,0.000402
Rhundan,190,41,11,52,12,0.005492
TheVioletBarry,77,8,3,11,12,0.001633
badass_panda,46,10,5,15,13,0.00202
homomorphisme,22,6,1,7,13,0.001079
scarab456,35,3,1,4,14,0.00014
Business-Stretch2208,21,6,18,24,12,0.000712
3superfrank,38,13,6,19,12,0.004364
Amazing_Might_9280,21,5,6,11,12,0.00026
BackpackJack_,10,5,0,5,0,0.000304
Finch20,16,5,0,5,0,0.000672
Fondacey,30,7,3,10,12,0.000618
KokonutMonkey,28,5,0,5,0,0.00073
Murky-Magician9475,117,21,20,41,11,0.002684
ProDavid_,277,45,24,69,11,0.004768
Rabbid0Luigi,22,5,19,24,12,0.000479
SANcapITY,58,14,6,20,12,0.001323
ZizzianYouthMinister,37,7,1,8,13,0.001413
Canuck_Voyageur,30,3,5,8,14,0.000488
21-characters,71,4,10,14,13,0.000306
GregHullender,11,2,0,2,0,0.000358
Pongpianskul,43,11,2,13,13,0.001478
SendMeYourDPics,31,2,0,2,0,0.000127
Capable-Art-1972,21,3,60,63,11,0.000305
Accomplished-Plan191,11,2,2,4,12,0.000286
Alesus2-0,35,16,4,20,12,0.001264
BloodyPaintress,12,6,7,13,11,0.000925
Clear_Newspaper4052,11,1,1,2,15,0.000273
EdelgardSexHaver,39,11,9,20,12,0.002293
Evening_Spot_5151,23,10,6,16,12,0.000699
ExpiredPleaseUpdate,17,3,3,6,13,0.000435
Gremlin95x,18,10,4,14,12,0.003638
HadeanBlands,231,40,32,72,11,0.005574
Imadevilsadvocater,224,57,57,114,11,0.026907
KrabbyMccrab,21,7,4,11,12,0.001962
LouisWillis98,11,3,2,5,13,0.000857
Lylieth,104,25,11,36,12,0.002479
MaximumOk569,21,9,6,15,12,0.002835
Molenium,10,2,3,5,11,0.000403
Munchkin_of_Pern,16,7,6,13,11,0.000824
NeoLeonn3,13,4,2,6,12,0.000369
NoWin3930,23,4,1,5,13,0.000647
Ok_Cup_5454,25,9,7,16,12,0.00831
Puzzleheaded-Bat-511,37,8,6,14,11,0.000864
Rainbwned,141,31,12,43,12,0.00459
Raise_A_Thoth,28,11,8,19,13,0.001662
Rakkis157,35,5,4,9,13,0.000416
Recent_Weather2228,13,5,1,6,13,0.002243
RickRussellTX,45,6,4,10,13,0.001133
Sigmatronic,12,2,1,3,14,0.000278
TheWhistleThistle,57,10,4,14,12,0.003671
ThirteenOnline,38,15,5,20,12,0.003614
Thoth_the_5th_of_Tho,57,32,17,49,11,0.006197
Toverhead,83,29,11,40,12,0.008724
UnicornForeverK,12,4,2,6,12,0.000508
VegetableBuilding330,11,4,2,6,12,0.000519
jatjqtjat,88,12,6,18,12,0.003858
jayeffkay,28,5,4,9,13,0.000349
laz1b01,12,5,1,6,13,0.000535
lee1026,118,28,23,51,12,0.011996
m_abdeen,10,4,3,7,12,0.001063
maximumhippo,11,2,1,3,14,0.000307
motherthrowee,26,6,1,7,12,0.000731
nuggets256,22,4,2,6,13,0.000832
stevie-antelope,32,8,6,14,13,0.001531
strikerdude10,23,7,2,9,12,0.002137
tbdabbholm,11,4,1,5,13,0.000415
theAltRightCornholio,27,9,9,18,11,0.017118
themcos,72,17,7,24,12,0.004108
viaJormungandr,24,11,4,15,11,0.002193
CptPatches,21,4,11,15,12,0.032577
Matt2_ASC,44,12,23,35,11,0.040897
MonarchLawyer,17,10,3,13,13,0.014717
See-A-Moose,12,8,3,11,13,0.020625
CrazyCoKids,17,1,41,42,10,0.000123
Constellation-88,61,10,11,21,10,0.003221
Greedy-Win-4880,30,5,3,8,13,0.000283
Helpful_Loss_3739,18,3,13,16,12,0.000258
Intelligent-Cow-7122,27,2,2,4,13,0.000258
Jakyland,23,5,1,6,12,0.000531
MarxCosmo,23,10,9,19,12,0.000942
MaxTheCookie,10,2,1,3,13,0.000284
ObsessedKilljoy,50,11,41,52,10,0.000887
Robie_John,32,7,8,15,13,0.001655
Tangentkoala,13,4,2,6,12,0.002358
TheTyger,37,11,10,21,11,0.002634
TomCormack,23,6,2,8,12,0.000388
hacksoncode,87,21,13,34,12,0.004322
helemaal,17,8,6,14,12,0.001258
jawrsh21,12,2,2,4,14,0.000564
juliacar,23,6,0,6,0,0.000863
knightress_oxhide,10,2,3,5,11,0.000282
majesticSkyZombie,111,24,21,45,12,0.002448
potatolover83,17,2,0,2,0,0.000373
rolyfuckingdiscopoly,16,6,2,8,13,0.000626
talashrrg,11,6,1,7,14,0.001186
tsisdead,17,6,7,13,13,0.000674
vettewiz,61,17,12,29,11,0.002929
weedywet,18,8,2,10,13,0.002975
xChops,14,9,1,10,13,0.001013
yankeeboy1865,13,4,2,6,13,0.001378
yogfthagen,15,7,3,10,12,0.003456
CurdKin,47,14,140,154,11,0.002941
-Ch4s3-,68,15,13,28,12,0.002331
33ITM420,30,6,2,8,13,0.005389
Able_Enthusiasm2729,19,4,7,11,12,0.002252
AdFun5641,19,9,2,11,12,0.003059
Agreetedboat123,61,16,19,35,12,0.003118
Altruistwhite,11,3,6,9,12,0.000762
BigDaddyDumperSquad,13,5,5,10,13,0.000934
BoyHytrek,23,8,7,15,12,0.001212
BurningEmbers978,39,8,7,15,13,0.003119
CMRSCptn,11,7,3,10,12,0.002085
Changer_of_Names,10,7,2,9,12,0.002025
CleverJames3,25,9,5,14,11,0.002969
CunnyWizard,62,14,9,23,11,0.007528
DMTwolf,17,6,3,9,13,0.00215
DaddyRocka,21,8,10,18,12,0.00243
Dependent-Tailor7366,10,4,3,7,12,0.001021
DevelopmentSad2303,14,6,4,10,11,0.002405
Doub13D,118,26,21,47,11,0.003482
DrRealName,19,6,3,9,12,0.003152
Dry-Tough-3099,43,10,5,15,12,0.003221
Eat--The--Rich--,13,6,2,8,12,0.002198
Emergency-Style7392,27,6,8,14,12,0.002381
Entire-Ratio-9681,11,3,0,3,0,0.001916
Exact-Joke-2562,21,7,5,12,12,0.00119
EyePharTed_,30,9,9,18,12,0.003005
Far_Mistake9314,12,5,3,8,13,0.001542
Financial_Shame4902,14,6,0,6,0,0.004118
FlounderCautious4523,12,11,2,13,13,0.001362
Full-Professional246,175,50,43,93,12,0.009459
FurryYokel,15,8,7,15,12,0.00464
GenghisKhandybar,12,5,5,10,11,0.0069
Green__lightning,75,28,9,37,12,0.00742
Here4Pornnnnn,48,10,6,16,12,0.002702
HereForTheBoos1013,15,8,7,15,11,0.004555
HeyYoisTaken,20,4,2,6,13,0.001085
ILikeToJustReadHere,21,3,2,5,12,0.000941
Icy-Exits,14,4,4,8,12,0.000892
ImmodestPolitician,16,6,6,12,12,0.002036
Internal_Kale1923,18,5,3,8,12,0.00462
ItsGrum14,29,12,10,22,12,0.001859
Jscapistm,15,6,6,12,12,0.001112
Kakamile,107,34,21,55,11,0.007311
KathrynBooks,19,4,2,6,12,0.000769
Kijafa,35,21,9,30,12,0.002697
KlausVonChiliPowder,31,18,10,28,12,0.001708
Korimito,38,3,4,7,12,0.001087
Kristoveles,18,5,3,8,13,0.001528
LivingGhost371,15,21,5,26,12,0.002429
MyNameIsNotKyle,29,12,5,17,13,0.002647
New_General3939,56,17,52,69,12,0.003772
No-Perspective3453,24,4,1,5,13,0.003581
NysemePtem,14,10,8,18,12,0.002396
Ok-External6314,18,7,4,11,12,0.003553
One-Independent8303,81,16,9,25,11,0.003077
Orphan_Guy_Incognito,69,23,23,46,11,0.011312
Perdendosi,12,7,1,8,12,0.001034
PinGroundbreaking754,11,2,1,3,14,0.000759
PirateMean4420,13,4,1,5,13,0.002437
Popular-Formal-7971,68,18,14,32,12,0.002841
PuzzleheadedShoe5829,11,2,175,177,10,0.000786
Randomousity,72,18,24,42,12,0.001873
Shadruh,22,14,7,21,12,0.001821
SilenceDobad76,10,8,4,12,11,0.00392
Solnx,22,7,4,11,12,0.001516
Speedy89t,17,3,2,5,13,0.002325
Square-Dragonfruit76,47,15,26,41,12,0.002714
StopElectingWealthy,17,7,6,13,11,0.001706
Successful-Daikon777,13,6,4,10,13,0.002568
Thatsthepoint2,10,3,0,3,0,0.003031
The_Itsy_BitsySpider,37,16,10,26,12,0.002218
Think_Clearly_Quick,13,7,4,11,13,0.002287
VegetableComplex5213,20,3,3,6,12,0.000784
Warny55,63,19,15,34,12,0.002806
WeekendThief,13,2,1,3,14,0.000773
Zestyclose_Peanut_76,34,12,6,18,13,0.003274
alfredo094,21,8,9,17,12,0.00206
anewleaf1234,283,44,34,78,11,0.011861
camilo16,12,4,5,9,11,0.000864
cferg296,36,15,7,22,12,0.001758
fossil_freak68,107,18,15,33,12,0.001253
galaxyapp,10,4,1,5,13,0.002215
generallydisagree,53,27,16,43,12,0.005841
ghjm,16,2,2,4,13,0.000779
grayscale001,35,8,6,14,12,0.002748
iamintheforest,73,21,8,29,11,0.002522
iryanct7,51,34,16,50,11,0.008716
issuefree,68,10,18,28,12,0.002124
jaundiced_baboon,12,5,1,6,14,0.002186
joshdrumsforfun,24,6,8,14,12,0.001514
kingofcrosses,13,5,2,7,13,0.001367
koolaid-girl-40,45,9,5,14,13,0.002844
other_view12,26,7,6,13,13,0.003409
raven19528,12,3,1,4,13,0.001958
reefersutherland91,12,8,5,13,12,0.004357
richqb,11,5,4,9,13,0.001744
rickbubs,11,5,2,7,13,0.001697
sanguinemathghamhain,27,7,6,13,12,0.003087
santathecruz,13,2,3,5,12,0.000829
shadofx,18,5,2,7,13,0.002021
slowowl1984,20,4,0,4,0,0.003799
toolateforfate,10,5,2,7,13,0.002149
trevor32192,97,22,17,39,11,0.005049
ttw81,13,4,3,7,12,0.002016
unscanable,59,20,18,38,12,0.003084
ute-ensil,13,3,1,4,13,0.000773
whiskey_piker,14,4,2,6,13,0.001517
wibbly-water,38,9,5,14,12,0.001157
Dare_Ask_67,18,4,47,51,11,0.000171
AleristheSeeker,48,10,7,17,12,0.001358
Anti_colonialist,14,6,3,9,13,0.002914
Cacafuego,13,5,2,7,13,0.000999
CaptainONaps,22,2,1,3,14,0.000232
Destinyciello,253,52,49,101,12,0.005311
EmotionalSize5586,54,12,10,22,12,0.000706
EmptyDrawer2023,35,14,7,21,12,0.003241
Forsaken-House8685,75,27,14,41,12,0.021266
JuicingPickle,40,15,125,140,10,0.015465
MaloortCloud,15,5,0,5,0,0.001357
MelodiusRA,44,8,3,11,12,0.000415
Monte_Cristos_Count,24,3,1,4,13,0.001386
MrGraeme,22,5,4,9,11,0.00207
Natural-Arugula,51,17,14,31,11,0.002829
NoTomato7740,36,13,6,19,13,0.003019
No_Material7583,10,2,0,2,0,0.000858
NotMyBestMistake,71,23,10,33,12,0.004209
ScrupulousArmadillo,22,8,3,11,13,0.000385
Teddy_The_Bear_,43,12,7,19,12,0.001613
Throwaway7131923,10,5,32,37,11,0.000632
VortexMagus,17,5,1,6,13,0.001683
YossarianWWII,14,3,0,3,0,0.000689
abacuz4,42,11,14,25,12,0.003811
addictedtolife78,22,7,5,12,12,0.000953
deck_hand,15,7,2,9,13,0.002357
huntsville_nerd,27,7,5,12,11,0.002203
jweezy2045,239,29,25,54,11,0.000948
shouldco,55,12,15,27,11,0.002883
skdeelk,22,6,2,8,12,0.001012
DeathStrike56,15,4,11,15,12,0.001595
Agitated-Quit-6148,33,7,9,16,11,0.000177
AluminiumLlama,21,6,4,10,12,0.000486
NegevThunderstorm,23,6,1,7,14,0.002546
No-Dinner-5894,32,4,2,6,13,0.001737
ObsidianKing,16,2,2,4,13,0.000081
True_Ad_3796,12,5,2,7,12,0.001214
Tuvinator,16,3,5,8,11,0.000207
Desperate-Fan695,26,11,25,36,12,0.000825
AgitatedBadger,15,3,3,6,12,0.000116
Arthesia,15,11,2,13,13,0.002864
CartographerKey4618,80,27,21,48,12,0.003959
Gatonom,37,7,3,10,13,0.001721
Hellioning,54,13,0,13,0,0.002675
Past-Winner-9226,23,5,2,7,13,0.000418
VforVenndiagram_,11,5,1,6,13,0.000694
WinDoeLickr,28,8,6,14,12,0.001099
YardageSardage,48,6,2,8,12,0.001456
dejamintwo,17,4,35,39,11,0.000545
eggs-benedryl,27,4,1,5,13,0.000123
funglegunk,20,6,4,10,12,0.000177
Downtown-Act-590,31,18,26,44,11,0.00223
EH1987,34,9,5,14,12,0.002743
HeroBrine0907,19,5,23,28,11,0.00032
Huge-Nerve7518,21,4,3,7,12,0.001847
Km15u,31,5,3,8,12,0.000624
Low_Imagination_1224,12,2,14,16,12,0.000153
Mcwedlav,26,8,2,10,14,0.001906
MediumAids,58,9,7,16,12,0.002715
Pizzaflyinggirl2,11,2,2,4,12,0.000153
Puresuner,29,7,6,13,12,0.000544
RevolutionaryGur4419,160,28,28,56,12,0.010627
Technical-King-1412,36,16,6,22,12,0.002676
TurbulentArcher1253,120,16,15,31,12,0.002726
help_abalone,33,8,1,9,11,0.021658
kinrove1386,306,56,51,107,11,0.005462
DowntownManThrow,44,9,52,61,12,0.000946
Advanced-Ad6210,21,2,0,2,0,0.000313
Aggravating_Lemon631,10,3,0,3,0,0.00141
Argo505,39,2,0,2,0,0.000305
AspirationAtWork,72,10,9,19,13,0.00365
Birb-Brain-Syn,26,13,4,17,12,0.00142
Elegant-Pie6486,26,4,2,6,12,0.000497
Fun_Squirrel_9539,11,2,0,2,0,0.000484
Jakobites,17,5,2,7,12,0.000812
Kotoperek,35,18,9,27,12,0.00287
LookWhatlCanDo,32,3,2,5,13,0.000409
Relevant_Actuary2205,76,19,10,29,12,0.001837
Rude_Lengthiness_101,20,6,7,13,12,0.000497
aardvark_gnat,72,18,61,79,11,0.001264
bettercaust,92,26,27,53,12,0.003654
dukeimre,26,10,6,16,12,0.001755
duskfinger67,36,12,5,17,12,0.001108
fascistp0tato,28,4,24,28,12,0.000526
frickle_frickle,28,7,6,13,12,0.002663
fuckounknown,20,5,10,15,12,0.000479
heidismiles,33,13,6,19,12,0.001285
rightful_vagabond,29,4,2,6,12,0.000885
sxaez,22,5,1,6,13,0.00049
vote4bort,78,10,6,16,12,0.00093
vuzz33,37,3,2,5,13,0.000465
Embarrassed-Dress211,11,2,55,57,12,0.000042
Ace0spades808,21,8,5,13,12,0.000668
AdHopeful3801,23,4,4,8,12,0.000493
Affectionate-War7655,27,5,4,9,12,0.001604
Al-Rediph,13,5,1,6,1,0.000255
Antique-Ad-9081,13,5,4,9,12,0.001366
Arstanishe,28,17,10,27,12,0.002838
CallMeCorona1,35,8,4,12,12,0.000824
CocoSavege,57,18,14,32,11,0.002762
HazyAttorney,75,20,15,35,12,0.003343
LordSwedish,11,7,4,11,13,0.000489
MagicalMonarchOfMo,10,2,1,3,1,0.000175
MennionSaysSo,21,13,4,17,12,0.005793
Mrs_Crii,48,14,12,26,12,0.008264
Owlblocks,21,4,3,7,13,0.001545
Particular-Way-8669,13,4,4,8,12,0.000463
Personal-Advance-494,20,6,5,11,12,0.00051
RemoteCompetitive688,51,12,6,18,12,0.003421
SatisfactoryLoaf,10,2,0,2,0,0.00025
Spirited-Awareness31,11,3,1,4,14,0.000186
Stereo_Jungle_Child,41,24,5,29,12,0.004193
SwagginOnADragon69,23,9,5,14,12,0.002563
Teleporting-Cat,13,5,6,11,12,0.000256
The-_Captain,15,13,84,97,11,0.001725
_Richter_Belmont_,35,19,4,23,12,0.001309
chaucer345,19,2,189,191,11,0.000182
fox-mcleod,93,26,24,50,11,0.010378
garnet420,21,9,4,13,11,0.000738
ja_dubs,14,8,8,16,12,0.001922
libra00,50,8,7,15,12,0.001963
mishaxz,38,6,2,8,13,0.000785
parsonsrazersupport,25,8,8,16,12,0.000668
rustyseapants,13,5,1,6,13,0.002103
slypool,10,5,4,9,12,0.000912
stereofailure,16,4,4,8,13,0.000689
Even-Ad-9930,16,2,119,121,11,0.000146
--o,31,6,10,16,12,0.001035
10ebbor10,34,11,8,19,11,0.00368
4art4,29,26,10,36,12,0.002585
AcceptablePea262,54,14,9,23,12,0.004042
Accomplished_Tour481,29,9,6,15,12,0.016983
Admirable-Lecture255,11,5,4,9,12,0.003537
Alive-Necessary2119,62,13,12,25,12,0.002945
Angsty-Panda,22,4,5,9,12,0.001131
ApeAF,11,8,4,12,11,0.007857
ArCSelkie37,10,7,5,12,13,0.002001
Baby_Needles,35,13,15,28,12,0.02589
BaguetteFetish,33,17,16,33,12,0.002639
BillionaireBuster93,54,14,29,43,12,0.004165
Brilliant-Lab546,25,12,8,20,13,0.002186
CallItDanzig,28,8,10,18,12,0.002688
CaptCynicalPants,93,44,20,64,11,0.006143
CaptainMalForever,21,5,2,7,13,0.001671
Choperello,30,7,5,12,12,0.001411
Classic_Season4033,12,2,1,3,1,0.000844
CnC-223,54,14,8,22,12,0.004901
Deep-Two7452,17,6,5,11,11,0.001508
Diligent_Pie317,11,8,4,12,12,0.001403
DoeCommaJohn,33,36,6,42,13,0.00537
Extinction00,12,4,3,7,12,0.000869
FatnessEverdeen34,10,2,2,4,13,0.000757
FuckItImVanilla,16,3,3,6,13,0.000771
Hatta00,11,6,4,10,13,0.001475
HugsForUpvotes,23,8,6,14,13,0.002703
HumanDissentipede,16,3,4,7,12,0.000846
I_am_the_Jukebox,64,19,19,38,12,0.003774
Insectshelf3,42,17,14,31,11,0.005939
Jaysank,13,9,0,9,0,0.001981
Leather_Preference67,13,6,5,11,12,0.001834
Maximum_Error3083,20,5,2,7,12,0.001322
Next_Yesterday5931,14,5,1,6,13,0.002437
Obi-Brawn-Kenobi,11,4,4,8,13,0.001483
Past-Community-3871,10,6,2,8,13,0.001584
Planterizer,16,3,4,7,12,0.00093
Pristine_Club_3128,64,13,10,23,12,0.002205
Real-Telephone4077,33,12,5,17,13,0.00451
Rehcamretsnef,18,6,1,7,13,0.004764
RetreadRoadRocket,31,5,3,8,12,0.003418
Reynor247,10,5,1,6,12,0.00229
SLAMMERisONLINE,16,4,3,7,13,0.000798
Sayakai,27,7,5,12,12,0.001679
Sea-Storm375,11,4,2,6,12,0.001015
Several_Leather_9500,10,5,3,8,13,0.001815
SingleMaltMouthwash,28,7,6,13,12,0.004509
Soft_Accountant_7062,83,16,14,30,11,0.004202
Successful-Shopping8,39,5,3,8,12,0.001261
Suitable-Activity-27,22,6,3,9,13,0.000911
TheDrakkar12,19,9,103,112,11,0.001497
The_World_May_Never,46,15,11,26,11,0.001954
ThisOneForMee,14,2,1,3,13,0.000745
X-calibreX,39,8,8,16,12,0.00354
abstractengineer2000,37,8,11,19,12,0.003951
amonkus,13,5,3,8,13,0.002104
badlyagingmillenial,13,2,0,2,0,0.000736
cairnrock1,23,5,5,10,13,0.000831
climbstuff32,13,4,2,6,12,0.000824
dommmm9,11,2,1,3,13,0.000743
fingerchopper,10,4,3,7,13,0.001105
imoutofnames90,11,2,1,3,12,0.000746
jwrig,54,22,12,34,12,0.003764
mormagils,48,17,10,27,12,0.025989
muyamable,16,13,3,16,13,0.002232
neotericnewt,67,17,17,34,11,0.00479
newshirtworthy,11,2,2,4,12,0.000736
permanentimagination,13,2,1,3,14,0.000747
raouldukeesq,29,12,8,20,12,0.00513
tbombs23,13,3,3,6,13,0.001903
xxconkriete,27,11,9,20,12,0.003425
FairDinkumMate,13,7,99,106,11,0.000805
11grim,18,6,3,9,12,0.00312
AnimatorDifficult429,16,3,1,4,13,0.000647
AnxiousChaosUnicorn,23,8,9,17,11,0.002098
Arnaldo1993,27,5,2,7,13,0.001076
AtmosphericReverbMan,44,13,16,29,13,0.003312
BoogerMagnolia,21,5,6,11,12,0.000845
CEO-Soul-Collector,16,7,5,12,13,0.002531
CalLaw2023,86,15,12,27,12,0.005477
ChickerWings,26,10,4,14,12,0.003562
Chocotacoturtle,21,7,5,12,12,0.013866
CodWonderful2045,15,2,0,2,0,0.001349
Colluder,18,5,7,12,13,0.002624
Dave_A480,23,3,1,4,13,0.000651
DisgruntledWarrior,13,2,1,3,12,0.000668
EksDee098,28,6,8,14,11,0.001004
Emotional-Tailor-649,16,5,4,9,12,0.001564
Former_Star1081,22,8,5,13,12,0.00429
FrgTurdeson,65,9,13,22,12,0.002587
Frylock304,48,13,26,39,12,0.002462
Gexm13,23,9,9,18,12,0.001562
GiveMeBackMySoup,30,16,10,26,11,0.005151
Guldur,13,3,1,4,12,0.001998
ImReverse_Giraffe,33,11,10,21,13,0.002215
JohnWittieless,21,10,5,15,12,0.002186
Lagkiller,36,4,5,9,13,0.00094
Lost-Letterhead-6615,12,2,3,5,12,0.001186
Majestic_Horse_1678,12,4,2,6,12,0.001886
Message_10,18,8,4,12,12,0.001045
Obvious_Chapter2082,49,19,12,31,12,0.014816
Olderscout77,28,6,6,12,12,0.022648
PineBNorth85,17,9,9,18,13,0.002297
Pockydo,11,3,2,5,13,0.000795
PrimaryInjurious,81,43,24,67,12,0.00829
Rationally-Skeptical,30,10,5,15,12,0.000697
RequirementRoyal8666,26,11,6,17,12,0.005136
Rusty-Shackleford000,69,13,12,25,12,0.003097
South-Rabbit-4064,45,8,5,13,12,0.018608
Super_Mario_Luigi,18,11,4,15,12,0.005776
T2Drink,11,3,3,6,11,0.000935
ThatOneAttorney,12,6,1,7,13,0.002507
ThatOtherGuyTPM,51,12,14,26,11,0.010233
Thuis001,36,10,8,18,12,0.001371
Writing_is_Bleeding,20,4,8,12,12,0.000728
YouLearnedNothing,47,21,16,37,12,0.004871
ZappSmithBrannigan,31,10,7,17,12,0.003041
Zauberer-IMDB,14,5,4,9,12,0.001195
alaskanperson,21,7,4,11,12,0.002857
atred,25,8,6,14,12,0.005114
captainhukk,19,7,6,13,12,0.002475
deadpool_pewpew,14,4,2,6,12,0.001703
dr_pepper_35,10,7,2,9,13,0.001443
ecafyelims,27,9,5,14,12,0.001569
insaneHoshi,38,11,12,23,12,0.003966
kkdawg22,21,7,6,13,12,0.001914
lordtrickster,17,4,4,8,11,0.002268
mapadofu,21,6,2,8,12,0.002456
mikeber55,15,7,4,11,12,0.006283
mormonatheist21,15,2,1,3,12,0.000649
ranchojasper,15,6,6,12,12,0.004695
revertbritestoan,85,13,14,27,12,0.002134
rollem,22,15,6,21,11,0.007608
sourcreamus,31,7,4,11,12,0.002023
wydileie,39,11,9,20,12,0.003998
Fando1234,10,4,10,14,12,0.000606
No-Mushroom5934,10,4,0,4,0,0.000291
Royal_Negotiation_91,67,23,11,34,12,0.004407
Fickle-Syllabub6730,12,0,15,15,12,0
Anomander,138,20,12,32,13,0.002117
Fauropitotto,54,11,9,20,13,0.000424
InfernalOrgasm,158,19,20,39,12,0.001818
RottenMilquetoast,13,4,0,4,0,0.000549
Treethorn_Yelm,20,4,0,4,0,0.000326
bi_polar2bear,19,4,1,5,14,0.000391
cornholio8675,10,2,1,3,13,0.000197
countrykev,39,14,11,25,12,0.04312
kerouak,12,3,1,4,14,0.000351
lnkprk114,11,6,6,12,12,0.004946
FishFollower74,13,3,9,12,12,0.000178
Impressive-Floor-700,32,5,4,9,14,0.000229
NightflowerFade,10,4,3,7,13,0.026109
amiibohunter2015,11,3,1,4,14,0.021849
checker280,78,23,18,41,11,0.023595
dannypdanger,11,2,2,4,13,0.000477
tehzayay,11,2,1,3,14,0.000206
FlanneryODostoevsky,38,7,247,254,10,0.014799
00zau,13,9,5,14,12,0.001864
4bkillah,11,5,2,7,13,0.001655
Actual_Confusion7140,20,10,10,20,12,0.003346
Adventurous_Ad7442,14,4,4,8,12,0.001906
Alternative_Oil7733,30,7,7,14,12,0.002683
Analyst-Effective,10,3,0,3,0,0.003356
Angel1571,42,19,14,33,12,0.004187
Apprehensive_Song490,25,7,4,11,13,0.00202
Appropriate_Fly_6711,34,3,2,5,13,0.001605
Ayslyn72,18,3,2,5,12,0.001565
BahnMe,11,2,2,4,12,0.001714
Both-Structure-6786,14,9,0,9,0,0.004369
Bottlecapzombi,27,9,7,16,11,0.00297
Bourbon-Decay,20,10,8,18,12,0.02803
Classic-Obligation35,14,4,1,5,13,0.002381
CobraPuts,15,8,5,13,11,0.007918
CosmicLovepats,24,4,1,5,14,0.002931
CosmicSoulRadiation,14,5,2,7,12,0.003835
Darkagent1,23,7,6,13,12,0.002218
DeathMetal007,15,7,6,13,12,0.002312
Destroyer_2_2,47,12,12,24,12,0.002433
DungeonJailer,20,4,2,6,12,0.002897
EclipseNine,28,8,8,16,12,0.002123
Eden_Company,18,7,5,12,13,0.002352
ElATraino,14,2,2,4,13,0.001655
Evilsushione,25,9,10,19,12,0.002272
FetusDrive,59,12,12,24,12,0.003262
Few_Mistake4144,31,9,11,20,12,0.001986
GalaXion24,43,10,18,28,11,0.004586
Garganello,35,7,8,15,11,0.008219
Glorfendail,54,14,10,24,11,0.002518
GrowFreeFood,39,11,12,23,12,0.027528
Honeycrispcombe,21,9,6,15,12,0.002291
Hothera,26,7,5,12,13,0.003097
ImRightImRight,11,4,3,7,12,0.002343
JohnLockeNJ,28,6,3,9,12,0.003326
KaikoLeaflock,10,7,5,12,12,0.003628
Kerostasis,67,23,12,35,12,0.003855
Kr1spykreme_Mcdonald,14,3,1,4,13,0.002771
Large-Flamingo-5128,17,5,5,10,13,0.001656
Leon_Thomas,26,6,2,8,12,0.003395
ManufacturerVivid164,19,5,4,9,12,0.001718
MartyTax,12,2,1,3,1,0.001557
Maximumoverdrive76,31,8,8,16,12,0.002411
Me_U_Meanie,11,4,3,7,12,0.001583
MeowTheMixer,10,4,7,11,12,0.001621
NTXGBR,14,3,2,5,13,0.001652
NeuroticKnight,17,3,3,6,13,0.001634
No-Somewhere-7069,46,6,6,12,13,0.002013
Noctudeit,10,4,1,5,12,0.001796
Odeeum,15,2,5,7,12,0.001886
Ok-Condition-6932,22,4,3,7,12,0.001604
Ok_Swimming4427,24,6,3,9,12,0.002943
Ossevir,10,7,4,11,13,0.00266
Outcast129,19,7,7,14,12,0.003002
PaxNova,35,14,8,22,12,0.003912
PeteMichaud,17,5,1,6,13,0.00239
PopTough6317,27,10,6,16,12,0.002477
PreviousCurrentThing,53,24,27,51,11,0.012921
ProRuckus,71,13,5,18,12,0.004337
Pyrostemplar,11,3,2,5,13,0.002214
ReactionAble7945,77,10,6,16,13,0.002094
RedOceanofthewest,53,13,19,32,11,0.004728
Responsible_Dream282,18,6,5,11,12,0.002336
Rob__T,12,5,4,9,13,0.002801
Ruger1958,11,3,3,6,12,0.001913
Sartres_Roommate,15,6,2,8,14,0.003982
ScalesOfAnubis19,95,24,17,41,12,0.005117
Sea_Section_9861,12,4,0,4,0,0.002917
Sharkbait_ooohaha,23,6,5,11,12,0.003034
SmartYouth9886,23,2,1,3,14,0.0017
SnappyDresser212,15,4,6,10,12,0.002739
Some_Excitement1659,10,3,5,8,12,0.001599
SophonParticle,11,2,0,2,0,0.001852
Sovereign_Black,17,4,3,7,12,0.001617
Spaniardman40,17,5,1,6,13,0.00284
Stopper33,10,8,1,9,13,0.015951
TarumK,25,6,9,15,12,0.003218
Tea-Unlucky,10,9,5,14,13,0.002677
Tea_Time9665,24,3,4,7,12,0.001611
The-Gobba-Ghoul,19,2,5,7,13,0.002701
TheAzureMage,95,21,20,41,12,0.004239
TheRoadsMustRoll,14,2,2,4,13,0.001599
The_Bjorn_Ultimatum,19,7,3,10,13,0.001668
VassalforThy,11,3,1,4,14,0.001865
Wingerism014,16,3,3,6,12,0.001616
Xanith420,39,10,6,16,12,0.001854
airboRN_82,63,7,6,13,12,0.001801
aurora-s,18,4,2,6,13,0.001698
awfulcrowded117,15,5,2,7,14,0.003404
canned_spaghetti85,30,4,3,7,12,0.001912
colt707,17,7,2,9,14,0.003021
crashfrog05,111,26,13,39,12,0.003241
csopinion,10,3,30,33,12,0.002913
desgasser,10,3,1,4,11,0.002029
ethical_arsonist,34,7,3,10,13,0.002487
everydaywinner2,15,9,5,14,13,0.004937
ferdaw95,26,7,8,15,12,0.003226
goldenroman,10,5,4,9,12,0.002668
happyclam94,18,3,1,4,14,0.001559
iamcleek,20,12,2,14,13,0.00218
icecubtrays,13,4,2,6,13,0.002223
imthesqwid,16,6,1,7,12,0.002095
jayzfanacc,12,2,1,3,13,0.001574
jbruce72,12,2,3,5,11,0.001564
jeffwulf,26,4,10,14,12,0.012781
lastberserker,21,7,6,13,12,0.002062
mackinator3,33,16,11,27,11,0.003223
morganational,14,6,5,11,12,0.003335
natelion445,31,6,7,13,13,0.001882
ncolaros,13,5,6,11,12,0.003167
nicksey144,13,5,5,10,12,0.003005
nowthatswhat,30,7,6,13,13,0.002989
olcrazypete,10,6,2,8,12,0.014432
pawnman99,24,8,10,18,11,0.002718
pcgamernum1234,36,13,10,23,12,0.003646
pickleparty16,16,7,6,13,12,0.001859
plummbob,14,3,4,7,12,0.001599
psychosisnaut,17,5,6,11,12,0.003042
rdsuxiszdix,43,5,5,10,12,0.00171
rogun64,12,14,3,17,13,0.01519
s_wipe,35,8,4,12,13,0.001752
seanflyon,27,5,2,7,11,0.001907
seedoilbaths,63,14,114,128,11,0.018297
serene_brutality,21,6,2,8,14,0.002019
serravee,10,3,2,5,13,0.001609
sincsinckp,35,7,6,13,13,0.003273
spectrehauntingeuro,21,7,6,13,12,0.001866
taeerom,26,7,6,13,13,0.003424
tastefulmalesideboob,26,43,46,89,12,0.004349
troycalm,13,4,1,5,13,0.00285
uisce_beatha1,18,1,1,2,12,0.001556
unlimitedzen,18,6,11,17,12,0.001863
unordinarilyboring,31,8,4,12,13,0.004272
whipsmartmcoy,11,4,3,7,11,0.002049
woailyx,31,11,4,15,12,0.00307
xFblthpx,11,4,3,7,13,0.001832
y0da1927,26,6,7,13,12,0.001833
ForgetfullRelms,22,3,5,8,13,0.000169
Bastiat_sea,19,12,7,19,12,0.001899
CarsTrutherGuy,60,18,12,30,12,0.003471
Plastic-Abroc67a8282,18,3,5,8,12,0.001174
PretendAwareness9598,17,10,3,13,13,0.002998
RedMarsRepublic,40,10,5,15,12,0.000861
StopblamingTeachers,22,6,19,25,11,0.000549
cantantantelope,18,12,5,17,11,0.003144
FuturelessSociety,97,24,63,87,11,0.003564
AgreeableMagician893,31,6,3,9,12,0.000709
Big_oof_energy__,11,5,6,11,12,0.001616
Blairians,38,10,3,13,12,0.002052
FockerXC,15,5,7,12,11,0.000567
JSmith666,57,9,7,16,12,0.000725
JadedDruid,17,9,6,15,13,0.000974
Northern64,11,2,2,4,13,0.000334
Plus-Plan-3313,11,6,6,12,12,0.000973
QueensOfTheNoKnowAge,13,4,2,6,13,0.000366
Salanmander,12,3,3,6,13,0.000356
Theomach1,59,7,11,18,13,0.000676
Vesurel,26,6,1,7,14,0.001298
Warchief_Ripnugget,23,8,9,17,12,0.000987
couldbemage,41,11,19,30,12,0.001736
furtive_phrasing_,27,5,47,52,11,0.000519
justanotherdude68,10,9,2,11,14,0.001368
rainman943,13,5,3,8,12,0.00155
sawdeanz,29,7,2,9,11,0.002335
someofyourbeeswaxx,12,1,1,2,14,0.00033
torytho,29,7,0,7,0,0.005839
Goggio,60,8,25,33,12,0.002464
Big-Bodybuilder-5035,15,3,5,8,12,0.000141
ChirpyRaven,15,7,1,8,14,0.000397
Giblette101,95,23,32,55,12,0.002601
PM_ME_YOUR_NICE_EYES,93,23,6,29,12,0.005361
SmarterThanCornPop,44,13,7,20,12,0.003148
Thumatingra,122,57,13,70,12,0.006101
bshum95,18,2,1,3,14,0.000113
oremfrien,20,8,10,18,11,0.000167
Haleakala1998,19,3,48,51,12,0.000205
Alternative_Pin_7551,66,16,7,23,12,0.016817
Ancient_Confusion237,52,7,4,11,12,0.001211
CremasterReflex,21,6,4,10,12,0.000925
DebutsPal,48,8,7,15,12,0.000868
GotAJeepNeedAJeep,53,16,9,25,12,0.00095
Maestro_Primus,12,6,4,10,12,0.002046
Mysteriousdeer,16,5,5,10,12,0.000481
No_Initiative_1140,26,6,4,10,12,0.000876
Playful_Ad_6773,13,3,2,5,12,0.000458
SamCam9992,12,9,2,11,12,0.001126
WippitGuud,16,5,3,8,12,0.000671
XenoRyet,105,26,7,33,12,0.005366
Zncon,38,13,13,26,12,0.001328
darwin2500,28,4,5,9,12,0.000707
lordnacho666,22,8,6,14,12,0.001888
onepareil,12,7,7,14,13,0.000523
Healthy_Shine_8587,28,6,264,270,10,0.000433
90daysismytherapy,23,7,6,13,11,0.002213
A_Soporific,24,8,6,14,12,0.002095
Academic_Guitar7372,10,3,0,3,0,0.001198
Acrobatic-Brother232,15,5,3,8,13,0.001438
After_Lie_807,22,14,10,24,12,0.007049
AlternativeDue1958,32,6,5,11,12,0.001237
Anna-Politkovskaya,10,4,2,6,13,0.001245
Anomalous-Materials8,13,6,2,8,13,0.00195
Anonymous_1q,125,32,24,56,11,0.002588
Any-Wheel-9271,17,3,3,6,13,0.001558
Automatic_Tackle_406,27,10,11,21,11,0.001679
Awkward-Estate-9787,70,10,12,22,11,0.002859
BadBoiy33,41,4,3,7,13,0.001219
Beautiful-Climate776,12,2,4,6,12,0.001185
BeeLamb,13,3,3,6,12,0.001169
Bilabong127,13,7,3,10,11,0.001229
BoltThrower28,12,4,2,6,14,0.001902
Buttercups88,10,3,1,4,13,0.002099
CalTechie-55,16,4,2,6,13,0.004804
Candid_Beat8390,28,6,6,12,13,0.001304
ChocFarmer,11,3,1,4,13,0.001507
Commercial_Pie3307,20,7,6,13,12,0.001498
Corrupted_G_nome,53,19,8,27,12,0.002537
CreativeContract2170,20,7,3,10,12,0.002002
DC2LA_NYC,17,7,5,12,12,0.001489
Dark1000,15,6,4,10,11,0.026322
Dazzling_Occasion_47,10,5,2,7,13,0.001691
Doc_ET,25,13,12,25,12,0.001756
EconomistAromatic497,10,3,1,4,13,0.001846
EdliA,17,4,0,4,0,0.001361
Effective_Jury4363,25,12,10,22,12,0.003233
Every3Years,35,6,6,12,12,0.002151
Eyuplove_,49,9,8,17,12,0.001804
FartingKiwi,17,11,4,15,12,0.00282
Fifteen_inches,40,12,10,22,11,0.002925
FreeGazaToday,31,10,6,16,12,0.002169
GarryofRiverton,18,5,4,9,12,0.001399
General_Day_3931,11,2,2,4,12,0.001377
GreatWhiteSalmon,11,3,0,3,0,0.002139
Hatook123,24,15,8,23,13,0.002964
Hellion_444,13,4,5,9,13,0.001233
HungryDepth5918,47,4,2,6,14,0.001548
Ihsan2024,13,3,3,6,12,0.001385
ImNoLawyer,12,5,2,7,12,0.014098
Imaginary-Orchid552,42,21,18,39,12,0.005148
Important_Pattern_85,16,3,4,7,11,0.00119
Infinite_Wheel_8948,28,13,10,23,12,0.003112
Initial_Cellist9240,15,3,1,4,12,0.001461
IslandSoft6212,31,5,4,9,13,0.001305
January_In_Japan,10,4,1,5,13,0.00176
JawtisticShark,26,11,8,19,12,0.001886
Jealous_Tutor_5135,12,2,1,3,14,0.002243
Jew_of_house_Levi,31,7,6,13,13,0.001418
JoJoeyJoJo,58,10,14,24,12,0.001804
Josvan135,70,53,10,63,11,0.004704
Kingreaper,10,6,3,9,12,0.002298
Kman17,61,30,9,39,12,0.014236
Letshavemorefun,43,8,10,18,12,0.001482
Locrian6669,34,8,7,15,13,0.002063
LowRevolution6175,14,5,3,8,13,0.001336
MagnanimosDesolation,51,7,5,12,11,0.001264
Mazinderan,14,6,8,14,11,0.001804
McdoManaguer,13,4,2,6,11,0.001833
MercurianAspirations,18,10,2,12,13,0.001811
Mother_Sand_6336,36,8,8,16,12,0.003242
MyrddinTheKinkWizard,29,7,5,12,12,0.00278
Neither-Stage-238,11,6,4,10,11,0.001247
NotReadyForTomorrow,13,2,2,4,13,0.001163
Notachance326426,28,7,9,16,11,0.001354
OddCook4909,28,7,7,14,12,0.002029
Ok-Temporary-8243,24,3,4,7,12,0.001259
Ok_Stop7366,10,4,1,5,13,0.002084
Pale-Ad9012,10,3,29,32,11,0.001808
PapaverOneirium,53,22,22,44,12,0.003559
PassionGlobal,20,5,4,9,12,0.002148
Perfect_Security9685,55,7,12,19,11,0.001504
PerspectiveViews,30,11,9,20,12,0.001461
Playful_Programmer91,12,2,2,4,13,0.001165
PuckSenior,74,13,7,20,12,0.00493
RSmeep13,25,13,13,26,12,0.002114
RateEmpty6689,11,3,2,5,12,0.001263
ReOsIr10,32,8,4,12,13,0.001262
Relevant-Expert8740,10,3,2,5,12,0.001462
RiceGold3688,10,7,3,10,13,0.002117
Saargb,21,7,4,11,12,0.001255
SaucyWiggles,10,3,2,5,14,0.00118
Scumdog_312,10,7,8,15,13,0.001996
ShadowSniper69,15,2,1,3,13,0.001199
Skuggsja86,22,9,7,16,12,0.001702
Slackjawed_Horror,31,6,3,9,12,0.001245
Sloppykrab,14,9,5,14,12,0.002167
Slow-Seaweed-5232,12,7,3,10,12,0.002162
Socialimbad1991,24,8,6,14,11,0.007275
Square_Hat_3994,23,7,5,12,12,0.002565
Standard-Secret-4578,10,4,3,7,12,0.001958
Straight_Letter5819,10,4,5,9,12,0.00173
Sugarrrsnaps,12,3,2,5,13,0.001905
Suspicious-Raisin824,12,3,3,6,13,0.001899
Tanaka917,12,4,0,4,0,0.001228
Telaranrhioddreams,15,4,3,7,12,0.00154
Temporary-Truth2048,18,4,2,6,13,0.001373
TesalerOwner83,25,4,6,10,11,0.002022
The-Grand-Pepperoni,11,3,1,4,13,0.001181
TotaLibertarian,24,8,5,13,12,0.002699
True_Fill9440,10,2,3,5,13,0.001161
UsualPreparation180,10,3,2,5,12,0.003455
Vedic70,30,6,5,11,13,0.00144
Vikings_Pain,10,2,1,3,13,0.001175
Visible_Device7187,16,2,5,7,12,0.001178
Warm_Shoulder3606,10,5,1,6,14,0.001575
WillCode4Cats,12,3,5,8,12,0.001289
WlmWilberforce,11,7,6,13,12,0.002139
Worried4lot,12,3,2,5,13,0.001626
WreckinRich,32,7,6,13,12,0.002216
Wrld-Competitive,10,2,2,4,13,0.001174
Xolver,10,3,2,5,13,0.001201
aasfourasfar,12,2,1,3,14,0.001505
abn1304,21,7,3,10,13,0.001681
aguafiestas,13,3,2,5,14,0.001164
aspiringimmortal,53,7,41,48,11,0.001529
axp187,22,5,3,8,11,0.001496
bfg-best-fried-gandu,14,3,2,5,12,0.001371
bigbadaboomx,51,7,5,12,12,0.001391
bleahdeebleah,18,6,8,14,11,0.007266
bugsmaru,13,12,5,17,13,0.001862
cindad83,12,4,6,10,12,0.001628
comment_i_had_to,29,7,5,12,13,0.001392
daoistic,26,9,7,16,12,0.001747
eldankus,16,4,5,9,12,0.00138
enlightenedDiMeS,13,3,52,55,12,0.001391
eteran,38,7,5,12,12,0.002069
harambeLover_69,12,2,1,3,13,0.001794
iAmBalfrog,10,3,1,4,14,0.001884
josh145b,68,16,16,32,12,0.003676
kvakerok_v2,12,5,2,7,13,0.002428
kwamzilla,36,12,8,20,12,0.003093
lalahair,27,7,51,58,11,0.002556
mem2100,23,5,7,12,13,0.001317
mini_macho_,14,3,2,5,12,0.001426
mmmsplendid,45,12,9,21,12,0.001609
moderatelymeticulous,15,5,18,23,11,0.002082
modernDayKing,41,11,15,26,12,0.014987
mrcsrnne,15,4,3,7,13,0.015246
nefarious_planet,18,9,4,13,12,0.001352
nickchecking,15,7,6,13,12,0.020804
qTp_Meteor,10,5,3,8,13,0.001399
revankk,23,5,5,10,12,0.001311
revilocaasi,30,10,10,20,13,0.001702
satyvakta,50,15,9,24,12,0.001575
scrambledhelix,29,5,8,13,13,0.001264
sharkbomb,13,2,1,3,14,0.001434
shoesofwandering,16,6,7,13,13,0.001679
shumpitostick,14,12,4,16,12,0.002298
sluuuurp,16,2,1,3,12,0.001304
spicymemesdotcom,31,12,9,21,12,0.003271
spongue,12,2,2,4,12,0.001208
stockinheritance,60,29,29,58,12,0.003441
stopbsingman,23,7,6,13,11,0.002711
subduedReality,12,2,0,2,0,0.001183
teateawea,15,7,5,12,12,0.001309
terminator3456,15,10,4,14,12,0.003142
tittyswan,22,6,5,11,12,0.001724
top0impact,38,8,12,20,13,0.001446
uber_neutrino,10,3,2,5,13,0.001196
vampiregamingYT,17,4,2,6,13,0.002881
walletinsurance,11,2,13,15,12,0.001324
xamxes,11,2,1,3,14,0.001163
zyrkseas97,14,3,3,6,12,0.002638
DarroonDoven,12,4,2,6,12,0.000435
SlipperWheels,82,12,8,20,12,0.001018
Starfleet-Time-Lord,10,5,2,7,13,0.00013
c0i9z,31,9,5,14,12,0.001765
custodial_art,96,26,24,50,11,0.001805
gate18,28,5,2,7,13,0.000513
medical_bancruptcy,17,2,4,6,12,0.000094
AutistAstronaut,25,6,3,9,12,0.00093
Cheshire_Khajiit,44,15,8,23,12,0.005614
GenTwour,22,3,1,4,14,0.000218
Letters_to_Dionysus,39,9,5,14,13,0.00114
Noodlesh89,62,14,12,26,11,0.003664
StormlitRadiance,13,4,1,5,13,0.00054
xvpawel,10,3,2,5,13,0.00023
Fulgore101,14,3,3,6,13,0.000292
NittanyOrange,16,6,3,9,13,0.00037
Quankers,27,5,5,10,12,0.000251
Sea-Chain7394,20,9,6,15,12,0.013401
SteedOfTheDeid,10,6,4,10,12,0.001668
eggynack,78,14,10,24,12,0.001081
h_lance,14,5,3,8,12,0.001486
traanquil,19,5,4,9,12,0.000275
History_Fanatic1993,12,2,22,24,12,0.00037
Charlie4s,57,17,11,28,12,0.002793
Impossible-anarchy,97,32,18,50,12,0.002928
MarkHaversham,40,9,11,20,12,0.000213
Swimreadmed,76,12,9,21,12,0.001676
authorityiscancer222,13,2,0,2,0,0.000321
nhydre,15,7,4,11,13,0.000227
0ldfart,11,3,0,3,0,0.00028
Garblin,23,7,2,9,12,0.001072
fwubglubbel,25,12,5,17,12,0.000742
monkey_gamer,11,3,3,6,14,0.00028
Interesting_Claim414,25,7,92,99,11,0.000234
Adorable_Ad_3478,27,12,7,19,11,0.001432
Appropriate_Owl_91,33,4,4,8,13,0.000693
BrokenManOfSamarkand,13,9,3,12,13,0.001135
CadenVanV,13,5,2,7,13,0.000866
ColTwang333,11,4,3,7,13,0.000418
Cross_examination,10,6,2,8,14,0.001166
Dr_G_E,18,7,3,10,12,0.001037
Efficient_Phase1313,11,5,4,9,12,0.000437
Evening-Skirt731,17,7,2,9,12,0.002048
GrungleMonke,51,9,12,21,12,0.000604
HakuOnTheRocks,10,4,6,10,13,0.000463
Harbinger2001,45,10,11,21,12,0.000791
HiHoJufro,12,5,5,10,13,0.00053
Kilkegard,14,5,3,8,13,0.000826
Lifemetalmedic,13,2,2,4,13,0.000364
Live-Cookie178,15,4,4,8,13,0.000353
Maximus3311,16,3,1,4,13,0.000993
Mediocre-Risk3581,15,6,5,11,11,0.000677
Neat_Rip_7254,32,5,6,11,12,0.000661
P4ULUS,22,3,2,5,12,0.000394
PlusAd4034,23,4,5,9,12,0.000543
Popular_Kangaroo5446,32,13,8,21,12,0.001252
PrettyChillHotPepper,26,6,8,14,11,0.000669
PuffyPanda200,12,9,6,15,12,0.00124
Quarter_Twenty,13,10,7,17,12,0.001014
ReturnPresent9306,15,6,6,12,12,0.002222
Rightricket,26,5,5,10,12,0.001011
Routine-Equipment572,15,5,2,7,13,0.000431
SufficientlyRested,21,6,8,14,11,0.001541
Suitable_Plum3439,10,3,5,8,12,0.000428
TheBouwerie,23,4,6,10,11,0.001138
TomatoTrebuchet,15,4,1,5,13,0.000611
Upset_Gerbil,17,5,3,8,13,0.000374
Weird-Translator6797,15,4,4,8,12,0.000423
What_the_8,18,9,6,15,12,0.001926
Zinged20,15,1,1,2,13,0.000345
asperatedUnnaturally,13,1,3,4,12,0.000345
bakeandjake,11,4,3,7,13,0.00053
bbcczech,15,3,5,8,12,0.000473
cp5184,40,8,11,19,12,0.008264
fghhjhffjjhf,27,4,1,5,13,0.000579
heywhutzup,23,4,4,8,12,0.000509
km3r,19,7,5,12,12,0.000876
lightmaker918,14,5,2,7,13,0.00047
nobaconator,13,5,3,8,12,0.000408
november512,11,4,4,8,13,0.000476
paikiachu,10,3,152,155,11,0.014803
renlydidnothingwrong,14,6,3,9,13,0.000559
rpolkcz,24,6,7,13,12,0.000391
trolletariat69,20,4,2,6,13,0.000391
Jimithyashford,10,3,63,66,11,0.009957
Aggressive-Story3671,32,7,8,15,13,0.001086
BitterGas69,29,11,9,20,11,0.003347
Budobudo,14,4,4,8,12,0.000479
Celebrinborn,27,15,8,23,12,0.002857
Didntlikedefaultname,64,22,18,40,11,0.00204
Essex626,14,1,1,2,13,0.000148
Final-Prize2834,12,7,6,13,12,0.000261
FormerLawfulness6,21,5,7,12,12,0.000974
Grand-Expression-783,16,6,0,6,0,0.000733
Hard_Corsair,13,4,4,8,12,0.000187
Krytan,25,7,3,10,12,0.001964
LocketheAuthentic,21,7,3,10,12,0.002569
Maximum-Lack8642,12,5,2,7,13,0.000647
Nervous_Ganache_9031,11,4,3,7,13,0.000489
NotRadTrad05,15,5,5,10,13,0.000183
Ponce2170,25,9,7,16,12,0.001936
PrimeWolf101,12,1,2,3,13,0.000148
SiPhoenix,26,12,11,23,12,0.001995
Talik1978,95,16,12,28,11,0.004113
Urbenmyth,17,4,0,4,0,0.000282
Various_Succotash_79,107,13,15,28,12,0.000466
Xralius,23,4,2,6,13,0.000284
_robjamesmusic,15,5,4,9,12,0.001482
alohazendo,27,5,4,9,13,0.000398
appealouterhaven,41,15,9,24,12,0.001476
decrpt,23,4,1,5,13,0.000687
hotlocomotive,13,6,5,11,11,0.000341
ofBlufftonTown,27,7,8,15,12,0.00107
speedyjohn,20,9,6,15,12,0.001366
todudeornote,17,9,4,13,12,0.008172
Ambiwlans,10,3,4,7,13,0.01777
Famous-Garlic3838,21,6,5,11,12,0.008407
Francois-C,10,2,2,4,13,0.00364
Frank_JWilson,33,14,10,24,12,0.036036
InFearn0,20,8,7,15,12,0.024116
Knight_Machiavelli,61,14,13,27,12,0.007657
OhWhatsHisName,11,4,3,7,13,0.005258
RexDraco,19,3,1,4,13,0.012576
RocketRelm,31,22,17,39,12,0.058574
Sufficient_Steak_839,14,8,5,13,12,0.018082
TBSchemer,11,5,4,9,13,0.008805
Xytak,18,9,9,18,13,0.010412
analogWeapon,17,5,7,12,12,0.027128
baby_budda,14,11,3,14,13,0.038867
cknight13,13,4,2,6,13,0.016315
daretoeatapeach,25,7,8,15,13,0.007153
eldomtom2,26,6,4,10,13,0.006106
kenlubin,14,6,7,13,12,0.017512
medhat20005,15,9,2,11,13,0.031467
nigel_pow,10,5,2,7,13,0.03249
schistkicker,25,12,11,23,12,0.047697
shamrock01,12,7,2,9,13,0.020788
that_husk_buster,12,8,3,11,13,0.040809
thewerdy,11,4,5,9,13,0.018508
warmwaterpenguin,11,3,2,5,12,0.015808
zonearc,12,2,2,4,13,0.004021
1ithurtswhenip1,12,2,1,3,12,0.000673
AlphaBetaSigmaNerd,77,15,14,29,10,0.001841
Apprehensive-Let3348,25,7,8,15,12,0.00066
Bootmacher,53,6,5,11,12,0.000766
BrooklynSmash,19,16,12,28,12,0.00126
CABRALFAN27,23,10,8,18,13,0.002958
Chemical_Big_5118,17,6,3,9,13,0.002482
Co-flyer,23,4,2,6,14,0.001465
Cold_Breeze3,45,12,10,22,12,0.00277
ConundrumBum,10,4,2,6,13,0.001913
DrawPitiful6103,13,3,1,4,13,0.000758
Easy_Language_3186,11,3,1,4,12,0.001926
Expert-Repair-2971,10,2,1,3,11,0.000674
GeekShallInherit,10,2,3,5,12,0.00179
Inside_Jolly,12,1,2,3,13,0.00064
JeruTz,15,8,3,11,12,0.00246
John-for-all,10,4,1,5,13,0.001394
Kaiisim,10,7,1,8,13,0.001301
KingJades,35,10,7,17,13,0.002526
Known_Week_158,11,11,3,14,13,0.001999
LackingLack,10,2,0,2,0,0.00179
LordBecmiThaco,23,9,6,15,12,0.001551
Muninwing,28,12,12,24,11,0.001362
OneNoteToRead,32,7,6,13,12,0.001743
Qubit_Or_Not_To_Bit_,60,35,32,67,11,0.020541
ScannerBrightly,15,4,3,7,12,0.000717
TheButtDog,21,5,4,9,12,0.000774
Tiny_Rub_8782,19,3,1,4,14,0.00136
Willing-Time7344,16,8,6,14,12,0.001166
alelp,13,3,6,9,12,0.00067
asselfoley,14,2,1,3,15,0.000644
blade740,13,3,2,5,13,0.000659
j____b____,15,8,2,10,14,0.018851
joittine,38,8,10,18,12,0.000903
kimariesingsMD,39,13,8,21,13,0.001294
movingtobay2019,20,8,9,17,11,0.003106
muffinsballhair,17,7,4,11,12,0.001243
sbenfsonwFFiF,19,6,4,10,12,0.001495
sdric,11,5,3,8,12,0.000762
shugEOuterspace,10,4,3,7,11,0.006874
stewmander,26,7,9,16,12,0.001508
sullythered,25,6,8,14,12,0.000838
Katarack21,10,3,8,11,11,0.010563
BothDiscussion9832,44,22,17,39,12,0.040979
friedgoldfishsticks,58,17,13,30,11,0.029254
1964leeb,11,5,5,10,12,0.006905
AmusingMusing7,20,8,6,14,11,0.012018
AndlenaRaines,10,13,5,18,13,0.021356
Automatic-Flounder-3,28,19,14,33,12,0.036911
ChazzLamborghini,19,15,5,20,12,0.019931
Complex-Field7054,30,11,18,29,11,0.039675
CrawlerSiegfriend,11,6,2,8,13,0.021349
DJ_HazyPond292,15,11,0,11,0,0.046203
DelirielDramafoot,20,9,5,14,13,0.006327
Djinnwrath,14,7,9,16,11,0.013672
False_Celebration626,10,9,4,13,13,0.035854
FancyyPelosi,18,6,8,14,13,0.010757
Finishweird,12,4,1,5,13,0.006034
Fishtoart,11,6,5,11,12,0.017049
Gurpila9987,36,15,12,27,12,0.02292
Honky_Cat,14,11,8,19,12,0.01332
Howhytzzerr,10,7,0,7,0,0.03176
KevyKevTPA,13,3,4,7,12,0.004647
LateralEntry,45,25,18,43,12,0.024966
LeftToaster,11,16,3,19,11,0.038706
Mist_Rising,87,33,43,76,11,0.067041
MrMrLavaLava,22,6,6,12,12,0.027003
NOOBFUNK,12,10,4,14,12,0.028116
NekoCatSidhe,75,26,17,43,12,0.056503
OMGitisCrabMan,10,3,3,6,13,0.012146
RKU69,52,22,21,43,11,0.042039
SantaClausDid911,29,12,11,23,12,0.025251
Signal_Membership268,10,5,3,8,13,0.018619
SkiingAway,14,6,4,10,12,0.036147
Specific-Hand3439,17,4,1,5,13,0.017691
Super-Statement2875,10,4,4,8,12,0.006903
Tw1tcHy,48,12,18,30,12,0.03419
Upstairs-Scratch-927,19,6,4,10,11,0.023065
YnotBbrave,58,26,20,46,12,0.05435
bigdon802,30,7,9,16,12,0.024244
da_ting_go,15,2,2,4,13,0.009373
equiNine,25,15,8,23,12,0.044228
fiktional_m3,39,6,5,11,13,0.005743
goddamnitwhalen,26,15,8,23,12,0.036143
indescipherabled,22,6,11,17,13,0.0203
jethomas5,62,15,20,35,11,0.041696
junkit33,17,8,6,14,12,0.031238
neverendingchalupas,28,11,13,24,12,0.04252
stinkywrinkly,23,6,7,13,11,0.02141
xXxdethl0rdxXx,20,8,4,12,12,0.009804
LaquaviusRawDogg,24,7,14,21,12,0.000384
alwaysright0,51,6,2,8,13,0.000155
Iustis,25,7,3,10,12,0.012325
Prasiatko,20,5,2,7,12,0.003823
Syharhalna,12,4,6,10,12,0.001581
arbitrageME,10,10,3,13,13,0.031319
illegalmorality,39,6,28,34,12,0.021099
rigormorty,12,7,3,10,12,0.006621
Liad3008,29,8,23,31,11,0.000089
Foxhound97_,27,6,3,9,11,0.001282
HotSauce2910,11,3,4,7,12,0.00038
Subtleiaint,17,5,17,22,11,0.000638
glumjonsnow,25,6,6,12,13,0.000329
poorestprince,35,6,0,6,0,0.000683
vreel_,11,4,2,6,11,0.00657
Xiibe,39,12,7,19,12,0.00034
deep_sea2,33,13,5,18,12,0.001023
ygmc8413,57,12,9,21,12,0.001079
Massive-Albatross823,10,2,10,12,13,0.000186
Familiar_Invite_8144,12,4,6,10,12,0.000396
Feyle,72,6,6,12,13,0.000384
JacquesShiran,12,3,2,5,13,0.000297
Waste-Menu-1910,19,4,5,9,13,0.00131
houtex727,13,5,2,7,13,0.0002
shitposts_over_9000,106,12,8,20,12,0.000603
xienwolf,28,5,1,6,2,0.000481
Mijam7,10,0,31,31,11,0
Arkmer,19,9,2,11,12,0.019311
Dmagnum,15,10,4,14,12,0.014292
Intelligent-Sound-85,14,5,1,6,12,0.009483
LowerEar715,10,4,5,9,12,0.002081
NepheliLouxWarrior,18,21,4,25,12,0.028763
Pale-Candidate8860,11,5,0,5,0,0.013154
bjdevar25,36,14,11,25,11,0.036556
judge_mercer,27,10,6,16,12,0.016386
kittenTakeover,20,3,2,5,11,0.002548
xena_lawless,21,3,2,5,14,0.001532
MrsWeasley9,19,7,23,30,11,0.000441
Lumpy-Butterscotch50,93,23,11,34,13,0.002789
RICO_the_GOP,12,4,3,7,13,0.001011
Shewhomust77,20,2,2,4,13,0.000102
bemused_alligators,15,9,4,13,12,0.001025
seattleseahawks2014,37,7,11,18,12,0.000162
snotick,18,5,3,8,12,0.000475
NJBarFly,23,5,8,13,13,0.000166
Jackandahalfass,26,4,1,5,14,0.000323
doriangray42,25,3,2,5,14,0.000445
Bombastic_tekken,11,2,2,4,12,0.000316
BoxForeign8849,14,4,2,6,12,0.001109
ExtremeAd7729,16,2,3,5,13,0.000283
Freeham55,10,7,1,8,12,0.002126
Indecisive-Gamer,12,2,4,6,12,0.000301
Independent_Donut_26,20,2,4,6,12,0.000273
NefariousQuick26,13,2,1,3,13,0.000275
PeculiarSir,10,2,1,3,13,0.000276
Rough-Tension,13,3,4,7,13,0.000461
Trylena,89,22,16,38,12,0.001
Tzuyu4Eva,13,3,5,8,12,0.000299
WindyWindona,15,7,4,11,12,0.000598
WinstonWilmerBee,11,6,6,12,12,0.000625
WittyProfile,11,4,4,8,12,0.000365
Z7-852,267,43,40,83,11,0.005784
ZeusThunder369,10,3,41,44,11,0.000458
burningbend,11,4,3,7,12,0.000592
dragonfirestorm948,16,2,12,14,12,0.000284
dtbgx,10,4,1,5,13,0.000456
garden_dragonfly,14,2,1,3,13,0.000276
pinksparklyreddit,15,3,2,5,13,0.000291
-Foxer,19,6,6,12,13,0.015213
12_0z_curls,45,14,13,27,11,0.042422
2057Champs__,42,12,11,23,12,0.022165
20_mile,15,5,6,11,12,0.027379
214ObstructedReverie,19,7,7,14,12,0.026739
40WAPSun,15,8,10,18,12,0.031106
4BasedFrens,15,4,5,9,13,0.014654
AM_Bokke,19,10,7,17,11,0.025182
AStealthyPerson,28,4,4,8,12,0.018694
AVonGauss,18,8,4,12,12,0.029227
Adeptobserver1,16,7,6,13,12,0.01857
AdhesivenessCivil581,11,11,4,15,12,0.032781
AgentMonkey,10,3,1,4,11,0.020462
AlexRyang,10,3,5,8,12,0.014708
Alternative_Buy_4000,27,7,5,12,13,0.014898
AntarcticScaleWorm,34,10,7,17,12,0.016181
Appropriate_Leg9113,13,3,0,3,0,0.024724
ArendtAnhaenger,15,8,8,16,12,0.019488
AshleyMyers44,27,12,11,23,12,0.021085
AxlLight,15,7,2,9,12,0.02045
BKGPrints,245,34,26,60,12,0.03709
BUSY_EATING_ASS,10,6,5,11,13,0.021819
BalboaCZ,12,4,3,7,13,0.016438
Black_XistenZ,19,4,8,12,12,0.027786
Bodoblock,42,24,12,36,12,0.033174
Brysynner,10,5,2,7,13,0.014639
Bulugaboy05,12,4,1,5,14,0.024546
BuzzBadpants,14,7,6,13,12,0.030312
Charming_Cicada_7757,11,6,4,10,12,0.0364
CremePsychological77,22,9,8,17,12,0.031394
Crib15,26,4,4,8,13,0.018797
Damnatus_Terrae,13,5,2,7,12,0.02615
DickNDiaz,57,10,14,24,12,0.027615
Dineology,15,10,4,14,12,0.041771
DinkandDrunk,18,10,5,15,12,0.019512
DonatCotten,11,2,2,4,13,0.018236
Eminence_grizzly,13,5,4,9,13,0.036192
Emotional-Box-6835,16,4,4,8,13,0.014263
FawningDeer37,12,9,8,17,12,0.040464
Fuckface_Whisperer,10,3,1,4,12,0.015059
FuguSandwich,13,14,6,20,12,0.02678
GritNGrindNick,12,7,4,11,12,0.01824
Gryffindorcommoner,55,14,12,26,12,0.016045
Gta6MePleaseBrigade,30,14,6,20,12,0.052464
GuestCartographer,18,13,0,13,0,0.030835
HGpennypacker,10,6,6,12,11,0.03425
Hartastic,51,16,23,39,12,0.045421
HiSno,47,18,8,26,12,0.021994
Honestly_Nobody,11,7,7,14,12,0.031076
HowDoIEvenEnglish,23,5,10,15,12,0.020994
HumanContinuity,16,8,6,14,12,0.024225
Idk_Very_Much,15,12,7,19,12,0.039014
Irish_Pineapple,15,10,7,17,12,0.018527
Jazzlike-Wolverine19,11,3,3,6,11,0.028704
Jeffery95,12,3,3,6,12,0.014591
JesusSquid,14,6,7,13,12,0.026362
Jmoney1088,20,9,6,15,12,0.026831
JustAnotherJon,17,3,3,6,13,0.015029
KeyYak4008,49,7,9,16,13,0.026155
Laves_,12,1,1,2,12,0.014004
LettuceFuture8840,73,27,25,52,11,0.063774
LiberalAspergers,18,4,4,8,12,0.026797
Littlepage3130,13,1,4,5,13,0.014004
LouisWinthorpeIII,18,3,8,11,12,0.014468
LukasJackson67,31,9,8,17,12,0.036848
MagicWishMonkey,14,6,5,11,12,0.025871
MarshyHope,11,3,3,6,13,0.0229
Middle_Ad8183,19,7,9,16,12,0.018884
MonaSherry,14,5,3,8,13,0.019222
New2NewJ,19,11,8,19,12,0.02476
No-Ear7988,22,8,8,16,12,0.037298
NoOnesKing,20,7,4,11,12,0.022159
OccamsRabbit,12,5,3,8,11,0.025034
Ok_Bandicoot_814,79,22,23,45,12,0.047368
Ok_Macaroon6155,34,12,8,20,12,0.032952
OnePunchReality,14,5,3,8,13,0.025917
OneReportersOpinion,29,4,4,8,12,0.016706
OptimusPrimeval,10,5,5,10,12,0.016128
Orbital2,13,7,3,10,12,0.016335
PlantComprehensive77,20,9,8,17,12,0.017334
PolicyWonka,15,8,5,13,12,0.029833
PomegranateOld7836,11,4,3,7,13,0.024374
Prestigious_Ad_5825,13,1,3,4,12,0.014004
PrimAhnProper998,18,4,4,8,13,0.014066
QSannael,10,3,1,4,13,0.017033
RamJamR,17,4,2,6,12,0.025946
RareMajority,10,2,2,4,12,0.01405
RealSimonLee,13,3,3,6,13,0.01446
RedApple655321,13,11,5,16,11,0.020408
Responsible-Yak9000,24,6,6,12,12,0.017018
RonaldTurner88,27,10,6,16,12,0.0271
SaintNutella,13,6,2,8,13,0.024765
Salty-Snowflake,15,5,4,9,11,0.023135
Select_Insurance2000,14,8,4,12,12,0.019031
Selethorme,92,11,12,23,11,0.035129
Significant-Cancel70,40,13,8,21,12,0.048053
Significant_Arm4246,56,23,13,36,12,0.033471
Silent-Storms,22,7,5,12,12,0.018438
Snatchamo,37,15,18,33,12,0.025024
SnottNormal,13,5,5,10,13,0.026032
Sofa-king-high,10,2,0,2,0,0.024191
Sptsjunkie,36,23,17,40,11,0.064424
Standupaddict,15,5,4,9,12,0.015236
StedeBonnet1,22,9,7,16,12,0.021887
Storyteller-Hero,22,13,5,18,12,0.047993
Sublimotion,12,4,1,5,1,0.030209
SuperRocketRumble,18,11,6,17,12,0.02238
The-Polite-Pervert,20,13,6,19,11,0.038346
TheNavigatrix,24,6,32,38,11,0.022354
The_Law_of_Pizza,45,22,14,36,12,0.031196
Time_Minute_6036,26,3,272,275,11,0.015837
Tliish,47,12,9,21,12,0.038398
Toadfinger,10,5,3,8,12,0.032222
TorkBombs,22,16,6,22,12,0.021528
Vast_Road7888,31,6,11,17,12,0.017127
VeekaVeeks,15,5,2,7,11,0.050712
Wave_File,30,15,8,23,11,0.036907
Wermys,52,13,14,27,12,0.044532
Which-Worth5641,49,21,17,38,12,0.05957
YogurtclosetOwn4786,18,8,3,11,13,0.01968
addicted_to_trash,13,6,5,11,12,0.017004
apiaryaviary,25,10,8,18,13,0.016792
bigmac22077,18,7,6,13,12,0.019195
braindeaths,17,4,46,50,12,0.014793
chamrockblarneystone,52,17,20,37,12,0.050058
cowmix88,14,12,4,16,14,0.025079
das_war_ein_Befehl,29,19,13,32,11,0.052389
datalicearcher,38,6,4,10,11,0.032106
dragnabbit,11,5,2,7,13,0.033501
dsfox,12,3,3,6,13,0.014717
elmekia_lance,30,14,13,27,12,0.021309
gquax,24,24,12,36,12,0.033675
grinr,12,5,1,6,13,0.027428
indigoC99,11,3,2,5,13,0.014394
ironyinsideme,14,8,6,14,12,0.018931
jumpinjacktheripper,16,4,3,7,11,0.016157
kevbot918,14,10,6,16,12,0.030712
kormer,24,10,8,18,11,0.027519
l1qq,28,22,10,32,12,0.040688
lewkiamurfarther,44,18,19,37,12,0.04678
littleredpinto,14,3,3,6,11,0.025869
mercfan3,17,17,7,24,12,0.041143
mongooser,14,10,5,15,13,0.019921
nanoatzin,19,10,5,15,13,0.028859
ninfan1977,32,8,5,13,12,0.023975
notapoliticalalt,29,11,9,20,11,0.038763
onlyontuesdays77,56,16,12,28,11,0.055718
quizbowler_1,18,3,1,4,12,0.02385
rabidstoat,11,4,5,9,12,0.025238
rcglinsk,12,8,5,13,12,0.027283
sirswantepalm,45,8,42,50,11,0.028618
spam__likely,24,11,13,24,12,0.034054
speedingpullet,23,8,9,17,12,0.018982
stripedvitamin,14,6,5,11,12,0.020325
sunshine_is_hot,105,33,20,53,12,0.028702
t234k,28,12,6,18,12,0.023599
teilani_a,21,5,2,7,12,0.01882
telefawx,20,7,7,14,12,0.017268
the_original_Retro,10,6,66,72,11,0.017421
trace349,25,10,14,24,11,0.032113
ttystikk,14,5,1,6,13,0.036186
umbren,20,4,5,9,11,0.020533
uptokesforall,17,5,5,10,12,0.015239
wellwisher-1,40,20,12,32,11,0.069208
wha-haa,47,19,16,35,12,0.065314
wulfgar_beornegar,35,5,7,12,13,0.016814
yoshi8869,32,9,8,17,12,0.022447
zaplayer20,11,5,5,10,12,0.024882
AtlasThe1st,11,2,1,3,12,0.000467
GarageIndependent114,27,6,2,8,14,0.001539
Hemingwavy,14,4,3,7,11,0.007274
Justame13,27,7,6,13,13,0.001171
Ok_Owl_5403,33,6,6,12,11,0.001113
SeattleBrother75,15,2,0,2,0,0.00134
SpecificConscious809,10,2,2,4,12,0.000373
TetraThiaFulvalene,22,8,5,13,10,0.000373
TheBitchenRav,11,4,4,8,12,0.000348
TheInsomn1ac,11,8,2,10,13,0.000231
hydrOHxide,13,3,5,8,12,0.000276
sumit24021990,42,8,11,19,12,0.000905
Ok-Trade-5937,23,3,21,24,12,0.000039
FearlessResource9785,107,22,16,38,12,0.001275
JaggedMetalOs,17,2,1,3,12,0.000064
Ok-Warning-7494,10,1,107,108,11,0
1331_1331,14,4,3,7,13,0.000714
7thpostman,15,3,2,5,13,0.001192
Ah_Pook,11,4,4,8,12,0.000657
AngryVolcano,30,7,5,12,11,0.001716
Appropriate_Gate_701,26,9,5,14,12,0.001733
BackseatCowwatcher,18,11,6,17,12,0.001235
Bast-beast,32,12,10,22,12,0.001712
Belisarius9818,28,7,5,12,12,0.000901
Boulange1234,14,3,1,4,13,0.001209
CallMeOaksie,14,4,4,8,12,0.000616
CommyKitty,10,6,2,8,13,0.003107
Contemplating_Prison,10,3,2,5,13,0.000811
FreddieMoners,21,6,3,9,12,0.001731
IcyRecommendation781,26,7,6,13,12,0.000792
IndividualSkill3432,13,5,4,9,13,0.000858
IsNotACleverMan,78,16,15,31,12,0.003347
John-Zero,11,3,2,5,13,0.000611
Majestic-Effort-541,17,8,5,13,12,0.000721
No-Ladder7740,24,6,7,13,12,0.001277
PharaohhOG,10,5,4,9,13,0.001489
RedHead-Eng25,16,8,3,11,13,0.00239
Responsible_Music248,10,2,2,4,12,0.000581
Sammonov,24,14,10,24,12,0.014743
SmokingPuffin,11,1,1,2,14,0.000554
Solondthewookiee,36,8,7,15,11,0.001575
Technoxgabber,16,3,2,5,12,0.000873
Throwaway5432154322,31,8,9,17,12,0.011769
Total_Yankee_Death,10,3,3,6,12,0.000899
U_Sound_Stupid_Stop,15,4,6,10,13,0.000661
VikingFjorden,12,3,2,5,13,0.000693
Wayoutofthewayof,13,5,4,9,12,0.00083
XhazakXhazak,26,12,4,16,13,0.001616
Zrakoplovvliegtuig,11,3,4,7,12,0.000726
denyer-no1-fan,17,6,5,11,12,0.001237
forkproof2500,27,4,5,9,12,0.000649
lepoissonstev,28,5,3,8,13,0.000847
polisharmada33,19,6,6,12,12,0.001256
poopy050224,16,2,1,3,12,0.000754
scaurus604,14,2,7,9,12,0.000573
spyrielles,18,3,2,5,13,0.000575
thelaceonmolagsballs,10,4,4,8,13,0.001286
Crafty-Average-586,10,3,0,3,0,0.000936
itsnotcomplicated1,37,11,6,17,11,0.007346
Parzival_1775,21,2,47,49,11,0.000009
Ancquar,11,5,2,7,12,0.012308
DoYouWantAQuacker,10,4,1,5,14,0.000545
Donkletown,27,4,6,10,12,0.000446
Eyespop4866,11,3,1,4,13,0.001503
GoBills585,22,10,3,13,14,0.000746
LowNoise9831,12,2,3,5,12,0.000366
Noob_Al3rt,64,16,17,33,12,0.003523
PhaseFull6026,10,0,10,10,13,0
Allydarvel,13,2,1,3,15,0.00013
ChChChillian,40,3,4,7,14,0.000145
SethGekco,29,4,1,5,13,0.000559
allboolshite,11,2,3,5,13,0.000281
minion531,33,5,1,6,14,0.000881
neodiogenes,65,11,8,19,13,0.001538
saliczar,12,2,0,2,0,0.000297
Delli-paper,88,25,17,42,11,0.005738
WaterboysWaterboy,10,3,1,4,12,0.000198
Powerful_Falcon_4006,15,0,25,25,12,0
Asmos159,13,4,3,7,13,0.000357
Rombom,53,9,7,16,13,0.000415
Stompya,13,2,2,4,12,0.000218
Unusual_Wasabi_7121,10,2,1,3,15,0.000351
Yarddogkodabear,11,1,1,2,1,0.000183
rlbond86,12,4,2,6,13,0.000387
solid_reign,35,6,5,11,12,0.000677
space_monster,11,2,2,4,13,0.000183
ven_geci,21,5,3,8,13,0.000824
PressPausePlay,12,3,39,42,12,0.000297
1SecularGlobe4All,14,3,5,8,12,0.001783
Ambitious-Care-9937,13,3,1,4,14,0.000418
Beljuril-home,11,2,2,4,14,0.000342
DD_Spudman,10,3,4,7,12,0.000338
Delduthling,23,3,2,5,12,0.00052
JRDZ1993,15,3,4,7,11,0.000652
LosingTrackByNow,14,6,4,10,13,0.00049
Mutive,10,3,3,6,13,0.000333
ObviousSea9223,11,2,0,2,0,0.000593
Stunning_Active_8938,55,28,31,59,11,0.004772
TapPublic7599,10,4,5,9,12,0.001048
PsychLegalMind,11,0,237,237,11,0
68plus1equals,19,10,7,17,13,0.016416
AdUpstairs7106,23,8,8,16,12,0.015587
Austin_Peep_9396,11,12,5,17,13,0.02426
Confusedgmr,11,6,5,11,12,0.017261
Dreadedvegas,19,10,4,14,13,0.014257
Dull_Conversation669,22,11,5,16,12,0.04173
Emergency_Driver_487,49,6,5,11,12,0.014001
Emergency_Streets,10,5,3,8,12,0.020309
Facebook_Algorithm,14,2,2,4,12,0.010237
Forte845,87,26,28,54,12,0.032911
Gweena,20,4,3,7,12,0.012106
Hot-Hurry3199,21,6,9,15,12,0.013455
Independent_Fox8656,13,6,3,9,13,0.013316
Infamous_Top677,11,3,3,6,12,0.015866
Intro-Nimbus,14,4,1,5,12,0.0162
IrritableGourmet,19,7,7,14,12,0.024952
Laceykrishna,10,3,2,5,14,0.012346
Lucas_Steinwalker,13,3,4,7,13,0.010472
OpeningChipmunk1700,24,9,7,16,12,0.015248
PM_me_Henrika,15,6,5,11,12,0.023157
Pi6,12,8,4,12,13,0.024933
PropofolMargarita,23,3,8,11,11,0.016388
RabbaJabba,39,11,7,18,12,0.025202
SAPERPXX,10,6,2,8,13,0.015522
SammathNaur1600,20,6,4,10,12,0.013964
TaxLawKingGA,18,10,5,15,13,0.022127
Zadow,14,7,8,15,11,0.01251
bfhurricane,20,10,8,18,12,0.015825
celsius100,14,7,5,12,12,0.018956
danappropriate,25,6,5,11,11,0.019734
fairenbalanced,13,4,2,6,13,0.0117
floofnstuff,13,4,5,9,12,0.021406
foilhat44,11,6,4,10,11,0.028714
honuworld,22,6,2,8,13,0.017753
hymie0,11,9,4,13,12,0.016426
ilikedota5,17,7,8,15,12,0.025598
itsdeeps80,62,21,19,40,12,0.043307
jaywst22,20,6,5,11,12,0.023181
johannthegoatman,10,7,3,10,13,0.024461
kerouacrimbaud,23,7,11,18,12,0.011871
link3945,20,6,5,11,12,0.01298
ninjadude93,14,9,4,13,11,0.027093
pharmamess,13,4,8,12,13,0.014002
popeIeo,32,10,6,16,12,0.015674
powerboy20,18,5,2,7,13,0.01194
res0nat0r,20,11,8,19,12,0.035894
rhombecka,11,8,3,11,13,0.030151
rockclimberguy,11,5,3,8,12,0.013688
truthovertribe,57,12,13,25,12,0.028059
weealex,15,10,7,17,11,0.041606
welcome_universe,10,3,3,6,12,0.011414
whater39,71,12,11,23,11,0.011392
zeussays,12,6,4,10,12,0.012822
Agreeable_Car5114,11,6,3,9,13,0.001086
Alternative_Hope6238,10,5,3,8,12,0.001175
Appropriate_Mixer,14,7,5,12,12,0.000827
BeginningMedia4738,19,7,7,14,12,0.000968
CauseAdventurous5623,16,3,2,5,13,0.000888
Consistent_Hurry_603,13,2,2,4,12,0.000718
Crowe3717,13,3,2,5,13,0.000722
Csimiami,15,6,4,10,11,0.001821
DTF_Truck,17,5,3,8,13,0.001491
DewinterCor,10,2,2,4,13,0.000723
Direct_Crew_9949,12,2,2,4,12,0.000738
DopeShitBlaster,13,6,4,10,13,0.001511
EdenSire0,54,7,7,14,12,0.002197
FineDingo3542,15,5,5,10,12,0.001007
Fishin4catfish,12,2,1,3,14,0.001867
Former_Function529,23,6,5,11,12,0.001197
HolyToast,113,21,15,36,12,0.001244
Horselady234,18,9,7,16,11,0.00361
Huge___Milkers,10,5,0,5,0,0.000753
IceTheFoundr,15,6,1,7,14,0.002651
Idrialite,16,4,3,7,12,0.00109
InfidelZombie,11,5,5,10,13,0.000842
Kangaroo_shampoo4U,76,3,2,5,12,0.000784
Key_Cheetah7982,116,25,37,62,11,0.003852
LEDN42,15,4,3,7,13,0.000746
Low_Guide5147,19,6,4,10,13,0.001351
ManliestBunny,14,4,2,6,13,0.000734
MaxwellKillMill,24,5,4,9,13,0.00353
Mister_Way,10,2,1,3,14,0.000991
MooseRyder,16,5,3,8,13,0.000825
No-Broccoli-7606,23,5,7,12,11,0.001391
NoseSeeker,10,6,5,11,12,0.001907
NotYourThrowaway17,15,3,2,5,13,0.000763
Ok_Artichoke_2928,10,3,2,5,13,0.000876
OptimisticRealist__,17,10,2,12,13,0.001875
PopTheRedPill,12,5,2,7,12,0.001052
Shadeylark,29,5,5,10,13,0.00312
SirWillae,13,5,0,5,0,0.001927
SkinnerBoxBaddie,29,6,3,9,13,0.001092
Tengoatuzui,45,7,7,14,12,0.00094
TheMuffler42069,39,4,3,7,13,0.000736
ThoseThatComeAfter,11,4,3,7,13,0.000914
ThrowRAboredinAZ77,21,5,4,9,12,0.000756
TownAfterTown,22,8,7,15,13,0.000852
Unexpected_Gristle,16,5,4,9,13,0.001063
Witty-Rabbit-8225,11,4,1,5,13,0.00086
baltinerdist,16,4,2,6,12,0.000776
banhs5,26,7,5,12,12,0.001402
blyzo,30,13,8,21,12,0.017743
charlesth1ckens,15,8,6,14,13,0.002343
chewwydraper,11,3,2,5,13,0.00101
comeon456,52,26,5,31,12,0.002636
draculabakula,15,6,4,10,11,0.001528
going_my_way0102,36,12,14,26,12,0.003725
isamudragon,18,4,3,7,12,0.000746
moboticus,15,6,5,11,12,0.002813
nighthawk_something,26,5,11,16,12,0.000807
oversoul00,41,7,7,14,12,0.000855
parentheticalobject,14,6,2,8,13,0.002015
savetinymita,11,2,1,3,14,0.000723
slyrent,10,5,5,10,12,0.001241
superswellcewlguy,10,5,3,8,12,0.000952
thefrozenflame21,19,8,5,13,12,0.002187
thegreatherper,28,3,3,6,13,0.000725
thinsoldier,26,12,10,22,12,0.001358
werewulf35,13,3,3,6,13,0.000719
yaboichurro11,25,12,1,13,12,0.002479
ImProdactyl,11,2,1,3,13,0.000096
stringbeagle,10,9,5,14,11,0.001007
Magehunter_Skassi,12,9,4,13,13,0.008865
Significant_Sign_520,11,11,2,13,12,0.018218
closetedwrestlingacc,10,3,4,7,12,0.002603
thegarymarshall,35,3,5,8,12,0.003922
Real-Intention-7998,23,16,35,51,11,0.000837
AnxietyObvious4018,35,14,11,25,12,0.000952
Iconic_Mithrandir,25,14,13,27,12,0.002584
KRAy_Z_n1nja,14,3,2,5,12,0.000288
Pastadseven,12,4,5,9,12,0.000802
StarChild413,32,9,15,24,11,0.002715
nauticalsandwich,26,10,8,18,12,0.001167
poprostumort,37,15,8,23,11,0.001794
urquhartloch,48,14,11,25,13,0.002243
Responsible-Bunch316,32,6,41,47,11,0.000836
Angry_Canadian88,13,6,5,11,12,0.000454
Apprehensive-Fun4181,10,3,1,4,12,0.001116
Charming-Leader-250,17,5,3,8,12,0.002256
L3onK1ng,23,6,6,12,12,0.000586
Muadeeb,16,2,1,3,14,0.000181
Wayyyy_Too_Soon,14,4,1,5,13,0.000841
asafg8,15,5,1,6,13,0.000679
bluepillarmy,13,5,32,37,12,0.000255
turboprancer,11,4,43,47,11,0.000367
Rolly3,22,4,20,24,12,0.000567
Gohab2001,14,6,5,11,12,0.001045
akaleonard,17,4,1,5,13,0.000672
blueplanet96,21,11,8,19,11,0.000875
myusrnmeisalrdytkn,19,5,3,8,12,0.000413
tinylemon128,11,5,2,7,13,0.001719
Crash927,65,15,10,25,12,0.015019
Doodenelfuego,14,4,3,7,13,0.000142
OldSarge02,11,3,6,9,12,0.000149
arrgobon32,36,14,2,16,12,0.001024
delimeats_9678,34,7,7,14,11,0.000424
Eggsformycat,26,11,7,18,13,0.000656
aipac124,10,2,0,2,0,0.000298
bgaesop,32,6,5,11,11,0.000791
GumboSamson,25,5,4,9,11,0.000694
Nick_Beard,31,16,6,22,12,0.000554
NumerousWeather9560,23,10,2,12,12,0.002238
imhugeinjapan89,20,6,4,10,12,0.001677
throw-away-doh,23,4,3,7,13,0.000213
Due_Satisfaction2167,13,5,2,7,13,0.000691
EmilytheALtransGirl,14,3,1,4,13,0.001
VirtualDingus7069,10,2,2,4,14,0.000281
SuggestionHoliday413,10,1,21,22,11,0.000016
No-swimming-pool,10,1,1,2,14,0.000226
dvolland,13,1,1,2,14,0.000226
followyourvalues,14,2,4,6,12,0.000246
h0sti1e17,14,6,7,13,13,0.000737
ultradav24,51,11,17,28,12,0.002023
Ayjayz,25,8,5,13,12,0.000628
Carlpanzram1916,10,4,2,6,13,0.000291
ErieHog,18,11,6,17,13,0.002092
IwantyoualltoBEDAVE,24,3,4,7,13,0.00024
MeanestGoose,10,4,1,5,13,0.000287
Puzzleheaded_Disk_90,14,4,3,7,13,0.000487
SpecialistBet4656,31,3,5,8,12,0.000594
Spirited-Feed-9927,16,3,1,4,14,0.000364
Sufficient_Run4414,15,4,4,8,11,0.000267
TankyRo,13,4,3,7,12,0.000402
TheAmazingBreadfruit,11,3,2,5,12,0.000263
United_Librarian5491,20,6,7,13,12,0.000247
WearIcy2635,37,12,12,24,12,0.000703
Yuo_cna_Raed_Tihs,17,4,3,7,12,0.000315
amrodd,19,4,5,9,12,0.00045
athe085,28,2,3,5,13,0.00025
bigElenchus,14,8,4,12,13,0.000335
cuntpimp,17,5,2,7,13,0.000261
mutantraniE,12,3,5,8,12,0.000274
quietmanic,17,5,7,12,12,0.000278
spinbutton,24,8,8,16,12,0.000978
tanglekelp,11,3,2,5,12,0.000378
trullaDE,21,14,6,20,13,0.001207
xboxhaxorz,10,3,3,6,13,0.000548
Bitter-Assignment464,18,5,3,8,11,0.007509
DataCassette,10,4,5,9,12,0.001134
FalseBuddha,10,5,3,8,13,0.001162
GkrTV,27,9,10,19,12,0.001975
JeffreyElonSkilling,13,5,4,9,13,0.001882
LankyEvening7548,29,5,4,9,13,0.001144
Lower_Group_1171,15,5,2,7,12,0.002503
LumpBizquik,28,8,13,21,12,0.001484
Nsfwacct1872564,21,5,8,13,12,0.001409
Royalfatty,11,5,4,9,13,0.001208
Secret-Put-4525,23,2,2,4,12,0.001116
TBK_Winbar,22,7,2,9,12,0.001307
TuskaTheDaemonKilla,12,4,1,5,13,0.0015
Wade8813,15,3,2,5,14,0.001101
WeakandSlowaf,25,6,5,11,12,0.001481
acesoverking,25,5,27,32,12,0.001165
atamicbomb,12,3,3,6,12,0.001144
cbf1232,38,9,12,21,12,0.001689
deepstaterecords,22,9,10,19,11,0.008304
elCharderino,10,6,1,7,13,0.008225
ezk3626,11,2,0,2,0,0.001379
fps916,15,3,2,5,11,0.007158
jpotion88,21,4,9,13,13,0.001467
maxxell13,12,6,5,11,12,0.00143
nerojt,32,5,7,12,11,0.0016
pile_of_bees,40,11,13,24,12,0.001538
timeless1991,25,5,65,70,11,0.001594
tjboss,10,2,2,4,12,0.001473
wingsnut25,18,6,5,11,11,0.006572
yIdontunderstand,10,2,1,3,2,0.001084
TheMissingPremise,14,3,17,20,11,0.000652
Careful-Painting3214,13,4,2,6,11,0.008162
spicy-chull,14,5,5,10,12,0.001727
TheMrCurious,36,12,14,26,12,0.00193
Fofolito,10,3,0,3,0,0.001709
Impossible_Ad9324,12,5,4,9,12,0.003817
Rastiln,38,21,13,34,12,0.031627
dickpierce69,29,11,4,15,12,0.009087
Mysterious_Ad_7301,11,3,6,9,12,0.003266
Pearberr,14,3,2,5,12,0.003085
Roselily808,10,17,2,19,13,0.007619
SpicyButterBoy,34,8,7,15,12,0.006303
Traditional-Ad-3245,12,2,1,3,13,0.00476
UnusualAir1,14,6,3,9,12,0.01573
WarbleDarble,130,23,32,55,12,0.023457
colako,10,2,2,4,13,0.003218
gburgwardt,33,10,9,19,12,0.016027
gravity_kills,12,6,4,10,12,0.007905
The_Godlike_Zeus,13,0,11,11,12,0
Coygon,12,3,1,4,13,0.0002
meteoraln,12,2,1,3,13,0.000433
nemoomen,11,3,0,3,0,0.00031
snrup1,11,1,1,2,1,0.000156
venuswasaflytrap,28,5,3,8,14,0.000384
Aggressive-Mix4971,13,3,2,5,13,0.000327
FourCardStraight,16,5,1,6,11,0.000436
McKropotkin,13,2,3,5,13,0.000301
Norman_debris,10,2,1,3,14,0.0003
Our_GloriousLeader,11,4,1,5,14,0.000392
TheWorstRowan,14,4,5,9,12,0.000353
barnburner96,12,3,2,5,13,0.00032
cstar1996,30,9,9,18,12,0.00044
iamunknowntoo,11,4,2,6,12,0.000962
redelastic,39,9,11,20,13,0.001399
96suluman,11,3,2,5,12,0.012457
ABobby077,11,5,5,10,13,0.025156
Amoral_Abe,14,16,3,19,12,0.024032
Aneurhythms,20,9,7,16,13,0.020615
Anodized12,13,1,2,3,12,0.011462
BobQuixote,17,5,6,11,12,0.015174
CerddwrRhyddid,23,6,4,10,13,0.02098
CharlieandtheRed,13,8,7,15,12,0.016818
CloudComfortable3284,15,5,7,12,13,0.014379
DMayleeRevengeReveng,31,15,9,24,12,0.029157
Dark_Wing_350,13,2,1,3,13,0.013219
Downtown_Afternoon75,15,5,6,11,12,0.015266
Dunkleosteus666,10,3,2,5,12,0.012677
Either_Operation7586,22,6,11,17,12,0.028206
Electrical-Lab-9593,11,5,3,8,12,0.015264
Electronic_Mango1,20,2,3,5,12,0.011494
EyesofaJackal,10,4,1,5,12,0.014638
Final_Meeting2568,13,5,2,7,12,0.015048
FrostyArctic47,19,7,4,11,12,0.024982
JimDee01,10,3,2,5,12,0.014294
MisterMysterios,22,6,8,14,12,0.016992
MrChow1917,20,10,6,16,12,0.012166
Padonogan,22,5,4,9,12,0.014397
Raythunda125,11,3,2,5,13,0.012079
SafeThrowaway691,16,6,7,13,12,0.022535
Serious_Senator,13,6,6,12,12,0.012675
Ssshizzzzziit,21,6,7,13,13,0.014408
TheMCMC,10,5,3,8,12,0.015204
VA_Cunnilinguist,11,4,4,8,13,0.013033
WATGGU,18,2,4,6,11,0.011593
WaltEnterprises,26,6,2,8,14,0.013993
YetAnotherGuy2,24,9,6,15,12,0.017828
arthur_jonathan_goos,13,3,3,6,12,0.02041
atoolred,10,5,8,13,12,0.013671
bones_bones1,21,14,3,17,12,0.040624
cakeandale,18,16,6,22,13,0.029912
cptjeff,14,8,4,12,12,0.025718
demihope,18,11,6,17,12,0.021763
everything_is_bad,12,8,3,11,13,0.019212
evissamassive,15,3,3,6,12,0.0119
figuring_ItOut12,37,5,4,9,13,0.021059
jadnich,32,4,4,8,11,0.028109
jarchack,26,14,8,22,13,0.023869
josh34583,20,10,8,18,12,0.019675
regolith-terroire,50,21,17,38,12,0.021653
rzelln,13,2,4,6,12,0.011486
sendenten,10,6,5,11,12,0.016768
smartcow360,15,3,3,6,13,0.012538
Bluehen55,19,10,7,17,13,0.01282
Clovis42,10,5,4,9,12,0.006682
Duckfoot2021,32,9,7,16,11,0.016158
Impossible_Pop620,45,8,8,16,12,0.01726
RebornGod,28,6,5,11,11,0.004369
ThatsARatHat,15,4,6,10,11,0.011651
Vaulk7,16,4,3,7,12,0.005057
YakCDaddy,21,3,2,5,13,0.004747
flat6NA,10,4,3,7,12,0.005569
jmtrader2,19,8,6,14,12,0.019654
nyckidd,22,16,8,24,12,0.00924
rookieoo,34,19,13,32,12,0.038069
sardine_succotash,61,24,19,43,12,0.010301
surfryhder,10,2,1,3,11,0.010188
West_Hat7270,23,2,4,6,12,0
Reasonable-Bad-769,41,7,4,11,12,0.000124
WhenButterfliesCry,29,4,5,9,11,0.000124
Aezora,18,5,2,7,13,0.000509
couverte,10,4,2,6,13,0.000839
ourstobuild,17,3,1,4,13,0.000185
BrownCongee,11,2,2,4,12,0.000425
Fichek,18,3,3,6,11,0.000449
HombreDeMoleculos,22,4,6,10,13,0.002154
MainPlankton9612,12,4,1,5,14,0.00272
fallingknife2,13,5,6,11,12,0.000585
Fredouille77,30,5,10,15,12,0.000701
Garfish16,59,14,13,27,12,0.001329
LateQuantity8009,19,5,2,7,12,0.000975
No-Cauliflower8890,55,8,6,14,13,0.000668
Tacenda8279,10,7,4,11,12,0.001123
angry_cabbie,12,5,3,8,12,0.000708
gingerbreademperor,21,5,2,7,13,0.000424
johnsonjohnson,12,3,0,3,0,0.000324
marbinho,18,4,4,8,13,0.000424
saul_not_goodman,40,11,17,28,11,0.000925
sisnitermagus,10,2,1,3,14,0.000333
StevenGrimmas,12,5,3,8,14,0.000584
megschristina,15,4,1,5,13,0.001462
mnoodleman,15,6,4,10,12,0.001665
ornery_curmudgeon,36,11,12,23,13,0.001659
sumoraiden,30,7,6,13,13,0.001046
Embarrassed_Bake2683,14,3,2,5,12,0.001448
Pinkydoodle2,22,3,4,7,11,0.000394
facefartfreely,34,5,2,7,13,0.000623
mallardramp,27,7,8,15,11,0.00176
A_Duck_Using_Reddit,28,15,7,22,12,0.001204
McAlpineFusiliers,22,2,0,2,0,0.000278
Philstar_nz,35,8,8,16,12,0.000227
ThatFuzzyBastard,17,3,2,5,13,0.000196
WileyApplebottom,17,4,2,6,13,0.000499
jabbanobada,16,2,1,3,12,0.000208
495orange,12,5,2,7,12,0.002959
Carlyz37,15,2,5,7,12,0.002933
ENCginger,13,2,1,3,13,0.003275
James_Fiend,24,4,8,12,12,0.004298
keenan123,16,5,4,9,13,0.006714
GentleKijuSpeaks,27,3,1,4,13,0.000286
GooseyKit,16,5,6,11,11,0.000194
Opposite-Bill5560,15,4,2,6,13,0.000364
Sky-Trash,16,6,8,14,12,0.000451
helpprogram2,15,4,2,6,12,0.000518
38159buch,10,4,4,8,13,0.001253
7692205,10,2,1,3,13,0.001257
AccomplishedBake8351,14,6,7,13,12,0.001582
Apart_Variation1918,27,7,9,16,11,0.001979
Avaposter,32,6,7,13,12,0.003162
Bigthrimbles,25,4,3,7,12,0.001207
BrandonLart,22,6,7,13,12,0.015436
Dorithompson,14,3,1,4,12,0.001276
Doughnut3683,19,2,2,4,13,0.001347
Edens_dark_garden,32,7,4,11,13,0.002259
Farcry5gonnabelit,12,4,4,8,13,0.002824
GoldenEagle828677,80,18,12,30,12,0.002146
Grand-wazoo,20,5,2,7,13,0.00153
ICantCoexistWithFish,46,4,7,11,13,0.001495
JosephJohnPEEPS,12,1,2,3,13,0.001149
Knave7575,18,5,3,8,12,0.001932
LIONS_old_logo,26,6,6,12,12,0.001327
LSF604,37,5,5,10,13,0.002471
Lethkhar,31,9,10,19,11,0.001545
LogensTenthFinger,11,6,3,9,12,0.001315
Mammoth_Sleep_7046,11,4,5,9,12,0.015515
Mordred19,14,1,7,8,13,0.001149
Most-Ad4680,16,4,3,7,11,0.001464
Negative_Jaguar_4138,23,6,6,12,12,0.001267
Proof-Technician-202,17,7,7,14,12,0.001275
RVarki,12,5,4,9,12,0.001629
Rosimongus,28,10,7,17,12,0.002346
SweetJeebus,10,4,4,8,12,0.001225
TSllama,18,5,5,10,13,0.001615
TotalityoftheSelf,31,7,8,15,12,0.001461
Utapau301,18,6,7,13,12,0.001398
Valirys-Reinhald,15,5,4,9,13,0.001362
ahrazz99,10,4,3,7,12,0.015499
bearington,33,15,13,28,13,0.002923
cleanlinessisgodly,14,5,6,11,12,0.001434
coochitfrita,51,13,14,27,12,0.001571
crispy1989,12,7,4,11,13,0.001355
isekai15,13,1,1,2,13,0.001149
jedisushi72,14,3,2,5,12,0.015415
jinjuwaka,21,5,8,13,11,0.001309
revengeappendage,57,15,7,22,11,0.002105
stormy2587,11,5,2,7,12,0.00133
username_6916,16,10,4,14,12,0.003773
vankorgan,28,10,5,15,13,0.001454
vintage2019,16,9,6,15,12,0.005039
vollover,10,3,5,8,12,0.001788
wetshatz,37,6,6,12,12,0.001424
melissaphobia,11,3,2,5,11,0.000585
squirlnutz,12,3,1,4,12,0.000639
Biptoslipdi,73,11,6,17,13,0.002298
Glory2Hypnotoad,30,5,3,8,12,0.001358
HauntedReader,56,12,6,18,12,0.002592
PimplupXD,12,6,2,8,13,0.000377
polyvinylchl0rid,11,2,2,4,13,0.000158
reginald-aka-bubbles,14,3,1,4,14,0.000107
unnecessaryaussie83,13,3,2,5,13,0.000138
Sea_Entrepreneur6204,49,15,10,25,12,0.001056
dsteffee,10,2,85,87,11,0.000161
Angylisis,69,20,16,36,11,0.00269
BonelessB0nes,11,3,1,4,13,0.00242
Broad_Temperature554,10,5,7,12,11,0.002429
FluffyWeird1513,13,5,3,8,12,0.002554
GreatResetBet,14,15,7,22,12,0.003098
HEpennypackerNH,14,3,3,6,12,0.002527
I_like_baseball90,16,3,2,5,12,0.003375
Irdes,31,8,9,17,11,0.002741
MazerRakam,12,3,2,5,12,0.002136
Ok-Autumn,10,2,1,3,1,0.002079
RequirementQuirky468,10,3,2,5,12,0.002311
Taconinja05,10,11,3,14,13,0.008236
VansterVikingVampire,10,2,1,3,13,0.002349
boldandbratsche,31,8,10,18,13,0.00305
postdiluvium,25,11,4,15,13,0.005104
pulsatingcrocs,26,6,7,13,12,0.003421
4p4l3p3,28,4,7,11,12,0.000502
Extension_Hand1326,26,8,8,16,12,0.000838
Hipp0damos,15,6,1,7,13,0.000366
McArthur210,11,2,2,4,13,0.000282
MrVeazey,12,2,2,4,14,0.000281
Only-Butterscotch785,19,6,9,15,13,0.000475
PeoplePerson_57,18,8,8,16,13,0.001708
PoIIux,16,4,4,8,12,0.000918
Supercollider9001,29,8,7,15,11,0.006665
TarantulaWithAGuitar,10,2,1,3,12,0.000425
WanderingAlienBoy,12,6,9,15,12,0.000494
Whatswrongbaby9,21,7,4,11,13,0.000374
anarchistright,17,3,2,5,13,0.000316
formandovega,31,6,7,13,12,0.000534
grobbler21,11,2,1,3,12,0.000328
pinegreenscent,10,5,2,7,12,0.000382
xeere,17,6,5,11,13,0.000743
B1ackHawk12345,14,2,2,4,13,0.000148
Mysterious_Eye6989,20,7,7,14,12,0.001516
ohhhbooyy,11,3,2,5,13,0.000196
EnterprisingAss,15,6,6,12,12,0.000544
Grunt08,42,18,7,25,12,0.001392
Gullible-Minute-9482,27,3,4,7,13,0.000268
deadphrank,12,3,2,5,12,0.000361
joepierson123,20,3,3,6,13,0.000327
le_fez,11,3,0,3,0,0.000268
herejusttoannoyyou,13,1,5,6,15,0.000004
RiskyBrothers,13,2,1,3,14,0.000168
Buzzs_Tarantula,11,2,4,6,13,0.001481
Fattyboy_777,20,5,8,13,12,0.001295
Ion_Unbound,18,6,6,12,12,0.012104
Marchtmdsmiling,39,8,14,22,11,0.004825
metarinka,11,7,2,9,13,0.027487
jman12234,11,1,49,50,11,0.000025
00Oo0o0OooO0,17,11,1,12,13,0.00093
Brief-Percentage-193,13,3,6,9,13,0.000247
GloomyButterfly8751,28,6,4,10,13,0.000764
KFrancesC,29,7,6,13,12,0.00032
Robert_Grave,11,6,1,7,14,0.000523
bingbano,26,10,7,17,13,0.00058
dr_eh,22,4,3,7,12,0.000403
kyngston,14,6,5,11,12,0.000302
memory_of_blueskies,30,7,7,14,12,0.000563
weirdoimmunity,49,8,4,12,13,0.000545
kep_x124,18,0,29,29,11,0
Accomplished-Cat3996,11,3,2,5,13,0.00021
Brainsonastick,12,4,0,4,0,0.000642
ElectronGuru,12,2,0,2,0,0.000168
Introscopia,10,5,4,9,12,0.000479
Oberon_Swanson,16,0,0,0,0,0
PM_ME_UR_Definitions,11,3,0,3,0,0.000321
RoundCollection4196,42,4,3,7,12,0.000294
Treefly916,15,2,0,2,0,0.00032
boytoy421,14,3,3,6,11,0.00051
physioworld,19,2,65,67,10,0.000177
wingspantt,13,2,2,4,12,0.000168
Dazzling_Instance_57,38,8,15,23,12,0.000725
ElReyResident,13,6,5,11,12,0.000595
EvilPutlerBotZOV,13,7,6,13,12,0.000862
Flimsy_Sector_7127,11,2,4,6,12,0.000342
HalfDongDon,11,3,3,6,12,0.000595
HeavyDutyForks,12,6,0,6,0,0.000569
MKing150,29,7,10,17,11,0.000929
Nugtr,12,3,3,6,13,0.000379
Pasadenaian,13,3,2,5,14,0.000735
Primary-Slice-2505,10,5,5,10,13,0.000404
Puzzleheaded_Buy_921,10,9,2,11,14,0.000541
Slow_Principle_7079,14,5,0,5,0,0.000503
Vekktorrr,14,3,2,5,12,0.001626
db1965,18,2,0,2,0,0.000348
icenoid,16,3,6,9,13,0.000415
Dr0ff3ll,16,3,3,6,13,0.000221
Ok_Beat9172,11,5,3,8,12,0.000239
Tricky_Break_6533,29,5,3,8,12,0.000383
jamerson537,33,6,8,14,12,0.002146
man-vs-spider,21,3,23,26,11,0.000026
Competitive_Let_9644,26,4,4,8,11,0.000615
Sea-Volume-4746,35,15,9,24,12,0.000404
engineerosexual,10,2,2,4,12,0.000195
lobonmc,30,10,6,16,13,0.002526
MeanderingDuck,26,7,7,14,12,0.000334
Mono_Clear,37,4,2,6,12,0.001152
Razorwipe,18,8,2,10,14,0.00023
moonkipp_,16,4,15,19,12,0.00008
Equivalent-Pea8907,27,6,6,12,13,0.000263
Kitchen-War242,23,3,2,5,12,0.000733
thelovelykyle,11,2,0,2,0,0.000702
najumobi,11,0,201,201,11,0
Big_Black_Clock_____,18,6,6,12,12,0.012036
Champagne_of_piss,13,6,3,9,12,0.012158
Cranyx,18,5,4,9,11,0.022257
Describing_Donkeys,14,7,5,12,11,0.021853
HideGPOne,16,3,3,6,12,0.011239
In-Brightest-Day,20,10,7,17,13,0.010729
Iwantmypasswordback,10,3,5,8,12,0.009474
Miles_vel_Day,11,11,6,17,13,0.014997
Prestigious_Load1699,31,9,10,19,12,0.015289
Prior_Coyote_4376,31,17,12,29,12,0.020752
R_V_Z,15,10,6,16,13,0.01455
ResidentBackground35,10,8,5,13,12,0.013652
Slicelker,10,8,2,10,13,0.012286
UncleMeat11,27,8,9,17,11,0.018171
absolutefunkbucket,38,4,5,9,12,0.009565
beardsac,14,7,4,11,12,0.011751
foulpudding,21,10,5,15,13,0.01756
kwantsu-dudes,10,2,4,6,13,0.008754
midnight_toker22,11,5,5,10,12,0.012488
miklayn,12,5,4,9,12,0.012254
nickcan,16,4,7,11,12,0.009926
punninglinguist,14,14,2,16,12,0.019931
sarcasticorange,13,4,4,8,12,0.009098
slicerprime,14,9,6,15,12,0.018086
soapinmouth,11,3,3,6,12,0.010892
temujin321,20,6,12,18,12,0.015788
BigbunnyATK,27,7,6,13,13,0.000387
Adiv_Kedar2,31,10,8,18,13,0.001194
AltruisticCoach9217,16,2,1,3,14,0.000637
AmELiAs_OvERcHarGeS,10,7,3,10,13,0.000803
ArCovino,33,8,8,16,12,0.001117
Chompytul,32,6,4,10,13,0.000725
ClickclickClever,15,7,6,13,13,0.000969
Dr-Assbeard,82,9,8,17,13,0.00083
FreyyTheRed,10,3,4,7,12,0.001131
JawnSnuuu,12,3,2,5,13,0.000686
LifeofTino,10,3,2,5,11,0.006599
Live_for_Now,13,3,2,5,13,0.000807
Local_Ad7264,11,5,5,10,12,0.000681
MartinBP,13,7,6,13,12,0.002745
MattVideoHD,10,3,4,7,11,0.000826
MediocreEffectt,13,4,2,6,13,0.000677
MrWoodblockKowalski,14,5,2,7,12,0.003125
No-Coach533,11,5,4,9,12,0.000693
Odd-Bumblebee00,46,7,8,15,12,0.000758
OneEverHangs,11,2,3,5,13,0.000637
PM_ME_A_PM_PLEASE_PM,33,9,9,18,12,0.000848
PeterRum,11,3,2,5,13,0.000798
PhoenixKingMalekith,10,2,1,3,14,0.000641
Powerful-Cheetah6685,10,4,3,7,13,0.000743
Slothnazi,10,4,3,7,13,0.000854
Ssgtsniper,12,4,3,7,13,0.000988
TheEmporersFinest,13,3,4,7,12,0.000638
TheOneFreeEngineer,11,3,4,7,12,0.000669
Top-Egg1266,10,3,4,7,11,0.000772
Zakaru99,31,9,8,17,12,0.000802
actsqueeze,15,5,4,9,12,0.001028
billymartinkicksdirt,56,14,13,27,11,0.001402
breakbeforedawn,60,9,12,21,12,0.000995
charlieto0human,10,3,3,6,12,0.000683
harmoniaatlast,13,3,4,7,13,0.000736
iL0veLittleGirl,143,53,30,83,12,0.004181
ignoreme010101,28,6,5,11,13,0.00073
makeyousaywhut,12,3,2,5,13,0.000672
marxist-teddybear,14,3,4,7,12,0.000839
nidarus,20,7,6,13,13,0.000847
notyourgrandad,41,15,11,26,12,0.001348
oeg2415,39,16,6,22,12,0.002045
soldiergeneal,65,12,11,23,11,0.001103
toomanyshoeshelp,39,19,15,34,11,0.000989
yosisoy,11,2,1,3,13,0.000664
AureliasTenant,42,9,6,15,12,0.000556
Careless_Bat_9226,27,8,5,13,11,0.000507
ChampagneDividends,51,12,11,23,11,0.000425
DarkNo7318,20,5,4,9,12,0.000525
Diveblock,23,1,1,2,1,0.000321
FaithfulPichu,15,2,5,7,12,0.00065
Famous-ish,13,2,1,3,12,0.00033
Former_Indication172,10,4,4,8,12,0.000358
Frooctose,21,3,2,5,12,0.00033
Glad-Talk,14,3,2,5,12,0.000332
Grand_Fun6113,80,10,9,19,12,0.000687
Hunterofshadows,11,2,1,3,13,0.000322
Icy-Mortgage8742,10,4,3,7,12,0.000322
JJSF2021,28,4,2,6,12,0.000567
Karmaze,11,5,5,10,13,0.000701
MCRemix,11,2,1,3,13,0.000322
MobiusCube,30,7,5,12,13,0.000361
StartledMilk,13,2,1,3,13,0.001467
TehNudel,11,2,1,3,14,0.000386
Virtual_Piece,10,3,3,6,13,0.00033
Visible_Pair3017,23,4,4,8,12,0.000397
antiquatedadhesive,10,4,6,10,13,0.000365
illini02,16,4,4,8,12,0.000383
pzerr,11,2,2,4,1,0.000321
quix0te,15,2,2,4,12,0.000325
vbob99,16,4,3,7,11,0.000357
ricknightwood13,11,3,22,25,11,0.000319
Henrik3443,35,4,5,9,13,0.000242
3slimesinatrenchcoat,10,4,3,7,12,0.001529
ArtOfBBQ,28,10,11,21,12,0.001992
BigBoetje,24,6,3,9,12,0.001719
Electrical_Quiet43,13,2,4,6,12,0.001325
Honest_Initiative471,21,5,8,13,12,0.00147
IeyasuMcBob,18,4,4,8,11,0.001285
Imaginary_Exam1068,19,7,8,15,13,0.001354
MeasurementCreepy926,132,15,20,35,11,0.003495
MisfireMillennial,51,5,3,8,12,0.001414
PeepSkate,11,2,1,3,13,0.001153
Scarlet-kenku2500,10,3,1,4,1,0.001175
Seeker_Of_Toiletries,15,3,3,6,12,0.001364
Socialmediaisbroken,10,5,4,9,13,0.001306
Stock-Film-3609,31,7,6,13,13,0.002305
TellItLikeItIs1994,11,3,4,7,12,0.001468
TheFlyingSheeps,17,3,9,12,12,0.001327
TrickyTicket9400,12,12,3,15,13,0.001756
VirtualMoneyLover,56,13,18,31,12,0.002548
anaconda4290,69,5,8,13,12,0.001217
blangenie,14,4,4,8,11,0.00143
chrisfathead1,15,8,3,11,12,0.001606
explain_that_shit,11,10,8,18,12,0.001407
mikevago,12,3,3,6,12,0.001617
ow_bpx,14,3,3,6,13,0.00284
spiteful-vengeance,21,7,9,16,12,0.001435
swallowmoths,13,5,3,8,12,0.00286
AbjectForm5759,14,4,7,11,13,0.001275
DancingWithAWhiteHat,25,11,5,16,12,0.001698
GadgetGamer,11,6,5,11,13,0.001233
Mean_Lawfulness_9781,14,4,4,8,12,0.00118
gorkt,11,3,2,5,12,0.001502
strongerthenbefore20,11,0,34,34,12,0
CalebAsimov,17,3,5,8,13,0.000289
Ottomatik80,19,3,2,5,14,0.000162
PureAntimatter,11,2,1,3,13,0.000429
SRIrwinkill,31,2,4,6,13,0.00017
Woah_Mad_Frollick,14,2,1,3,2,0.000152
actuallychrisgillen,20,2,1,3,14,0.000152
ameis314,28,5,2,7,13,0.000678
bawdiepie,11,3,2,5,13,0.000162
catdude142,39,3,5,8,14,0.000155
chinmakes5,12,6,1,7,13,0.005002
firematt422,34,4,4,8,11,0.000649
grottohopper,11,2,1,3,15,0.000153
hillsfar,10,2,2,4,13,0.000206
thatoneguy54,19,6,3,9,13,0.000622
thelastvortigaunt,12,2,1,3,14,0.000152
MiddleList52,11,3,3,6,12,0.000601
RealJohnBobJoe,48,4,2,6,13,0.000448
mjwza,15,6,2,8,13,0.000605
sophisticaden_,14,2,1,3,13,0.00034
AlienReprisal,17,11,5,16,12,0.01255
GoldenStarsButter,16,3,4,7,12,0.013455
StealUr_Face,11,4,2,6,13,0.005347
TheyGaveMeThisTrain,13,7,3,10,13,0.004716
bearrosaurus,14,9,5,14,11,0.01121
chronberries,28,9,6,15,12,0.006914
Both-Estimate-5641,43,7,16,23,12,0.000552
Flymsi,12,3,3,6,13,0.000394
LynnSeattle,39,12,12,24,11,0.002201
Marty-the-monkey,28,4,1,5,12,0.000694
NefariousnessMost660,23,3,6,9,12,0.000369
NonbinaryYolo,14,3,2,5,13,0.000339
ParfaitBurnera,11,3,2,5,13,0.000363
Puzzleheaded_Mix4160,24,6,4,10,13,0.000363
RadiantHC,53,9,14,23,12,0.000821
Salty_Map_9085,21,4,4,8,13,0.000338
Tirriforma,19,5,4,9,12,0.000375
ToSAhri,37,9,11,20,11,0.000637
boredtxan,15,3,3,6,13,0.000344
ellirae,17,5,4,9,13,0.000477
harpyprincess,31,7,8,15,13,0.000742
plantfumigator,12,5,5,10,12,0.000471
trickmirrorball,22,4,2,6,12,0.000401
FractionalFibonacci,11,2,1,3,13,0.000213
GtBsyLvng,14,3,2,5,13,0.000226
Limmeryc,16,5,5,10,12,0.001006
RaspberryLast170,11,3,2,5,12,0.000216
Tommyblockhead20,12,3,3,6,12,0.001234
ghotier,217,30,32,62,12,0.002937
Crew_1996,15,4,5,9,12,0.00026
yelbesed,10,0,2,2,14,0
---AI---,30,7,8,15,12,0.000265
ConsultJimMoriarty,50,19,12,31,12,0.000485
body_oil_glass_view,15,2,1,3,14,0.000016
carterthecomic,37,7,6,13,12,0.000238
marzaksar,14,4,3,7,12,0.000052
Horse__Latitudes,42,3,10,13,12,0.000058
LookAtMeNow247,22,11,10,21,12,0.009879
-HeisenBird-,10,2,1,3,13,0.000013
Bonky147,12,8,4,12,13,0.004425
RegressToTheMean,30,20,10,30,11,0.008051
ides205,27,7,6,13,12,0.010576
-spicychilli-,20,9,2,11,13,0.000305
lonecylinder,46,8,9,17,13,0.000303
00PT,17,4,5,9,12,0.000048
Icy_River_8259,76,14,10,24,11,0.001162
sapphireminds,55,10,9,19,11,0.000801
00rb,29,6,7,13,12,0.000004
Boisemeateater,26,5,1,6,14,0.000056
IdeaMotor9451,12,1,1,2,13,0.000054
Story_Man_75,21,11,4,15,11,0.00045
Laesslie,23,6,6,12,12,0.000245
outestiers,66,13,15,28,12,0.000911
0nlyhalfjewish,31,1,2,3,14,0.000001
LostMyKarmaElSegundo,12,4,5,9,15,0.000029
1-objective-opinion,19,4,4,8,12,0.000438
steponmedaddies,38,5,11,16,12,0.000345
101ina45,14,4,5,9,12,0.00174
Unfounded_archeology,15,4,5,9,13,0.002158
FudGidly,11,2,3,5,12,0.000849
conduffchill,12,5,4,9,12,0.000211
AdministrativeSet419,10,11,4,15,13,0.001688
BitcoinMD,18,6,4,10,12,0.000516
CincyAnarchy,20,10,5,15,11,0.001153
Cytothesis,10,4,2,6,12,0.000423
Deadpoint,18,6,5,11,12,0.000561
Gym_Noob134,10,2,2,4,12,0.000309
JRingo1369,19,4,6,10,12,0.000367
MercuryChaos,12,2,1,3,12,0.000271
Morasain,11,4,4,8,12,0.000385
Nojopar,41,9,11,20,11,0.001237
Overlook-237,20,5,6,11,12,0.00038
PandaMime_421,26,9,9,18,11,0.000567
SilverWear5467,19,4,3,7,12,0.001976
amopeyzoolion,10,2,5,7,12,0.000268
bossmt_2,12,8,3,11,12,0.000313
energirl,16,4,5,9,12,0.000447
hi_imjoey,11,3,1,4,1,0.00045
mrGeaRbOx,30,4,3,7,12,0.000456
pyramidalembargo,17,3,2,5,12,0.000266
tenfolddamage,19,2,2,4,12,0.000266
GiddyChild,12,1,1,2,14,0.000012
68_hi,18,1,2,3,12,0.00039
Cornwallis400,17,9,3,12,13,0.000643
PlayfulRemote9,18,5,5,10,12,0.000172
DidjaSeeItKid,11,1,3,4,13,0.000573
straightcashhomey29,16,1,1,2,13,0.000573
NuncErgoFacite,10,2,1,3,13,0.000428
TexanInNebraska,25,5,5,10,13,0.00022
The_Hungry_Grizzly,11,3,3,6,14,0.000012
cochlearist,15,4,1,5,15,0.000118
ucotcvyvov,19,3,1,4,14,0.000016
Jmcduff5,22,8,4,12,13,0.000673
AdmiralSaturyn,68,33,23,56,12,0.028899
233C,16,5,3,8,12,0.001131
Choano,13,7,4,11,13,0.000042
2apple-pie2,10,2,3,5,12,0.000009
CritterFan28,14,5,5,10,12,0.000116
TheBossOfItAll,26,10,7,17,12,0.000267
2dogslife,26,1,1,2,14,0
BeatificBanana,28,6,4,10,13,0
Imabigdealonredditny,12,0,0,0,0,0
BadIdeaSociety,11,7,3,10,13,0.012036
BadNewsSherBear,11,3,6,9,12,0.001717
Salsa_and_Light2,49,9,14,23,12,0.000399
Wombattington,17,3,4,7,13,0.000118
RL203,16,6,3,9,13,0.004737
cpatkyanks24,11,4,1,5,13,0.002147
ThePoppaJ,12,3,2,5,13,0.005293
Malibu921,18,2,3,5,13,0.000095
TheDuckOnQuack,10,4,2,6,13,0.000687
Junior_Razzmatazz164,18,4,3,7,13,0.000073
thatnameagain,28,5,7,12,13,0.00006
Down_D_Stairz,13,8,6,14,13,0.000112
4rch1t3ct,11,4,3,7,13,0.000088
BUUAHAHAHA,21,20,5,25,13,0.001284
Dooey,13,1,1,2,14,0.000004
cballowe,30,15,8,23,12,0.008468
6a6566663437,11,3,1,4,13,0.000302
6data,16,2,4,6,13,0.000012
Ok-Anteater_6635x,15,7,4,11,12,0.000108
Pressondude,13,6,5,11,12,0.000119
rewt127,22,7,7,14,12,0.000243
7625607,12,1,1,2,1,0
Ok_Tonight_3703,11,2,0,2,0,0
Tydeeeee,33,3,1,4,12,0.000696
bezjones,11,1,1,2,12,0.000126
Baselines_shift,29,5,8,13,11,0.006273
nope-nope-nope-nop,35,8,8,16,12,0.007024
ZeBigD23,19,14,7,21,12,0.0164
AOWLock1,28,8,5,13,12,0.000353
HKBFG,11,2,3,5,12,0.000015
flaminhotcheetos_,10,2,1,3,13,0.000037
ASpaceOstrich,12,3,3,6,11,0.000078
Sevourn,48,7,6,13,11,0.0001
datingcoach32,24,4,6,10,11,0.0004
ATotalCassegrain,16,3,2,5,13,0.000033
burnbobghostpants,13,4,5,9,12,0.000019
AVGJOE78,22,7,9,16,12,0.00015
Head_Personality_394,20,4,6,10,13,0.000069
Itzko123,12,3,3,6,13,0.000018
Physical-Dingo-6683,76,31,29,60,11,0.000975
communityneedle,11,10,3,13,13,0.000139
AVeryBadMon,20,5,5,10,13,0.002383
MissMenace101,58,6,20,26,12,0.00173
Xeltar,20,8,12,20,12,0.005759
Fit_Cut_4238,14,4,6,10,12,0.001796
AWildReaperAppears,29,5,5,10,12,0.000075
And_Justice,51,13,11,24,12,0.000498
D_Prime94,10,1,1,2,13,0.000001
NotACommie24,31,7,9,16,12,0.000139
Union_Jack_1,36,6,6,12,11,0.000305
rememberimapersontoo,34,7,2,9,12,0.000001
A_Typicalperson,14,2,2,4,13,0.000045
Riptiidex,21,5,5,10,12,0.000769
A_little_lady,10,1,1,2,12,0
ImpossibleReason2204,65,8,5,13,11,0
Aardwolfington,15,2,2,4,13,0.000083
GiveMeAHeartOfFlesh,40,4,5,9,12,0.000179
bionicfeetgrl,25,8,7,15,13,0.006854
DataTouch12,37,3,2,5,12,0.000083
Acceptable-Remove792,20,3,1,4,14,0.000038
health_throwaway195,26,3,4,7,13,0.000006
Mejari,34,5,11,16,12,0.000038
TurtleTurtleFTW,10,1,1,2,13,0.000011
Xicadarksoul,24,5,6,11,13,0.000205
Minute-Employ-4964,11,3,4,7,12,0.000065
Shepard_Normandy,26,3,3,6,13,0.000036
rollingrock16,12,7,2,9,13,0.001355
way2lazy2care,39,17,15,32,12,0.007097
AccordingMedicine129,11,2,3,5,11,0
SimonPopeDK,24,3,4,7,11,0.000002
chessboxer4,20,3,5,8,11,0.000002
AccountantsNiece,11,3,6,9,13,0.000181
tanatan88,11,9,5,14,14,0.000282
Accurate-Neck6933,21,2,2,4,12,0.000014
Princess-Eilonwy,26,8,3,11,12,0.000006
vanastalem,10,2,3,5,11,0.000002
Criminal_of_Thought,11,6,5,11,12,0.000129
Acrobatic-Narwhal-62,10,2,3,5,13,0.000019
Broseph_Heller,27,14,9,23,12,0.000563
TNine227,28,8,9,17,13,0.000274
drtropo,13,2,3,5,13,0.000055
Acrobatic_Ear6773,10,5,5,10,12,0.000033
Apprehensive_Set_105,16,3,3,6,13,0.000005
BrazilBound25,13,5,4,9,12,0.000027
ItsFuckingScience,10,6,4,10,13,0.000099
ActualDW,11,1,1,2,14,0.000003
AgitatorsAnonymous,12,4,5,9,13,0.002594
AdComprehensive960,18,2,4,6,13,0.000184
Cerulean_IsFancyBlue,11,4,1,5,14,0.000209
Puzzleheaded_Ant3378,18,2,3,5,14,0.000014
ShakyTheBear,10,2,1,3,1,0.000035
youwillbechallenged,26,11,9,20,12,0.011365
DuePersonality8585,16,3,3,6,12,0.000125
QuantumR4ge,21,5,9,14,11,0.000607
AdImmediate9569,17,6,6,12,12,0.000241
Beautiful-Loss7663,39,13,11,24,12,0.000414
Silon17,12,7,3,10,12,0.00009
redditratman,17,8,5,13,12,0.000314
JustMeAndMyKnickas,13,2,2,4,13,0.003101
_Floriduh_,15,10,7,17,13,0.00601
blaqsupaman,12,7,7,14,12,0.006111
Adequate_Images,25,2,2,4,12,0.000035
Brief-Bat7754,14,3,5,8,12,0.000659
Dregride,23,6,7,13,12,0.000341
Mad_Maddin,24,5,11,16,12,0.000248
annabananaberry,46,12,12,24,12,0.000265
AdmiralDalaa,13,1,3,4,12,0.000007
DerekVanGorder,13,3,5,8,12,0.000109
InfamousDeer,14,12,6,18,11,0.000202
CaptainoftheVessel,15,7,7,14,13,0.005739
Adorable-Bobcat-2238,14,1,2,3,14,0
QuestionMaker207,10,1,1,2,2,0
clauclauclaudia,14,3,4,7,13,0.000005
Beneficial-Set2738,31,3,4,7,12,0.000075
AdvancedMasterMode,10,2,3,5,13,0.000042
Unique_Statement7811,32,8,9,17,13,0.000316
arrogant_ambassador,19,12,7,19,12,0.000287
AffectionateStudy496,14,3,7,10,12,0.000206
LotsoPasta,11,5,5,10,13,0.000331
SannySen,39,11,8,19,13,0.000399
Affectionate_Top340,21,7,5,12,12,0.003935
Aggressica,12,1,1,2,15,0
Expert_Slip7543,10,1,1,2,14,0
Agile_Menu_9776,10,0,5,5,12,0
Novel_Fox,19,2,3,5,12,0
PikaV2002,30,3,4,7,11,0
TheDarkHelmet1985,47,5,5,10,12,0.000013
keesouth,36,1,1,2,12,0
lifeinwentworth,29,2,4,6,13,0.000006
DeadlyPython79,52,9,13,22,12,0.001245
KJongsDongUnYourFace,14,9,4,13,12,0.000338
michaelcanav,13,5,3,8,11,0.000369
Impressive_Ad_5614,26,6,4,10,12,0.00012
KittyQueen63,50,9,7,16,12,0.000371
Obsessive0551,13,4,3,7,11,0.000029
Agitated_Elephant469,13,4,4,8,12,0.001768
imatexass,17,2,3,5,12,0.000368
MinneapolisJones12,13,6,5,11,12,0.00014
ToranjaNuclear,29,6,8,14,12,0.000238
AhsokaSolo,36,4,5,9,12,0.000232
DJFrostyTips,33,3,3,6,13,0.000098
ImDeputyDurland,18,2,2,4,13,0.000117
Opening_Acadia1843,14,6,5,11,12,0.000178
AidenFested,12,2,2,4,13,0.000007
fourmesinatrenchcoat,15,6,3,9,12,0.000134
AlabasterPelican,11,5,2,7,12,0.000184
faux-fox-paws,96,32,21,53,11,0.001018
Zwicker101,42,7,5,12,13,0.001302
flatscreeen,13,2,2,4,12,0.000176
Streambotnt,12,6,5,11,12,0.000467
bearsnchairs,26,4,6,10,11,0.000091
Alev233,12,2,3,5,12,0.000079
TheSameGamer651,11,4,5,9,12,0.004658
Xanto97,26,14,7,21,12,0.005523
iguacu,10,4,1,5,13,0.006045
CSIBNX,10,3,3,6,13,0.000904
Alien_invader44,14,5,2,7,13,0.00037
Alive-Difference3905,11,2,4,6,12,0.000004
Disastrous_Onion_958,32,4,4,8,12,0.000083
Hodgkisl,13,7,3,10,13,0.000253
happyinheart,31,9,16,25,12,0.000364
AlkatrazzPrime,29,3,3,6,13,0.000114
Past_Scholar3723,18,3,6,9,13,0.000019
Allaboutbird,47,9,6,15,12,0
FlipFlopFlappityJack,17,2,4,6,11,0.000004
LiveKindly01,82,15,14,29,11,0.000015
MaeSilver909,10,2,0,2,0,0.000003
Malice_A4thot,12,1,1,2,15,0.000003
adventuresofViolet,36,6,2,8,12,0.000042
Allenobriann,23,5,5,10,12,0.000117
mickeyanonymousse,18,5,5,10,10,0.000215
ogjaspertheghost,43,8,8,16,11,0.000097
Alternative-Cut-7409,10,1,1,2,13,0.00006
Alternative-Redditer,39,5,6,11,11,0.000049
Donutsmell,20,3,0,3,0,0.000004
SuccessfulAd4606,27,3,3,6,12,0.000396
West_House_2085,61,3,4,7,11,0.000004
Alternative-Smile366,10,1,1,2,13,0.000015
TangoJavaTJ,94,29,16,45,11,0.000661
clowncarl,14,6,3,9,13,0.00016
Ok_Soft_4575,51,10,10,20,11,0.000727
Alternative_Switch39,22,3,6,9,12,0.000019
Puzzleheaded_Ad_5710,29,4,3,7,14,0.000028
RedSpaceman,20,4,6,10,12,0.000063
cheeruphumanity,11,8,4,12,13,0.000241
l_Paddystinian_l,11,3,4,7,12,0.000089
temujin94,16,2,4,6,12,0.000124
Altruistic-Berry-31,18,4,4,8,13,0.000033
BeardedDragon1917,10,1,1,2,14,0.000004
LongjumpingSeaweed36,14,2,2,4,13,0.000049
McKoijion,17,3,3,6,12,0.000087
Whatever4M,11,2,2,4,13,0.000043
DeepShill,12,8,5,13,12,0.006392
AlwaysHigh27,17,3,2,5,14,0.000045
Shmuckle2,16,6,4,10,13,0.000159
Jealous-Factor7345,19,5,5,10,12,0.000144
StobbstheTiger,30,11,8,19,13,0.000309
yeahmanbombclaut,15,4,3,7,12,0.00011
Odd-Zombie-5972,11,4,3,7,13,0.000008
No_Cheesecake_9019,17,3,3,6,12,0.000625
Anameillforge,14,3,2,5,2,0
Historical_Wing3120,14,1,1,2,3,0
makethatnoise,11,2,2,4,2,0
Finklesfudge,16,5,6,11,12,0.000578
Fulg3n,32,7,7,14,11,0.000131
Thriftless_Ambition,22,9,6,15,12,0.016321
magus678,15,4,7,11,13,0.001528
ClueMaterial,35,5,5,10,12,0.000417
Craig-Tea-Nelson,12,4,5,9,12,0.00018
Odd-Influence-5250,11,4,4,8,12,0.000131
Individual642,20,7,7,14,13,0.00011
TheLandOfConfusion,11,2,2,4,13,0.00003
Legitimate_Gas2966,10,1,1,2,13,0.000015
Massive_Wealth42069,12,4,3,7,12,0.000092
Paradoxe-999,36,7,9,16,11,0.000301
Sulfamide,43,10,11,21,12,0.014597
Wellington_Wearer,16,5,6,11,12,0.000194
_zhz_,11,2,4,6,12,0.000061
GSilky,23,4,3,7,13,0.000091
HOLEPUNCHYOUREYELIDS,15,2,3,5,13,0.000003
JonnyAU,13,1,2,3,13,0.000002
Major2Minor,13,1,2,3,14,0.000002
blackkettle,10,2,0,2,0,0.000018
epelle9,27,1,4,5,13,0.000002
teflondung,21,3,3,6,12,0.00022
Anon28301,15,6,6,12,12,0.000063
MadGobot,15,1,1,2,13,0.000008
BoratImpression94,25,5,7,12,12,0.00159
InterestingTheory9,35,4,5,9,12,0.000086
Overall-Ratio-1446,39,7,11,18,12,0.00012
WhiteGold_Welder,13,4,2,6,12,0.0016
runwith,11,1,1,2,12,0.000048
TuggenDixon,23,8,5,13,12,0.000362
wasabiiii,10,2,3,5,12,0.000077
OstentatiousBear,15,8,5,13,13,0.001316
Trauma_Hawks,19,7,6,13,11,0.000604
AnyBudget5507,11,1,2,3,1,0
Savitar5510,24,1,1,2,2,0
Anzai,13,3,3,6,13,0.000659
B9F2FF,19,4,4,8,13,0.000009
Proud-Sandwich8516,15,3,4,7,12,0.000048
Apart-Survey,10,1,4,5,12,0
Commonscents2say,12,3,2,5,12,0
Lmaris,25,5,7,12,12,0
annang,20,3,3,6,12,0
unsafeideas,33,5,3,8,11,0.000023
Rufus_TBarleysheath,23,3,4,7,12,0.00043
Apathetic_Villainess,18,2,2,4,12,0.000199
Technical-Revenue-48,16,5,5,10,12,0.000106
irespectwomenlol,10,7,3,10,12,0.000506
ApetteRiche,12,3,5,8,14,0.000031
Hefty-Reaction-3028,20,10,8,18,12,0.000448
Minty_Widower,11,2,2,4,13,0.00002
Osr0,10,3,2,5,13,0.00014
Zee216,11,1,2,3,12,0.000006
radred609,17,5,8,13,11,0.000089
Apprehensive-Top3756,11,1,2,3,12,0.000002
Apprehensive_Run238,36,8,5,13,13,0.000024
ArguteTrickster,40,7,8,15,12,0.000288
Gullible-Test8204,17,4,5,9,12,0.000019
Infinite_Collar_7610,13,1,2,3,13,0.000001
whatsitallabout999,10,5,4,9,12,0.000047
ExaggeratedSnails,15,2,2,4,13,0.000195
mambotomato,11,2,2,4,13,0.000006
BlueCollarRevolt,18,4,5,9,12,0.000154
Ndlburner,13,4,3,7,13,0.00006
PhysicalWave454,11,4,3,7,13,0.000024
Archophob,12,3,3,6,13,0.000128
Easy_Masterpiece_605,19,12,5,17,13,0.000471
Biffs_bunny,34,11,7,18,12,0.000374
Rawlott1620,25,6,8,14,12,0.000259
allbusiness512,15,4,4,8,13,0.000094
iTonguePunchStarfish,11,4,5,9,12,0.00005
ArielTheKidd,19,1,2,3,13,0.000004
Aromatic-Victory4210,11,0,3,3,11,0
South_Industry_1953,124,11,7,18,10,0.000001
Time-Tie-231,36,3,0,3,0,0
Wonderful_Two_6710,13,2,0,2,0,0
MakeItCelestial,10,1,2,3,12,0.000009
Ok-Hunt7450,30,4,5,9,12,0.000332
Super_Eagle1198,17,3,3,6,12,0.000044
Thinslayer,11,4,3,7,12,0.000065
AryaStark1313,18,1,3,4,12,0.000001
Bitter-Paramedic-531,16,4,1,5,13,0
Cudi_buddy,12,4,3,7,12,0.000014
Oyster5436,18,4,2,6,11,0.000001
Telcontar77,11,3,6,9,12,0.00296
AskingToFeminists,72,4,4,8,12,0.000226
OldSky7061,33,5,5,10,12,0.000352
leekeater,15,5,4,9,13,0.00022
Asleep_Region,11,2,1,3,13,0
myssi24,13,2,3,5,12,0
traumfisch,22,1,2,3,13,0.000002
SocksRocksDocks,36,5,3,8,13,0.000204
Unfair_Explanation53,15,4,4,8,12,0.000444
AsterKando,15,3,2,5,13,0.000011
CharmCityKid09,14,6,6,12,12,0.000108
Ornithopter1,38,5,8,13,12,0.000067
Theycallmeahmed_,12,8,4,12,13,0.000126
petitememer,10,4,3,7,13,0.000041
Aunt_Anne,11,0,0,0,0,0
Wise_Owl5404,19,6,3,9,13,0.000003
Evil_B2,29,6,5,11,12,0.013612
Rough_Butterfly2932,14,4,6,10,12,0.000228
Nate-dude,12,4,3,7,12,0.000136
Rollingforest757,27,7,11,18,11,0.000166
Avalonisle16,10,2,2,4,14,0
Bittybellie,15,2,1,3,15,0
CandylandCanada,53,5,4,9,13,0
Entire-Ad2058,25,4,5,9,11,0.00036
Aware_Acanthaceae_78,11,0,2,2,12,0
StAlvis,80,15,4,19,11,0.000003
smbpy7,75,5,9,14,12,0
Friendly-Many8202,13,14,2,16,13,0.000765
gemunicornvr,144,9,15,24,11,0.000314
hogsucker,13,8,7,15,12,0.000363
JefeRex,20,6,5,11,13,0.000028
Ptcruz,17,2,4,6,12,0.00021
BJPark,16,7,3,10,12,0.003955
DefaultProphet,15,5,2,7,12,0.002244
NigroqueSimillima,15,3,3,6,12,0.002772
No_Passion_9819,50,2,4,6,13,0.002718
Sea-Document-974,12,1,2,3,12,0.000982
curly_spork,11,5,3,8,12,0.005459
Revachol_Dawn,90,13,15,28,12,0.000533
DumboWumbo073,13,3,4,7,13,0.001198
Background-Cow8401,16,1,1,2,14,0
Possible_Emergency_9,13,2,1,3,13,0
Background-Key-457,12,12,3,15,12,0.000475
Every_Single_Bee,15,4,4,8,12,0.00003
Z86144,14,2,2,4,12,0.000009
BadHabitOmni,21,4,5,9,11,0.008892
Pandaaaa33,10,2,2,4,12,0.004113
Ballatik,10,1,1,2,13,0.00019
BalloonShip,10,0,2,2,14,0
BigBigBigTree,35,8,4,12,13,0.000033
almaperdida99,18,5,1,6,14,0.000026
KingKnotts,63,12,16,28,12,0.009301
BarBryzze,17,3,3,6,13,0.000007
Sensitive_Housing_85,13,3,3,6,12,0.000052
TheFoxer1,14,1,1,2,14,0
mauri9998,38,5,6,11,12,0.000127
Bartok_The_Batty,22,0,2,2,13,0
GoodQueenFluffenChop,11,1,1,2,1,0
Shadow4summer,22,5,9,14,12,0
Budget_Llama_Shoes,32,9,7,16,12,0.008311
hunbot19,16,6,7,13,12,0.000213
dEm3Izan,19,4,6,10,13,0.000105
Bast_OE,11,1,2,3,13,0.000003
BeGoodToEverybody123,21,3,2,5,12,0.000252
YNABDisciple,24,7,3,10,13,0.000554
Be_Kind_And_Happy,18,1,1,2,13,0.00052
LavishnessGeneral,10,1,1,2,14,0
No-Strawberry-5804,13,3,2,5,14,0
Turbulent_Cow2355,43,8,8,16,12,0.000023
FinalSealBearerr,46,8,12,20,12,0.000437
SinesPi,11,2,3,5,12,0.000044
zacsxe,12,2,1,3,13,0.00009
Beginning_Cupcake_45,12,4,7,11,12,0.000145
idontknowhow2reddit,28,21,4,25,13,0.002086
north_canadian_ice,11,6,4,10,12,0.000367
park777,18,2,7,9,12,0.000026
BigMcLargeHuge8989,12,5,4,9,13,0.00019
keepin-it-sleezy,15,4,4,8,13,0.000065
ergo_incognito,21,6,3,9,13,0.000094
Best_Pants,17,4,3,7,12,0.000091
DreamofCommunism,18,2,4,6,12,0.000005
Better-Needleworker6,15,3,3,6,11,0.000216
BidRevolutionary945,11,1,1,2,14,0
NeatNefariousness1,15,1,2,3,13,0
Oishiio42,36,10,7,17,11,0.000319
Zequen,25,9,4,13,12,0.000934
Big-Imagination4377,27,3,4,7,13,0
ConflictGullible392,83,6,2,8,14,0.000002
Exotic-Knowledge-243,24,3,2,5,13,0
Similar_Pineapple418,15,6,2,8,14,0
Big-Maintenance2544,11,1,5,6,13,0.000015
pump1ng_,13,3,4,7,12,0.000026
ButterscotchIll1523,11,2,3,5,13,0
sunlightanddoghair,10,1,1,2,14,0
Just_Nefariousness55,10,1,2,3,13,0.000004
Colley619,10,3,2,5,13,0.000115
BigGreenBillyGoat,24,1,1,2,14,0
gdognoseit,18,1,2,3,13,0
BigMax,15,1,1,2,1,0
NefariousnessSweet70,13,1,1,2,1,0
LotionedBoner,12,4,6,10,13,0.000176
wheres_my_hat,22,6,5,11,11,0.011224
Jaymoacp,12,8,5,13,12,0.000261
Competitive_Jello531,17,3,4,7,12,0.000024
Rare-Ad-8087,12,3,4,7,11,0.000015
mangababe,18,7,7,14,11,0.000224
Critical-Buy-8677,22,5,4,9,12,0.000185
Cynthesyss,17,5,3,8,13,0.000135
Frientlies,14,2,2,4,13,0.000102
Quiet_Fan_7008,11,4,3,7,13,0.000161
Sparrowphone,27,5,4,9,12,0.000188
VPackardPersuadedMe,12,4,2,6,13,0.000149
pearl_harbour1941,28,2,2,4,13,0.000108
BillyBobJangles,15,2,3,5,15,0.000001
Ok-Question1597,12,2,2,4,14,0.000005
Workingclassstoner,10,2,2,4,14,0.000009
cwaterbottom,11,2,0,2,0,0.000096
Rhomya,14,5,5,10,13,0.000334
username_blex,26,7,10,17,11,0.000096
shadesofnavy,18,4,7,11,12,0.000232
Possible-Tangelo9344,30,4,3,7,12,0
Rindan,11,2,2,4,12,0.002625
Waterwoo,18,5,7,12,12,0.003638
trabajoderoger,25,7,8,15,12,0.000196
NonsensePlanet,10,3,2,5,13,0.001292
SilverTumbleweed5546,15,3,3,6,11,0.000073
BlooregardQKazoo,16,1,1,2,14,0.000001
More_Mind6869,45,8,8,16,13,0.000311
Bludiamond56,33,2,2,4,12,0
RelativePickle8333,11,1,2,3,13,0
StructEngineer91,10,1,3,4,11,0
LeRoyRouge,26,5,5,10,13,0.008049
StampMcfury,12,8,5,13,13,0.003297
Vegetable-Two-4644,16,7,6,13,12,0.000834
Happy_Tip_2091,15,4,1,5,12,0.018034
Pale_Zebra8082,12,1,1,2,12,0.010545
Remarkable_Aside1381,13,3,6,9,12,0.011294
Santosp3,12,3,2,5,12,0.01266
SoggyGrayDuck,16,8,7,15,12,0.017225
StopStealingMyShit,19,5,4,9,12,0.012289
_Age_Sex_Location_,12,1,6,7,11,0.010545
firewatch959,27,4,8,12,12,0.003746
Useful-Back-4816,24,2,6,8,13,0.000004
FrickinLazerBeams,45,9,11,20,13,0.000179
Bolt_EV,12,1,1,2,13,0.000447
BoobySlap_0506,16,0,2,2,12,0
Pandora2304,19,2,3,5,11,0
SurroundTiny,10,4,2,6,13,0.000126
Both_Bear3643,13,2,5,7,12,0.000238
ChihuahuaNoob,32,5,7,12,12,0.000533
Br0wnieSundae,13,0,2,2,13,0
Brave-Silver8736,12,1,2,3,14,0.000002
WVUEnchilada,24,4,3,7,13,0.0001
BraveOpinion3289,11,3,3,6,13,0
CarlEatsShoes,11,1,2,3,12,0
Jocelyn-1973,10,3,0,3,0,0
NobleNop,28,3,4,7,13,0
Pip-Pipes,13,2,3,5,13,0.000005
Brikish,11,3,3,6,15,0.000001
SideEmbarrassed1611,13,1,1,2,16,0
Trawling_,16,3,8,11,12,0.000074
Darkmayday,21,5,5,10,13,0.00017
Bronze_Rager,13,2,3,5,12,0.000165
Openmindhobo,12,3,2,5,12,0.000286
bidenxtrumpxoxo2,10,2,2,4,13,0.000085
IEATASSETS,26,5,4,9,13,0.000115
im-obsolete,14,6,4,10,12,0.000256
EveningImaginary1380,12,4,4,8,12,0.000214
Financial_Change_183,11,4,2,6,13,0.000143
BuHoGPaD,12,3,5,8,11,0.00001
Swimming-City-5001,105,14,5,19,10,0.000006
mrspyguy,10,6,2,8,12,0.000087
owls_and_cardinals,17,5,3,8,12,0.000001
Repeatitpete,20,11,8,19,13,0.003908
Stunning-Equipment32,15,4,2,6,13,0.0021
Zestyclose-Cat-1093,21,3,3,6,12,0.001146
BurtMSnakehole,29,3,4,7,13,0.000003
Dependent-Canary-514,17,5,3,8,12,0.000003
OutSourcingJesus,22,6,2,8,13,0.000154
architect___,10,2,4,6,13,0.000278
mikefick21,32,2,6,8,12,0
ButterLettuth,11,2,1,3,13,0.000679
Somebody_81,32,4,7,11,12,0
Mrs_Noelle15,10,4,3,7,13,0.000148
Sm3x,18,6,5,11,13,0.000335
lily-prince,12,2,3,5,14,0.00003
CHiuso,11,3,3,6,13,0.00004
COskibunnie,18,3,3,6,16,0
Moogatron88,14,1,1,2,17,0
Temporary_Row_7572,10,3,3,6,16,0
WearyMatter,10,3,2,5,15,0.000006
Hungry-Struggle-1448,57,11,15,26,11,0.001027
thedamnoftinkers,10,1,1,2,13,0.000039
Calaveras-Metal,25,4,5,9,12,0.000123
Steamed_Memes24,13,4,4,8,13,0.000152
mossed2012,10,4,3,7,13,0.000052
CallMeMrPeaches,11,2,2,4,13,0.000003
ellathefairy,12,3,3,6,13,0.000003
Calm-Purchase-8044,24,4,2,6,16,0.000039
ImprovementPutrid441,16,1,1,2,17,0
maychoz,10,2,3,5,15,0
Calm_Marsupial3123,25,5,3,8,12,0.00001
Kitastrophe8503,36,12,8,20,11,0.000007
Mrminecrafthimself,16,3,5,8,12,0
ThePhilVv,36,12,13,25,12,0.000055
Candid-Narwhal-3215,23,2,1,3,15,0.000003
SallyKait,11,1,2,3,14,0
coleman57,18,1,1,2,14,0.000021
CandidateNew3518,16,4,7,11,12,0.000085
Most_Finger,12,3,2,5,12,0.000101
Counther,19,1,1,2,14,0
KaliTheBlaze,32,6,6,12,12,0
Low_Armadillo3366,10,1,2,3,13,0
CanoodlingCockatoo,46,7,12,19,10,0.000041
Direct-Bread,10,4,4,8,12,0.000065
OwnEntertainment701,20,3,6,9,11,0.000006
PsychologicalLuck343,10,4,3,7,11,0.000011
TFOLLT,22,2,2,4,11,0.000007
roskybosky,34,5,7,12,11,0.000011
wiseduckling,11,3,0,3,0,0.000006
Major-Platypus2092,21,4,3,7,12,0.000101
raerlynn,10,3,2,5,12,0.000445
redroserequiems,35,5,6,11,12,0.000086
KoldPurchase,13,8,5,13,12,0.002496
tlopez14,20,11,9,20,12,0.009432
Careless_Cicada9123,11,4,2,6,11,0.000481
throwawaytalks25,154,15,12,27,10,0.000319
Mundane-Currency5088,29,3,2,5,11,0.000004
CarmenDeeJay,14,2,4,6,11,0.000022
Fresh_Caramel8148,15,2,0,2,0,0
Objective-Arugula-17,18,5,4,9,12,0.00004
Usrname52,23,7,2,9,12,0
Cazzah,13,7,4,11,13,0.00008
Kithslayer,17,3,3,6,14,0.000048
Prysorra2,11,3,6,9,12,0.00212
CerealExprmntz,17,3,2,5,12,0.000139
Certain-Definition51,13,2,3,5,13,0.000008
punta_del_diablo,14,5,4,9,12,0.000095
CertainGoon,11,1,1,2,13,0
Assume_Utopia,13,5,0,5,0,0.000005
Stunning-Drawing8240,15,3,4,7,14,0.000003
ChadWestPaints,13,2,4,6,12,0.004408
courtd93,30,6,7,13,12,0.000202
Humble-Progress8295,10,2,4,6,12,0.000009
DevA248,38,11,15,26,12,0.000298
JellyfishSolid2216,18,7,8,15,13,0.00009
Pac_Eddy,13,4,4,8,12,0.000042
SkunkApeForPresident,12,3,4,7,13,0.000009
Charming_Variation76,10,0,2,2,13,0
pottersquash,120,18,10,28,12,0.000009
wecouldhaveitsogood,11,3,2,5,13,0
CheezeLoueez08,39,4,5,9,12,0
agoldgold,12,6,2,8,13,0
jmking,11,1,2,3,13,0
ladancer22,10,2,2,4,11,0
CherryblockRedWine,17,1,1,2,14,0
OrindaSarnia,24,2,2,4,13,0
Chinohito,11,3,2,5,12,0.000195
amf_devils_best,13,4,5,9,13,0.000109
Fattydog,18,6,3,9,14,0.000022
Tripsy_mcfallover,24,4,3,7,14,0.000023
hamletswords,18,6,4,10,12,0.000194
Choice-Valuable313,10,2,3,5,14,0.000001
kjaiwiz,32,3,0,3,0,0
shiggyhisdiggy,22,4,4,8,13,0.000016
uTop-Artichoke5020,25,2,1,3,15,0
Chronoblivion,14,4,2,6,13,0.000451
CivilMath812,26,5,6,11,11,0.000674
Top-Cupcake4775,26,11,7,18,10,0.00015
efnord,13,4,4,8,12,0.000308
ClaraClassy,22,6,3,9,13,0.000002
Discount_Mithral,20,2,4,6,13,0
Tall-Newt-407,12,1,2,3,14,0
Classic_Bet1942,25,2,6,8,14,0.000003
Jolandersson,13,4,3,7,13,0.000015
Particular_Daikon127,13,2,1,3,14,0.000001
honeybee2894,15,3,1,4,15,0.000023
ta0029271,15,4,4,8,14,0.000001
alyxmorganvo,11,3,1,4,14,0
Lambfudge,10,4,4,8,12,0.000425
DarkSoulCarlos,14,1,1,2,11,0.005955
FredUpWithIt,16,5,5,10,11,0.007853
Gertrude_D,18,9,3,12,12,0.013122
Publius82,16,4,5,9,11,0.010337
ShuukBoy,14,2,1,3,12,0.006219
Statman12,18,6,4,10,11,0.008233
antisocially_awkward,19,7,7,14,11,0.007515
googagingaaaa,11,3,3,6,11,0.006483
rockstar588,10,2,2,4,11,0.006062
whomda,10,3,2,5,11,0.007848
CloudAdditional7394,37,4,6,10,13,0
No-Acanthisitta-2973,15,2,1,3,13,0
NotTravisKelce,21,3,4,7,14,0
SinglePermission9373,29,2,2,4,12,0
Unfair_Finger5531,62,10,11,21,12,0.000004
gahidus,13,2,3,5,14,0
specialkk77,12,3,3,6,14,0.000004
HiddenSage,11,2,3,5,13,0.000179
KingAggressive1498,36,8,11,19,11,0.000314
Meii345,19,7,4,11,12,0.000624
Only____,12,1,2,3,12,0.00002
Coffee-and-puts,12,1,1,2,14,0.00001
Cold-Palpitation-816,12,1,4,5,12,0.000242
CollectionStraight2,12,1,6,7,12,0.000001
constructioncranes,14,5,3,8,13,0.000025
jess_the_werefox,13,2,0,2,0,0.000005
CptHrki,11,3,1,4,14,0.00006
CombAny687,10,1,1,2,13,0.000023
CombinationRough8699,33,3,8,11,13,0.000086
Elias_Beamish,10,4,4,8,12,0.000128
SpaceCowboy1929,19,4,3,7,14,0.000021
Comfortable-Way-8029,18,2,2,4,13,0.000065
Unlikely-Distance-41,14,5,6,11,12,0.000022
Queen-of-meme,11,1,2,3,13,0.000004
zomanda,10,1,1,2,12,0.000024
Competitive_Tale_799,28,2,3,5,13,0.000002
Individual_Ad_9213,14,2,0,2,0,0
MACRS_or_Break,48,5,5,10,12,0.000001
oop_norf,31,5,5,10,12,0.000002
xtra819,26,3,6,9,12,0.001696
Complex-Present3609,10,3,6,9,11,0.000195
ComputerChemist,11,3,3,6,12,0.00026
midcen-mod1018,11,1,1,2,15,0
thegeniuswhore,32,5,5,10,13,0
Conscious_Bet_2005,15,1,1,2,1,0
Conscious_Raisin_436,16,2,5,7,11,0.000536
Consistent-Dinner799,11,1,1,2,1,0
Worth-Season3645,46,5,1,6,1,0
Scooney92,13,3,2,5,13,0.000014
knifeyspoony_champ,10,3,4,7,12,0.000042
Content-Valuable-489,16,0,2,2,12,0
ScarletNotThatOne,137,12,4,16,11,0.000006
r_coefficient,13,1,3,4,11,0
Content_Doughnut4590,12,4,4,8,13,0.000116
justeatyourveggies,12,3,2,5,14,0.000009
Coreyporter87,17,0,2,2,13,0
Correct_Cupcake_5493,39,6,3,9,13,0.00045
liquoriceclitoris,11,3,4,7,12,0.00013
Costiony,10,2,2,4,13,0.000002
labcoat_samurai,10,2,2,4,14,0
CouchieWouchie,11,2,2,4,14,0.000019
CoverCharacter8179,11,2,2,4,13,0
Cowabungamon,11,1,1,2,1,0
RoyallyOakie,26,3,0,3,0,0.000003
CracklierKarma9,18,1,2,3,14,0.000001
Ok-Significance2978,28,3,7,10,13,0.000004
chimingbell,12,4,3,7,12,0.00015
TrumpetDuster,14,3,1,4,13,0.000306
Crazyandiloveit,12,4,4,8,11,0.000001
Ok-Calligrapher1345,11,1,1,2,12,0
grammarlysucksass,23,5,4,9,12,0.000028
CreatineAddiction,29,2,2,4,13,0.000005
Jartblacklung,13,1,1,2,14,0.000002
Crepes_for_days3000,13,2,2,4,13,0.000014
InvestigatorOk7015,25,4,3,7,14,0.000013
roguesabre6,10,4,0,4,0,0.000019
CrimsonCartographer,20,3,4,7,13,0.0001
Dapper-Emergency1263,10,1,1,2,14,0.000003
CrimsonKnight_004,10,1,2,3,13,0
Heavy-Top-8540,19,6,7,13,13,0.000009
dachuggs,13,2,1,3,13,0.000003
EntWarwick,10,1,1,2,12,0.000021
Monotonosaurus,12,4,4,8,12,0.000112
morgaine125,17,3,1,4,13,0.000001
Cultural-Budget-8866,13,2,2,4,14,0.000002
Educational-Sundae32,10,2,2,4,13,0
yourlittlebirdie,11,1,1,2,15,0
suitupyo,19,8,3,11,12,0.004657
Cute-Boobie777,11,3,5,8,13,0.000075
CwazyCanuck,10,1,2,3,12,0.0002
Cyber_Guy1988,11,3,5,8,13,0.001182
RevolutionarySpot721,13,2,2,4,13,0.000007
RandomizedNameSystem,13,4,2,6,12,0.000721
superskink,13,2,2,4,12,0.002307
DBFool2019,29,3,6,9,13,0.00002
JDMultralight,18,2,4,6,13,0.000016
Level_Ad9278,39,6,6,12,12,0.000754
kurrganinterrogator,23,1,2,3,14,0.000001
DJ_Velveteen,11,3,3,6,12,0.000027
No_Bottle7859,17,3,3,6,12,0.000101
henosis-maniac,18,2,3,5,12,0.000046
Magic_Man_Boobs,12,5,4,9,12,0.000184
Front-Finish187,15,3,4,7,13,0.00008
DaEccentric,17,2,2,4,13,0.000034
DarkCrawler_901,15,1,1,2,14,0.000002
Dabalam,11,1,3,4,11,0
amrjs,52,5,5,10,14,0
lihzee,26,10,1,11,15,0
flying87,11,7,6,13,12,0.005122
Dangerous_Prize_4545,12,1,2,3,11,0
DapperDlnosaur,10,5,4,9,13,0.001131
DuckDouble2690,11,3,3,6,13,0.000325
DarkMarxSoul,23,2,2,4,13,0.000001
EchoingSimplicity,17,3,3,6,12,0.000022
sereniteenoww,10,2,2,4,12,0.00003
DarthJarJarJar,19,5,4,9,12,0.00395
DaveChild,21,2,5,7,12,0.000071
keyboardwari0r69,17,5,10,15,12,0.000529
paultheschmoop,10,4,5,9,12,0.002498
DazzlingFruit7495,38,3,3,6,13,0.00031
DazzlingLanguage5774,42,4,6,10,11,0
JPDL,10,2,3,5,11,0.000001
Katressl,19,5,7,12,11,0.000009
Purple_Wizard,23,6,6,12,13,0.000129
One-Salamander-1952,24,4,5,9,13,0.000049
Pixelology,16,5,6,11,13,0.000416
amitball,13,5,4,9,11,0.000288
bayesian_horse,29,5,9,14,12,0.000068
wtfgrancrestwar,16,3,3,6,13,0.000436
RogueCoon,20,3,4,7,13,0.000188
Dear_Solid3470,12,3,3,6,13,0
Impossible_Rain_4727,11,0,0,0,0,0
Mmm_lemon_cakes,15,2,2,4,12,0
OkSecretary1231,15,3,7,10,12,0
YoshKrawdot,11,3,3,6,14,0
Decent_Cheesecake_29,10,4,5,9,12,0.000036
iamwolfe,18,5,1,6,13,0.000072
Decent_Front4647,25,2,2,4,13,0
DecoratedDeerSkull,10,1,1,2,12,0.000002
DefNotARussiaBot,10,2,2,4,12,0.000737
lilelliot,11,2,4,6,13,0.000739
DefiantDistance5844,10,4,4,8,13,0.000174
redhillbones,30,9,14,23,12,0.000172
Delcane,11,1,1,2,13,0.000032
Delicious-Design527,10,2,4,6,13,0.000004
SophiaRaine69420,14,2,5,7,12,0.000014
WaterNerd518,14,3,3,6,12,0.000136
ishtar_the_move,17,3,4,7,12,0.000348
silence9,13,2,2,4,12,0.001411
Landoco,10,7,1,8,13,0.001002
Far_Physics3200,33,2,6,8,12,0
Radish00,14,9,5,14,12,0.000401
Ok-Emu-2881,14,2,2,4,13,0.000455
ZozMercurious,13,3,6,9,11,0.000269
slo1111,14,3,3,6,13,0.001343
Intelligent_Read_697,14,6,6,12,12,0.000218
No_Comfortable_3148,18,7,4,11,12,0.000526
Lopsided_Thing_9474,14,4,3,7,12,0.000033
Weak-Virus2374,12,2,3,5,12,0.000085
DevinTheGrand,13,3,3,6,12,0.000069
Dheorl,17,2,1,3,15,0.000031
Local_Painter_2668,25,3,4,7,14,0.000006
No_Assignment_9721,13,3,3,6,12,0.000091
PleaseDontBanMe82,13,4,2,6,12,0.000098
VivaLaRory,14,3,3,6,12,0.000074
moccasins_hockey_fan,10,4,3,7,12,0.000286
Difficult-Chard9224,11,1,1,2,1,0
Rare-Writer-9635,13,3,3,6,13,0.000061
MaiTaiMule,12,4,4,8,12,0.000188
xfvh,32,8,9,17,12,0.000594
DirectAntique,12,3,2,5,13,0
DisarestaFinisher,11,2,3,5,12,0.000275
Disastrous-Nail-640,23,4,3,7,12,0
IJustWantADragon21,16,4,3,7,13,0.000003
OrthogonalPotato,13,5,3,8,12,0.000021
Relevant_Bed6893,14,2,3,5,13,0.000002
Simple_Pianist4882,31,4,5,9,13,0.000046
citrus_cinnamon,23,3,2,5,13,0
Discussion-is-good,15,1,3,4,12,0.000107
Distinct-Temp6557,14,5,4,9,13,0.000107
DivorceIncoming123,40,5,3,8,13,0
Jun1p3rsm0m,16,4,4,8,14,0
babjbhba,11,4,4,8,12,0.000001
Dizzy_Needleworker_3,32,2,7,9,13,0
HotSatin,13,2,1,3,14,0
Slaator,17,4,3,7,12,0.000002
Specialist_Value_804,12,1,1,2,14,0
Trevena_Ice,25,5,1,6,1,0
DjangoBojangles,10,2,2,4,13,0.000337
piqueboo369,11,4,4,8,12,0.003487
cleverone11,12,2,2,4,13,0.000029
wildfirerain,11,2,2,4,12,0.000245
DogEnthusiast3000,11,1,2,3,14,0
btafd1,16,3,2,5,13,0.00001
sacredblasphemies,14,2,1,3,15,0.000411
DogsOnMyCouches,11,2,1,3,12,0.000375
DonQuigleone,14,2,2,4,12,0.000033
UNisopod,27,6,4,10,13,0.000286
DorsalMorsel,12,6,2,8,11,0.000429
DotCottonCandy,16,8,6,14,12,0.000316
Foyles_War,15,7,7,14,12,0.00036
ManufacturerSea7907,28,5,5,10,12,0.000278
Overton_Glazier,15,6,6,12,12,0.00026
followedbymeteor,16,1,1,2,12,0.000108
MissIncredulous,14,4,4,8,13,0.000113
radialomens,10,2,1,3,12,0.000228
DrWaffle1848,17,2,1,3,1,0.000287
Several_Razzmatazz51,10,4,0,4,0,0.000293
ladylondonderry,12,4,4,8,13,0.000303
Doxjmon,14,2,2,4,13,0.000032
cmecu_grogerian,12,2,3,5,12,0.000148
stiljo24,10,1,2,3,13,0.000007
homurainhell,10,1,4,5,13,0.000118
Violet_Perdition,11,2,1,3,1,0.000149
urnever2old2change,29,8,8,16,12,0.003319
JCMGamer,17,6,6,12,12,0.000414
DragonSeaFruit,11,1,1,2,12,0
ThisWillAgeWell,50,6,4,10,11,0
DragonWyrd316,26,2,3,5,14,0
Fearless_Spring5611,26,5,1,6,14,0
No_Conversation_5661,19,3,2,5,14,0
kawaeri,12,3,3,6,14,0.000002
Dragonmancer76,11,2,2,4,14,0.000001
nvveteran,12,1,1,2,15,0
Particular_Solid9008,11,4,5,9,11,0.000284
DrunkAlbatross,12,1,1,2,13,0.000083
Manaliv3,21,3,6,9,13,0.000064
pedrito_elcabra,12,2,4,6,13,0.000098
Dukklings,38,3,3,6,12,0
LupineVenom,16,2,2,4,13,0
Dull_Banana1377,18,1,2,3,13,0
LouisV25,11,4,4,8,14,0
WabbitCZEN,12,3,3,6,12,0
PopIntelligent9515,18,11,12,23,12,0.000497
Dweller201,23,1,1,2,13,0.000007
GoldH2O,21,3,6,9,12,0.000001
EDRootsMusic,22,4,5,9,12,0.000388
EVOSexyBeast,10,4,3,7,13,0.000472
Life_Repeat310,13,2,2,4,13,0.00001
TheGhostofJoeGibbs,16,7,5,12,12,0.000195
communist_slut42,10,1,1,2,13,0.000001
Economy-Emu-4689,17,1,1,2,13,0
pikminlover20,15,6,4,10,12,0
elocin1985,11,4,3,7,12,0.000059
midorikuma42,12,3,5,8,13,0.00026
Gygsqt,34,9,11,20,12,0.000553
emp-sup-bry,22,6,5,11,13,0.001811
haterofslimes,18,2,4,6,12,0.000045
ishmaellius,10,2,2,4,13,0.000084
Effective-Birthday57,16,3,1,4,11,0.00001
EggOkNow,17,4,5,9,12,0.000004
ModernZombies,11,5,2,7,13,0.000011
MzSea,18,4,5,9,13,0.000001
Stucklikegluetomyfry,14,2,4,6,11,0
iOawe,10,3,3,6,13,0
spid3rham90,34,5,4,9,13,0.000001
SpecificPay985,20,6,3,9,12,0.000204
k2svpete,26,3,2,5,14,0.000208
ElEsDi_25,26,4,4,8,13,0.000063
When_hop,10,2,0,2,0,0.000033
Eldriscp,12,5,4,9,12,0.000202
raptor-chan,14,4,5,9,11,0.000226
saltedmangos,13,4,5,9,11,0.000939
SlurpingDischarge,59,10,8,18,13,0.000291
EmceeSuzy,47,10,5,15,12,0.000002
Fickle-Cabinet3956,18,3,4,7,13,0
Gingerpyscho94,10,2,2,4,12,0.000002
allhailthehale,11,1,4,5,12,0.000105
Kibbles-N-Titss,20,1,1,2,13,0.000009
EmployAltruistic647,10,1,2,3,13,0.000027
Yntol,12,5,5,10,13,0.000359
Engine_Sweet,11,3,3,6,12,0.000026
Enki4n,12,2,2,4,12,0.000347
EonPeregrine,11,3,3,6,13,0.000627
EquipmentSpecific262,24,1,2,3,12,0.000001
Rozenheg,12,1,2,3,13,0.000003
Lenyngrad,29,5,4,9,13,0.000109
Equivalent_Length719,31,3,3,6,13,0.000001
Firestorm42222,21,2,2,4,13,0.000003
Key_Zucchini9764,15,1,1,2,14,0
chickadee_1,15,6,4,10,13,0.00028
vht3036imo,24,6,6,12,13,0.000433
EruDesu90,12,1,1,2,1,0
GrapefruitNo9284,12,3,1,4,1,0
EssayFunny1670,12,1,1,2,12,0
mightymite88,24,5,6,11,13,0.000253
FluffyB12,16,3,5,8,12,0.000225
ShipComprehensive543,14,3,1,4,12,0.000001
Expensive_Yam_2222,25,3,3,6,13,0
SykesLightning,14,1,1,2,14,0
Individual_Umpire969,11,2,2,4,13,0
Extension-Issue3560,16,2,1,3,14,0
Temporary-Stay-8436,26,6,5,11,12,0.000229
Extreme_Sector_6689,13,3,2,5,14,0
opelan,26,2,3,5,13,0
Eyesofmalice,14,3,4,7,13,0.000128
bfwolf1,48,7,9,16,12,0.000168
FL_Duff,12,2,3,5,12,0.000004
RennietheAquarian,27,4,5,9,12,0.000004
PrecisionHat,24,8,8,16,12,0.000463
ToLiveInIt,11,2,4,6,13,0.002637
FairyCompetent,32,1,3,4,12,0
Witty-Draw-3803,14,2,1,3,13,0.000001
LordGerdz,13,6,4,10,13,0.000968
False-Fall-6995,13,1,1,2,13,0
Falsequivalence,11,3,2,5,12,0.000324
Famous-Ad-9467,12,4,3,7,13,0.000006
imperfect9119,21,3,0,3,0,0.000013
StargazerRex,27,2,6,8,12,0.00001
ThrowRACoping,39,6,5,11,13,0.000012
Waterworld1880,19,3,6,9,12,0.000108
JaySpunPDX,10,2,2,4,15,0.000002
sir_mrej,33,5,4,9,13,0.000194
username_redacted,10,3,1,4,14,0.000281
Faust_8,10,1,1,2,14,0.000004
_ParadigmShift,16,2,3,5,12,0.000034
thesestormyseas,10,1,2,3,13,0.000032
Feeling-Visit1472,14,0,2,2,13,0
OLAZ3000,12,1,1,2,1,0
StuffedSquash,11,1,3,4,12,0
FemBoyGod,20,1,3,4,13,0.000004
Grish__,19,1,3,4,13,0.000039
Important_Suspect681,16,5,7,12,13,0.000507
Riceowls29,38,3,4,7,12,0.000083
luckyhunterdude,12,1,1,2,14,0.000003
SteelLt78,12,1,2,3,14,0
TheCowboyIsAnIndian,11,1,2,3,13,0.000196
Ulthanon,10,2,2,4,14,0.000196
Final7C,15,4,3,7,12,0.000002
Interesting-Pea-1714,22,1,3,4,11,0
Superdudeo,11,2,2,4,13,0
redditsuckspokey1,11,1,1,2,13,0
Ostlund_and_Sciamma,10,1,3,4,12,0.000175
burz,15,4,4,8,12,0.000257
Financial_Bowl9440,10,2,1,3,14,0
i_was_a_person_once,24,5,6,11,13,0
Fine-Sherbert-140,12,2,1,3,1,0.000007
First-Industry4762,10,1,2,3,13,0.000002
Fit-Act2056,11,2,2,4,12,0.000008
Wayfarer285,17,3,3,6,12,0.000048
thebottomblocks,22,4,3,7,13,0.000055
unitedshoes,20,4,9,13,12,0.000013
Flapjack_Ace,11,2,2,4,11,0.001807
ary31415,12,3,3,6,12,0.001786
noah7233,19,6,5,11,12,0.001836
Flashy-Lunch-936,17,1,4,5,12,0.000049
Fleeting_Dopamine,22,3,3,6,13,0.000121
QR4201,21,6,6,12,12,0.000138
Shot-Vacation2469,24,6,10,16,12,0.000219
paadugajala,12,3,3,6,12,0.001321
FrangipaniMan,10,1,2,3,13,0.000009
ravenHR,11,1,1,2,13,0.000013
Signal_Ad_7959,12,2,2,4,13,0.000001
Ready-Recognition519,14,4,4,8,11,0.000537
sailorbrendan,13,3,2,5,13,0.000361
Foxlikebox,11,1,1,2,12,0.000001
FragrantPiano9334,17,2,4,6,13,0.000008
Free_Storage_1088,13,1,3,4,13,0
OriginalSchmidt1,13,3,3,6,13,0
roseofjuly,20,6,7,13,12,0.000009
Top-Bootylover,13,3,3,6,12,0.000081
Womblue,10,3,3,6,13,0.000179
settleslugger,12,1,1,2,13,0.000088
Glitchy_XCI,28,5,8,13,13,0.00036
Thoughtful_Ocelot,14,2,6,8,12,0.000198
dbandroid,14,5,4,9,13,0.000251
mangongo,24,4,5,9,13,0.000256
Fumbles329,13,1,1,2,13,0
Rosevkiet,15,7,2,9,12,0.000287
The_FriendliestGiant,13,4,2,6,12,0.000449
Galious,18,2,2,4,12,0.000132
Striking_Computer834,10,1,1,2,13,0
bigdograllyround,14,3,3,6,13,0.000042
throwawayaway388,12,4,3,7,13,0.000106
Kenichi2233,23,7,3,10,13,0.000133
ferbje,33,4,8,12,12,0.000199
Gauntlets28,13,2,4,6,12,0.000001
PomegranateBasic3671,12,1,1,2,13,0.000007
housearachna,24,5,4,9,13,0.00002
GeneConscious5484,14,2,2,4,13,0.000007
GeorgeHarris419,12,1,2,3,13,0
Icy_Raspberry5456,15,1,2,3,13,0
OtherMarciano,17,1,1,2,13,0.000022
QuesoStain2,13,7,4,11,13,0.001368
MithosYggdrasill1992,57,1,11,12,11,0
mark_ik,24,4,4,8,13,0.000125
PromptStock5332,16,4,5,9,12,0.000121
GoNads1979,11,1,1,2,13,0.00007
GodMan7777,45,3,3,6,12,0.000003
Inevitable_Bit_9871,14,3,3,6,12,0.000046
No_Emphasis4360,13,1,1,2,13,0
GodkingAustin,14,1,4,5,13,0.000002
GodtheBartender,15,6,8,14,12,0.000066
Safe-Intern2407,14,2,2,4,13,0.000003
Zipz,11,2,2,4,13,0.000002
thedorknightreturns,26,7,11,18,12,0.000083
yawannauwanna,14,3,2,5,14,0.000004
OmniTalentedArtist,13,2,2,4,13,0.000165
aguruki,21,3,5,8,13,0.000126
GoingAllTheJay,10,1,1,2,13,0
Kosmopolite,19,3,2,5,13,0.000234
dullaveragejoe,13,4,1,5,16,0.00001
bigboobswhatchile,10,5,5,10,11,0.000451
GoldenLiar2,12,3,4,7,13,0.000056
Curious_Eggplant6296,15,2,0,2,0,0
PiersPlays,13,2,3,5,13,0.00001
Spite-Organic,14,2,5,7,12,0.000015
biteme4711,12,6,3,9,12,0.000288
panna__cotta,34,7,5,12,11,0.000453
LSATDan,11,2,2,4,13,0.000066
MrPoopMonster,12,3,5,8,12,0.000112
Individual_Row_2950,20,1,2,3,14,0.000008
Green-Dragon-14,11,2,1,3,1,0
Street-Length9871,16,1,1,2,1,0
GroundbreakingAd6354,13,2,2,4,12,0.0002
Tristan_Gabranth,16,2,2,4,13,0.000007
GroundbreakingBag164,12,3,4,7,13,0.000076
Grymflyk,11,1,1,2,12,0.000078
SartorialDragon,38,1,6,7,11,0
MelissaMiranti,24,4,6,10,11,0.000101
GunMuratIlban,14,1,1,2,14,0.000001
The_Zacain,21,2,2,4,13,0.000019
NotGalenNorAnsel,12,4,3,7,12,0.000191
abetterlogin,26,4,2,6,1,0.000084
The-Nice-Writer,10,2,2,4,12,0.000448
Hairy-Dream4685,19,1,1,2,12,0
Sorry_I_Guess,43,2,4,6,11,0
neurointervention,27,5,5,10,13,0.000634
HallowedGardens,10,1,1,2,14,0
Self-Aware,10,1,2,3,13,0
HammerOn57,28,1,1,2,12,0
Hamuel,12,4,4,8,12,0.000237
Prepared_Noob,12,3,3,6,13,0.000102
TintedApostle,12,2,3,5,13,0.001113
frederick_the_duck,12,3,3,6,12,0.000263
WrongCase7532,35,2,7,9,11,0.000007
Hautamaki,10,5,5,10,12,0.009875
JoeSavinaBotero,14,4,2,6,12,0.005628
HazelCheese,16,3,3,6,12,0.001118
Hazeygazey,17,1,1,2,15,0.000001
Wild-Spare4672,11,2,2,4,14,0.000001
Lpunit,10,5,4,9,13,0.000173
Healthy_Brain5354,20,2,3,5,12,0
MrBlizter,29,4,4,8,12,0
Twig-Hahn,13,1,2,3,13,0
jugglinggoth,15,2,2,4,11,0
Iricliphan,14,3,2,5,14,0.00002
Worldly-Confusion759,11,3,2,5,14,0.000019
Helen_A_Handbasket,10,3,3,6,13,0
milly_moonstoned,12,4,3,7,14,0
Ok-Recipe5434,11,3,4,7,13,0.000076
ta_mataia,32,4,6,10,11,0.000391
HendriXP88,14,2,5,7,12,0.000005
Hey-Just-Saying,14,2,2,4,13,0
Kathrynlena,17,2,1,3,14,0
crocodile_in_pants,10,2,2,4,13,0.000014
HiddenRouge1,10,2,2,4,13,0.000394
Tall-Professional130,22,4,7,11,12,0.00034
Hostilis_,10,1,1,2,1,0
Kaaji1359,10,2,1,3,1,0.000002
PearlStBlues,21,2,1,3,13,0
Hugo28Boss,11,5,4,9,12,0.000611
Hour_Smile_9263,31,4,8,12,11,0.000011
whorl-,15,4,2,6,11,0.00001
LordVericrat,10,5,4,9,12,0.000032
theroha,29,4,2,6,14,0.000069
IDVDI,14,4,7,11,12,0.000114
The_Amazing_Emu,20,4,4,8,11,0.000072
IHaveBoxerDogs,10,1,1,2,1,0
ToldU2UrFace,13,1,1,2,1,0
Objective_Air8976,25,0,0,0,0,0
IanArcad,11,1,3,4,12,0.000036
IceCreamBalloons,13,2,3,5,13,0.000006
Randy_Watson,12,1,2,3,13,0.000689
IchiroTheCat,11,0,2,2,12,0
Top-Entertainer2546,17,2,0,2,0,0
xhevnobski,30,3,3,6,12,0.00018
upfastcurier,10,1,2,3,13,0.000173
IgnoranceIsShameful,19,1,1,2,13,0.000001
trthorson,11,6,3,9,14,0.000051
ValitoryBank,12,2,5,7,12,0.000613
wedgebert,16,3,5,8,12,0.003231
IllIlIlIlIlIll,11,1,1,2,12,0.000076
RsonW,12,4,3,7,13,0.000106
Suspicious_Tank_61,12,3,3,6,13,0.000105
MostlyGhostlyPost,10,1,1,2,13,0.000329
kenzieisonline,10,1,2,3,12,0.000329
ashmortar,15,9,6,15,13,0.000374
Vegtam1297,13,4,3,7,13,0.000079
ImportantOnion9937,21,2,3,5,12,0
Nymph-the-scribe,12,3,4,7,12,0
JustACWrath,10,5,3,8,13,0.000263
land_and_air,14,2,2,4,13,0.000024
Impossible-Cod-323,15,1,2,3,13,0.000031
smol9749been,16,5,5,10,11,0.000036
baklazhan,10,1,1,2,15,0.000001
Impressive_Design177,15,1,1,2,1,0
Snoo_90208,10,1,1,2,1,0
In_A_Spiral,18,2,2,4,12,0
PetiteDreamerGirl,11,1,2,3,13,0.000023
Troysmith1,10,2,3,5,13,0.000481
Infamous-Purple-3131,15,0,2,2,13,0
Mother_Welder_5272,14,3,2,5,13,0.000299
InnerBlacksmith1208,12,3,2,5,1,0
drewmana,11,1,1,2,2,0
slackerchic,21,4,1,5,2,0.000026
Interesting-Shame9,15,1,1,2,12,0.000024
Successful-Silver485,14,2,3,5,13,0.000018
Mental-Combination26,15,6,4,10,12,0.000476
Otherwise-Win7337,14,2,3,5,12,0.000351
Internal-Giraffe-124,10,2,1,3,14,0
Otherwise-Tie-7459,19,2,7,9,12,0.000019
Jawyp,17,3,4,7,12,0.001814
InterstitialDefect,15,1,2,3,1,0
improbsable,11,2,0,2,0,0.00003
IntolerantModerate,11,3,3,6,13,0.000061
redknit,13,1,1,2,14,0.000006
Xepherya,10,5,4,9,13,0.00022
NoInsurance8250,17,4,4,8,12,0.00028
Only_Raccoon9397,18,3,3,6,13,0.000028
JAMONLEE,32,4,6,10,12,0.000373
Purple_Feedback_1683,18,2,2,4,13,0.000026
gittlebass,10,1,1,2,13,0.000019
JacobStills,10,0,4,4,13,0
savingforresearch,19,1,2,3,13,0.000012
Jalphorion1,15,3,3,6,13,0.000463
Top-Profile-4570,14,3,4,7,12,0.000458
totally-hoomon,10,1,4,5,12,0.000001
JamSkully,12,3,3,6,12,0.000003
PreparationAdvanced9,13,5,5,10,12,0.004107
RedPandaReturns,10,3,4,7,13,0.000076
itsacalamity,17,4,2,6,14,0.000159
Jealous-Contract7426,29,1,2,3,12,0
Sad-Country-9873,22,2,3,5,11,0
TalkToHoro,26,3,2,5,12,0
lebannax,10,1,3,4,13,0.000004
Jesssica_Rabbi,27,1,1,2,15,0
No_Effort5896,11,1,2,3,14,0.000028
JohnCalvinSmith,10,1,1,2,13,0
Johnclark38,10,1,1,2,13,0.000024
shivux,25,3,3,6,12,0.000063
JonnyRobertR,32,1,1,2,14,0.000004
Salazarsims,27,2,2,4,13,0.000012
mattyoclock,27,8,12,20,11,0.000449
MountainHigh31,16,8,4,12,12,0.000464
Remote_Difference210,11,1,1,2,15,0
PenImpossible874,27,4,9,13,12,0.004812
s-b-mac,18,2,3,5,13,0.000006
JunktownRoller,29,1,3,4,13,0.000017
JustSomeCells,17,2,3,5,13,0.000061
Thin-Image2363,11,1,6,7,12,0.000089
KCarriere,14,2,4,6,12,0.000078
Nameless_consult,11,2,2,4,12,0.000007
Kadajko,10,1,1,2,14,0.000003
Kaisha001,11,2,2,4,12,0.000039
Rude_Technician4821,10,1,1,2,13,0.000003
The_White_Ram,16,2,2,4,12,0.000153
Knight0fdragon,21,2,2,4,12,0
PurpleWeasel,15,2,1,3,13,0
W0nderingMe,22,1,2,3,12,0
Kami_Sang,30,4,3,7,12,0
MysteriousFootball78,10,4,0,4,0,0.000058
Key-Loquat6595,11,3,2,5,12,0.017749
Key-Philosopher-2788,13,3,3,6,12,0.000124
Key-Pickle5609,12,0,2,2,13,0
Nodaker1,13,5,3,8,12,0.000475
Key_Ingenuity_4444,11,1,1,2,12,0.000076
Kikikididi,15,1,4,5,11,0
teenageIbibioboy,10,1,1,2,12,0.000023
Smart-Status2608,25,4,5,9,12,0.000024
favorable_vampire,18,4,6,10,12,0.000022
TheGreatBenjie,12,1,2,3,13,0.000045
sheds_and_shelters,15,2,2,4,12,0.000062
Kingnimrod212,11,0,3,3,13,0
Odd-Spirit9829,10,2,3,5,13,0.000036
Upstairs-Teach-5744,14,1,2,3,13,0.000027
Klutzy_Routine_9823,13,3,2,5,13,0.000039
Least_Key1594,13,2,3,5,12,0.000041
elderly_millenial,14,7,7,14,13,0.00174
Kotor-Knowledge-7964,22,5,3,8,13,0.000145
Revolutionary-Copy97,10,1,1,2,14,0.000004
chicfromcanada,11,1,1,2,13,0.000007
Kurati-sa-Kariba,12,1,1,2,13,0.000004
KyleDutcher,18,2,2,4,13,0.001152
ReadLocke2ndTreatise,30,6,6,12,13,0.00021
ShadesOfTheDead,11,4,4,8,12,0.000555
vvalkyri3,10,3,3,6,13,0.000191
turtleduck,23,4,3,7,13,0.000049
Not_Yet_Italian_1990,19,2,6,8,12,0.000343
edwardludd,14,4,3,7,12,0.004853
LdiJ46,15,5,2,7,14,0.00003
j0179664,12,2,2,4,13,0
LetterheadBubbly6540,19,1,1,2,13,0
Letters_from_summer,15,2,1,3,13,0
lemon_charlie,38,5,6,11,12,0
Level_Amphibian_6249,10,1,2,3,2,0
lycrashampoo,21,3,1,4,1,0
LottieOD,11,1,1,2,12,0
MissionYam3,12,2,1,3,12,0
MortgageMiserable307,15,3,3,6,12,0
OkManufacturer767,36,1,2,3,13,0
kittywyeth,17,2,3,5,12,0
LivingLikeACat33,12,1,4,5,12,0.000006
bizarre_coincidence,14,4,5,9,12,0.00004
zookeepier,16,4,5,9,13,0.000072
indoorsy-exemplified,12,2,3,5,12,0.000004
squigs,13,3,2,5,11,0
terrika_has_spoken,20,2,1,3,13,0
thisisstupid0099,16,1,3,4,13,0
Local-Hornet-3057,12,1,2,3,12,0.00002
Longjumping-Plant617,13,1,1,2,14,0.000001
kozak65,15,2,3,5,13,0.000004
TheRemanence,14,2,4,6,12,0.000011
MaybePrudent3877,15,4,2,6,12,0.000064
wickybasket,10,2,1,3,15,0
rjtnrva,18,5,6,11,13,0.000269
ladiesPlusLlc,12,2,5,7,12,0.000066
Lows-andHighs,14,0,2,2,13,0
tf2coconut,11,3,3,6,12,0.000313
Siukslinis_acc,16,2,3,5,13,0.000088
enterthewoods1,20,2,2,4,14,0.000067
No-Assistant-1948,19,2,3,5,13,0
MS-07B-3,11,1,2,3,13,0.000003
MacaroonSad8860,12,1,3,4,11,0.000002
automaks,11,1,1,2,13,0.000009
unbelizeable1,30,6,9,15,11,0.000042
ZhopaRazzi,16,3,2,5,12,0.001118
cptn9toes,13,1,1,2,13,0.000006
octocatty,42,2,2,4,13,0.000071
MaleficentPizza5444,22,1,2,3,13,0
Queen_Sized_Beauty,10,2,2,4,12,0
MalekithofAngmar,14,1,2,3,13,0.000004
Toppoppler,20,3,4,7,12,0.000045
creamsodapoo,18,3,1,4,14,0
mikadouglas1,13,4,1,5,12,0.003106
MarionberryPlus8474,14,1,1,2,12,0.000028
TheDesertShark,11,2,2,4,13,0.000045
Shepathustra,13,1,3,4,13,0.000002
real-bebsi,24,5,6,11,12,0.000047
jimmyxtang,17,5,4,9,12,0.000065
Meddling-Kat,16,1,1,2,1,0
ninjatahu,24,1,1,2,1,0
Vredddff,13,2,3,5,12,0.000016
MediocreSizedDan,13,2,4,6,12,0.000101
Meghanshadow,10,0,0,0,0,0
Square-Bite1355,13,2,4,6,12,0.000046
giraloco,11,5,3,8,13,0.000155
MezzoFortePianissimo,14,1,6,7,12,0.002121
MidwestNormal,25,0,2,2,2,0
MikeLinPA,14,3,4,7,12,0.000427
MindFreedom1978,13,1,1,2,13,0.000002
anondaddio,26,3,3,6,12,0.000016
MisterRound,12,1,1,2,14,0.000002
Mistybrit,13,3,5,8,12,0.000082
silverpixie2435,27,4,6,10,13,0.000056
VordovKolnir,35,3,2,5,13,0.000002
perplexedtv,10,3,4,7,12,0.000002
PalmTreePhilosophy,17,1,4,5,12,0.000002
ToddlerOlympian,15,1,3,4,14,0.000002
_Dingaloo,11,1,1,2,14,0.000002
Money-Possibility606,13,2,1,3,15,0
pinkpink0430,17,1,3,4,13,0
Virtual_Technology_9,21,3,4,7,11,0.000455
Wattabadmon,16,2,3,5,11,0.000312
girldrinksgasoline,19,5,11,16,12,0.000227
Puzzleheaded-Face181,11,1,1,2,13,0
MrE134,11,3,3,6,12,0.000984
PushThePig28,11,3,2,5,12,0.00001
MrsDoylesTeabags,10,1,1,2,15,0.000003
NeedForSpeed98,11,3,2,5,12,0.000098
Mundane-Mud2509,22,5,5,10,12,0.000098
TemporaryThink9300,12,1,1,2,13,0.000002
Raephstel,32,4,4,8,12,0.000093
kiwipixi42,33,2,7,9,11,0.000819
MysteriousDig4656,33,1,2,3,13,0
Throat_Ancient,11,2,3,5,13,0.000057
MystifiedByPeople,22,0,5,5,12,0
TheTurtleShepard,15,5,4,9,13,0.000003
rb-j,16,2,5,7,12,0.00154
answer_giver78,16,3,4,7,13,0.000175
NSlearning2,11,1,2,3,13,0.000007
NYDancer4444,15,1,2,3,12,0
pieville31313,13,1,1,2,13,0
Neat-Ostrich7135,20,0,2,2,13,0
thechaoticstorm,27,4,1,5,12,0
thatvampigoddess,10,2,2,4,12,0.000009
Neither_Charity_2779,10,1,4,5,12,0.000001
TheBeardedDuck,22,5,5,10,13,0.000042
chickpeahummus,11,2,0,2,0,0.000006
Ninja333pirate,10,2,3,5,11,0.000021
No-Assignment5538,53,5,5,10,12,0
No-College4662,22,2,0,2,0,0
PeachBanana8,16,1,1,2,13,0
definitelynotjava,15,2,4,6,13,0
oliviamrow,13,2,0,2,0,0.000004
No-Theme4449,11,1,2,3,13,0.000003
Queasy_Artist6891,14,3,3,6,12,0.000247
No-Potential-7242,30,2,1,3,12,0
stroppo,10,2,2,4,11,0
No-Relation5965,11,3,3,6,13,0.000642
No-stradumbass,19,3,5,8,13,0.000177
No_Airport2112,10,1,3,4,13,0.000068
point_of_you,10,1,1,2,13,0.000004
No_Macaroon_9752,10,2,4,6,13,0.000191
No_Neighborhood_632,16,1,1,2,16,0
meeps1142,11,1,2,3,15,0
Uubilicious_The_Wise,34,5,4,9,12,0
space_force_majeure,11,2,2,4,12,0.000088
Several-Adeptness-83,27,2,2,4,14,0
Sugah-Mama,14,1,1,2,15,0
walkinwater,31,1,3,4,11,0
Novel_Surprise_7318,22,1,1,2,14,0
TriggerWarning12345,11,1,2,3,13,0
NtsParadize,11,0,2,2,12,0
NuYawker,18,1,1,2,13,0.000055
RevolutionaryYam2147,14,2,1,3,13,0
ScaryButterscotch474,41,3,2,5,13,0
OG-Brian,14,1,1,2,17,0
Environmental_Art591,11,3,0,3,0,0
rosegoldblonde,10,1,1,2,13,0
tosser9212,19,1,3,4,12,0
OneEye3360,10,3,4,7,12,0.000294
Wonderlostdownrhole,13,1,1,2,14,0
Ok-Acanthaceae5744,11,1,3,4,12,0.000003
PrivilegeCheckmate,28,1,3,4,13,0.000004
Ok-Debate3920,13,1,2,3,13,0.001159
Ok-Presentation-2068,13,2,1,3,1,0
ike7177,17,2,1,3,1,0
Ok-Raspberry7884,11,3,3,6,12,0.000001
iilinga,11,2,2,4,15,0
littlebitfunny21,48,6,8,14,11,0.000001
Ok-Simple5493,27,1,2,3,14,0
shelwood46,37,1,5,6,12,0
trollcitybandit,17,2,2,4,13,0.000212
Old-Pear9539,10,3,3,6,12,0.000439
Sammy4152015,14,2,2,4,12,0.000033
On_my_last_spoon,10,2,1,3,13,0
barfbat,20,2,4,6,12,0
khizar4,15,1,2,3,13,0.000017
OrdinaryWords,12,0,3,3,11,0
hiddenkobolds,10,4,0,4,0,0.000004
Organic_Start_420,31,3,3,6,12,0
ScopeIsDope,11,2,2,4,13,0
Psychonaut1008,14,1,2,3,13,0
gifhyatt,11,1,1,2,14,0
reddituserperson1122,19,1,1,2,13,0.000006
apophis-pegasus,12,3,2,5,13,0.000035
OwlCaptainCosmic,10,1,1,2,2,0
Raptor_197,13,1,2,3,1,0
QueueOfPancakes,18,3,2,5,13,0.000024
epichuntarz,18,1,4,5,12,0
SeeRecursion,20,2,2,4,12,0.000343
Pascale73,13,0,2,2,11,0
munche,23,5,3,8,12,0.000715
Peefersteefers,11,1,3,4,13,0.000014
PeelingMirthday,12,3,1,4,13,0
PerAsperaDaAstra,19,2,2,4,12,0.000081
PerfectReflection155,11,2,1,3,13,0.000056
Persis-,17,1,2,3,13,0.000014
Playful-Trip-2640,13,6,6,12,12,0.000406
Phanes7,11,2,2,4,13,0.000137
testtest867,12,2,1,3,13,0.00002
Phyltre,11,3,4,7,12,0.00004
notafuckinmarine,11,2,2,4,13,0.000062
Supernova-Max,39,1,2,3,12,0
Accomplished-Park480,11,2,0,2,0,0.000025
PinkPandaHumor,17,0,3,3,13,0
Dittoheadforever,27,2,0,2,0,0.000047
Twenty_twenty4,17,2,4,6,13,0.000043
PlasticLab3306,33,0,4,4,12,0
Ploutophile,12,2,5,7,11,0.0001
ilGeno,17,2,3,5,12,0.001533
THExLASTxDON,15,6,5,11,12,0.005878
PoolQueasy7388,22,1,3,4,13,0.000001
tnrdmn,11,1,1,2,13,0.000153
dalekrule,13,2,1,3,14,0.000145
PrinceArchie,11,2,3,5,11,0.000008
Deep-Okra1461,89,0,0,0,0,0
Pristine_Volume4533,17,1,1,2,1,0
SavingsRhubarb8746,12,2,0,2,0,0.000026
ProofJournalist,20,1,1,2,15,0.000003
PublikSkoolGradU8,13,1,1,2,15,0.000005
PuzzleheadedTrash131,22,2,4,6,12,0.000201
Radiant_Gene1077,17,1,1,2,14,0
RainfallsHere,19,3,3,6,13,0
RequestSingularity,18,2,4,6,13,0.000008
uttersolitude,10,2,2,4,13,0
RammsteinFunstein,17,1,2,3,12,0
SnooChipmunks770,40,2,3,5,13,0.000003
Zeydon,11,1,1,2,14,0.000008
Realistic_Mud_4185,13,1,3,4,13,0
zealot_ratio,17,1,1,2,14,0.000002
DarthRedYoga,36,2,0,2,0,0
RespondCharacter6633,21,2,2,4,13,0.000002
freakydeku,10,1,3,4,12,0
reactorfuel,27,2,2,4,14,0
Responsible_Rich_284,12,1,1,2,12,0
UnfttrrdMlvlnc,10,1,3,4,13,0.000026
apri08101989,12,2,3,5,12,0.000184
sh1tpost1nsh1t,11,2,1,3,12,0.000067
splurtgorgle,19,5,6,11,12,0.000089
StockAdeptness9452,13,2,2,4,13,0.000294
michaelas10sk8,14,3,4,7,12,0.000036
k_princess,11,1,1,2,14,0.000003
RumRunnerMax,15,1,2,3,12,0.00109
Sad-Paramedic-8523,26,4,5,9,12,0.000265
Spiel_Foss,19,1,5,6,12,0.000954
Samanthacino,12,2,2,4,13,0.00003
xXdontshootmeXx,11,1,1,2,14,0.000048
Whole_Database_3904,10,3,2,5,15,0
sirthunksalot,13,4,3,7,14,0.000022
angelerulastiel,11,1,1,2,14,0
Scenarioing,16,0,3,3,12,0
SceneNational6303,10,0,2,2,13,0
Sea-Nerve-8773,10,0,2,2,13,0
ServelanDarrow,62,0,0,0,0,0
ServiceDragon,11,1,1,2,15,0
joe_s1171,13,1,2,3,13,0
Viola-Swamp,10,2,3,5,11,0
captainwhatserface_5,13,4,3,7,13,0
SheWhoLovesSilence,12,3,3,6,13,0.00004
damo1112,19,3,5,8,13,0.000033
SunshineThunder101,14,2,2,4,12,0.000213
SigSauerPower320,14,0,2,2,12,0
Slight-Improvement84,15,2,2,4,14,0.000036
SoMuchMoreEagle,11,3,2,5,15,0
Simon-Says69,15,0,4,4,11,0
Single_Cancel_4873,10,1,1,2,15,0
Skull_Bearer_,12,3,3,6,12,0.000066
jrssister,27,3,3,6,12,0.000201
Spare_Ad5009,47,3,0,3,0,0
fitandhealthyguy,12,1,3,4,13,0
Total-Habit-7337,45,1,1,2,14,0.000017
Smart-Afternoon-4235,11,1,2,3,14,0.000003
Snoo93629,10,1,1,2,14,0.000057
Accidental_Sage,10,2,0,2,0,0
Solid-Musician-8476,26,1,1,2,3,0
Think-Variation2986,10,3,3,6,11,0.000001
Space_Pirate_R,10,1,2,3,13,0.000001
Specialist-Rise1622,18,2,1,3,1,0.000057
Symbiotic_flux,14,1,1,2,1,0
SpiritedLettuce6900,16,0,2,2,15,0
Sprmodelcitizen,10,1,1,2,15,0.000001
ashkesLasso,13,2,3,5,12,0.000838
Squaaaaaasha,11,1,1,2,1,0
findmeauname,12,1,1,2,13,0.000116
turbografx_64,16,2,3,5,12,0.000466
simcity4000,12,1,4,5,11,0.000026
toothychicken,10,2,1,3,14,0.000039
fizzmore,14,2,1,3,12,0.000056
Stingre1956,11,0,2,2,13,0
Stormtomcat,25,1,4,5,11,0
StrikingExcitement79,18,0,2,2,12,0
WillowGirlMom,26,1,2,3,12,0.000001
Sufficient-Win-1234,10,1,1,2,14,0.000034
juwruul,14,1,3,4,14,0
Sure-Lingonberry-283,19,4,5,9,12,0.000123
_Calmarkel,15,3,3,6,12,0
notyourmartyr,10,2,2,4,13,0
nolife159,12,1,3,4,12,0.000016
SweetMaam,22,2,1,3,1,0
Valkrhae,10,1,1,2,1,0
TALKTOME0701,17,1,5,6,13,0
Team503,11,4,5,9,13,0.000037
aaeme,20,2,3,5,12,0.000018
waldleben,13,3,4,7,12,0.000086
TankieErik,10,1,1,2,15,0
allprologues,16,2,5,7,12,0.000155
stex85,20,1,1,2,13,0.000011
Thatredheadwithcurls,23,0,3,3,13,0
brutishbloodgod,15,1,1,2,13,0.000005
Wise-Opportunity-294,10,3,3,6,13,0.000069
TheOpinionIShare,13,0,3,3,13,0
TheTrueCampor,17,1,3,4,14,0.000011
maiingaans,12,1,1,2,14,0
The_Artist_Dox,16,0,2,2,13,0
Theistus,18,2,1,3,1,0.000003
mmmeadi,21,1,1,2,1,0
Thermicthermos,12,1,1,2,13,0
jakeofheart,22,2,2,4,12,0.000062
Tight_Jaguar_3881,20,2,6,8,12,0.000002
lmchatterbox,15,2,2,4,12,0
awbradl9,12,2,2,4,13,0.000064
Traditional-Bag-4508,14,0,0,0,0,0
Traditional-Swan-130,11,0,4,4,11,0
TrainOfThought6,12,1,3,4,13,0.000021
TrelanaSakuyo,11,2,2,4,14,0
amongthepillows,20,1,1,2,1,0
TrexPushupBra,13,2,3,5,13,0.000061
space_cult,21,2,2,4,13,0.000061
Trouble_Walkin,14,1,1,2,14,0
thatrandomuser1,20,3,4,7,13,0
mayasux,10,3,2,5,12,0.000626
U8337Flower,24,3,3,6,13,0.000108
mcbriza,10,2,1,3,14,0.000015
UnbreakableAlice,26,2,2,4,15,0
writinwater,13,1,3,4,14,0
lemickeynorings,16,3,4,7,12,0.001054
alliwantistacoss,30,4,5,9,12,0.000001
anotherdropin,16,2,3,5,13,0
multipocalypse,45,1,4,5,11,0
utriptmybitchswitch,10,1,1,2,13,0
blackglum,10,3,3,6,12,0.000024
Universeintheflesh,12,1,5,6,12,0.000428
Usual-throwaway7076,14,2,2,4,14,0
Wise_Session_5370,52,1,1,2,15,0
ded517,16,1,2,3,12,0
gr8dspro,11,2,1,3,13,0
zeeelfprince,14,1,1,2,14,0
WeAreAllMycelium,13,1,1,2,14,0.000078
katiemorag90,10,1,2,3,12,0
Wide-Speaker-7384,12,1,1,2,15,0
WildMaineBlueberry87,25,1,1,2,14,0
regus0307,22,2,2,4,13,0
Wwwwwwhhhhhhhj,10,1,2,3,11,0.000003
air_walks,10,1,1,2,14,0.000006
YawningDodo,15,1,1,2,13,0
doesanyofthismatter,10,1,1,2,12,0.000182
serial_teamkiller,10,1,3,4,12,0.000182
sustainthenoise,10,2,3,5,13,0.000058
molten_dragon,10,1,1,2,14,0.000015
bakedbaker319,14,2,3,5,12,0
_Morgi_the_Corgi_,11,2,2,4,13,0
whiskerrsss,10,1,3,4,13,0
_phish_,12,1,2,3,13,0
nottrumancapote,12,1,1,2,14,0.000001
a3wagner,10,1,1,2,14,0
mle_eliz,15,1,1,2,2,0.000001
forestrox,12,2,2,4,15,0
Snarky75,10,3,0,3,0,0
amaxen,12,1,2,3,12,0.000428
tcdaf7929,44,1,2,3,14,0
anglflw,15,1,1,2,11,0
hadesarrow3,24,4,6,10,13,0
aperture413,14,2,2,4,14,0.000072
helion_ut,27,1,2,3,12,0.000207
bakerfaceman,11,2,3,5,12,0.000052
ballisticks,11,0,2,2,12,0
foreverAmber14,13,2,3,5,11,0.000027
the_buddhaverse,16,1,2,3,12,0.004846
bladex1234,10,1,3,4,12,0.000068
captain-burrito,10,1,3,4,13,0.000373
carsonthecarsinogen,14,1,2,3,13,0.000008
copropnuma,10,2,3,5,13,0.000079
d-cent,17,1,1,2,13,0.000029
dbmermels,17,1,1,2,15,0
mystad,12,2,6,8,12,0.002242
jacquidaiquiri,17,2,3,5,12,0.000076
epicmooz,10,2,2,4,13,0
flimflam_machine,24,1,2,3,14,0.000099
fluffybabbles,10,0,3,3,11,0
friendlily,17,1,1,2,14,0.000001
poIym0rphic,10,1,2,3,13,0.000251
shrug_addict,10,1,1,2,13,0.000057
half_way_by_accident,15,0,5,5,12,0
hardman52,15,1,1,2,13,0.000092
the_LLCoolJoe,12,1,3,4,14,0
internet_commie,10,1,1,2,13,0.000056
issy_haatin,12,0,2,2,13,0
stewshi,13,1,1,2,13,0.000244
satanic_androids,11,2,3,5,13,0.000082
jiminygofckyrself,11,1,2,3,13,0
johnwcowan,10,2,5,7,12,0.000417
yellowhatb,12,1,1,2,12,0.00291
kidcudi115,13,1,1,2,12,0.001443
veartchess,11,2,2,4,12,0.00023
llordlloyd,14,1,5,6,12,0.000899
memphisjohn,12,1,1,2,14,0.00004
moo-chu,25,1,3,4,12,0
tarahlynn,15,1,6,7,12,0
nextnode,18,1,3,4,13,0.000033
none74238,10,1,2,3,12,0.000979
numbersthen0987431,17,0,3,3,12,0
phtcmp,13,1,1,2,14,0
pfundie,11,0,3,3,13,0
phoenix823,19,1,1,2,14,0
thatVisitingHasher,12,1,1,2,13,0.000006
1962Michael,36,0,0,0,0,0
scarletwellyboots,12,0,2,2,12,0
tinyhermione,26,1,1,2,12,0.000428
sreno77,13,0,2,2,12,0
sunny_suburbia,22,0,0,0,0,0
windershinwishes,14,1,2,3,12,0.000492
