id,engagement,indegree,outdegree,degree,weighted_indegree,weighted_outdegree,weighted_degree,eccentricity,closnesscentrality,harmonicclosnesscentrality,betweenesscentrality,pageranks,authority
-Dead-Eye-Duncan-,13,8,18,26,12,34,46,7,0.310525,0.329985,0.000171,0.000124,0.003787
10ebbor10,22,25,10,35,36,16,52,7,0.289986,0.304369,0.000211,0.000179,0.020943
3superfrank,25,19,9,28,46,19,65,7,0.272028,0.285353,0.000116,0.000254,0.012147
Angel1571,22,21,9,30,43,16,59,7,0.288104,0.304007,0.000287,0.000252,0.021194
ChronoVT,18,23,14,37,40,17,57,7,0.301531,0.321068,0.000647,0.000194,0.0222
DeltaBot,35,361,375,736,1460,984,2444,6,0.416268,0.470542,0.090652,0.004025,0.278208
Destinyciello,451,158,113,271,819,381,1200,7,0.361308,0.395078,0.018411,0.004112,0.083177
Evening-Skirt731,11,15,7,22,19,10,29,7,0.304246,0.32282,0.00025,0.000134,0.017531
LucidMetal,107,57,36,93,170,88,258,7,0.317825,0.340824,0.002168,0.000853,0.038504
Nofanta,11,19,4,23,27,8,35,7,0.26872,0.282087,0.000226,0.000149,0.026704
Temporary-Stay-8436,57,13,13,26,85,32,117,7,0.29116,0.306319,0.000659,0.000287,0.009188
The_Confirminator,13,15,8,23,39,14,53,7,0.287009,0.302012,0.000185,0.000224,0.01009
Thumatingra,45,46,19,65,85,29,114,7,0.320683,0.340901,0.001727,0.000495,0.034068
UnicornForeverK,20,15,8,23,33,13,46,7,0.271246,0.284984,0.000126,0.000231,0.005102
ZizzianYouthMinister,43,29,12,41,61,25,86,7,0.292118,0.309404,0.000335,0.000278,0.024069
aoc666,27,13,10,23,55,28,83,7,0.286664,0.302941,0.000377,0.000304,0.005764
gingerbreademperor,20,16,4,20,32,7,39,7,0.24322,0.252644,0.000054,0.000151,0.020892
tidalbeing,17,16,5,21,40,16,56,7,0.267324,0.279378,0.000141,0.000269,0.013383
0nlyhalfjewish,14,1,5,6,3,8,11,8,0.2496,0.26003,0.000009,0.000047,0.000037
SinCityCane,19,8,27,35,12,134,146,7,0.298944,0.316629,0.000485,0.000139,0.00343
jakeofheart,41,30,27,57,61,47,108,7,0.313317,0.333325,0.002775,0.000305,0.029535
mikeber55,10,14,4,18,21,5,26,8,0.24649,0.259326,0.000072,0.000124,0.013242
100pOmnipotence,47,19,59,78,48,372,420,7,0.328117,0.352773,0.001987,0.00048,0.005968
Ambroisie_Cy,13,11,6,17,21,10,31,7,0.281165,0.294181,0.000082,0.000111,0.010153
Bluehen55,16,16,7,23,31,15,46,8,0.259111,0.272198,0.000211,0.000228,0.014773
Bootmacher,15,14,5,19,29,11,40,8,0.265086,0.276362,0.000234,0.000145,0.01101
Bottlecapzombi,66,22,22,44,98,49,147,7,0.31423,0.333074,0.001304,0.000415,0.01127
Careless_Bat_9226,32,13,10,23,60,35,95,7,0.277648,0.289807,0.000222,0.000334,0.012681
Catsdrinkingbeer,13,17,11,28,24,12,36,7,0.293367,0.309011,0.000317,0.000124,0.016789
Dry_Bumblebee1111,172,115,71,186,263,177,440,7,0.351412,0.381414,0.008489,0.001076,0.078608
EmptyDrawer2023,55,34,15,49,104,40,144,7,0.298098,0.313929,0.000685,0.000512,0.026566
FetusDrive,54,26,25,51,104,60,164,7,0.323062,0.342729,0.001177,0.000469,0.017698
Flashy_Win_4596,24,14,9,23,52,21,73,7,0.291855,0.310274,0.000318,0.000266,0.009774
Funny_Parfait6222,22,5,5,10,38,16,54,7,0.257447,0.26944,0.000019,0.000165,0.003434
GentleKijuSpeaks,26,18,9,27,31,17,48,7,0.271637,0.28468,0.000547,0.000226,0.006941
GiveMeBackMySoup,33,26,17,43,70,32,102,7,0.305807,0.324261,0.000805,0.000316,0.037184
Goggio,62,27,27,54,100,70,170,7,0.314929,0.336191,0.001212,0.000489,0.014728
GreatResetBet,23,24,14,38,37,17,54,7,0.299874,0.317821,0.000322,0.000217,0.017456
GrouchyGrinch1,18,4,2,6,20,14,34,7,0.252256,0.263529,0.000004,0.000078,0.005898
Happy-Definition-656,15,6,2,8,27,9,36,8,0.24901,0.258714,0.000027,0.000122,0.002217
Hypekyuu,191,111,76,187,439,148,587,7,0.35808,0.389341,0.016991,0.001797,0.067991
Key-Willingness-2223,138,24,18,42,227,99,326,7,0.298865,0.317676,0.001139,0.00084,0.01684
Kohvazein,17,5,5,10,27,13,40,8,0.263421,0.274558,0.000005,0.000158,0.001568
LaMadreDelCantante,16,10,7,17,39,19,58,8,0.218097,0.226568,0.000693,0.000308,0.001224
LordBecmiThaco,41,33,15,48,66,24,90,7,0.289338,0.305004,0.000803,0.000407,0.02862
Lylieth,118,68,43,111,179,112,291,7,0.316205,0.340743,0.002089,0.000811,0.040372
MagnanimosDesolation,58,35,20,55,115,50,165,7,0.314121,0.332964,0.001654,0.000496,0.034124
Marithamenace,15,9,3,12,35,13,48,8,0.254238,0.263962,0.000016,0.000211,0.004307
Ndlburner,50,21,15,36,57,30,87,7,0.297237,0.313677,0.00031,0.000242,0.016066
Nerdsamwich,25,8,6,14,49,26,75,7,0.282163,0.299488,0.000091,0.00025,0.008324
Oishiio42,43,14,8,22,76,23,99,7,0.279051,0.293762,0.000169,0.000282,0.006775
Ok-Bug-5271,19,15,6,21,44,13,57,8,0.252045,0.262881,0.000076,0.000204,0.005514
OverpricedGoods,27,16,27,43,38,43,81,7,0.309696,0.33052,0.000495,0.000239,0.007565
PhasmaUrbomach,91,19,18,37,188,83,271,7,0.299023,0.316517,0.000495,0.000567,0.008566
PrevekrMK2,13,21,9,30,30,13,43,7,0.278605,0.295198,0.000624,0.00015,0.01877
ProDavid_,325,107,89,196,553,318,871,7,0.349649,0.381972,0.007928,0.00225,0.064663
Profound_Thots,14,11,21,32,17,36,53,7,0.29851,0.31541,0.000291,0.000154,0.003031
Ready-Recognition519,23,13,9,22,46,20,66,7,0.280104,0.294338,0.000078,0.00023,0.00856
Redditor274929,19,13,10,23,28,23,51,7,0.322969,0.341997,0.000546,0.00014,0.017857
RideNo4759,15,10,7,17,32,14,46,7,0.26252,0.275135,0.000152,0.000199,0.004143
RottedHuman,32,16,8,24,43,32,75,7,0.273375,0.28607,0.000201,0.000263,0.010007
RulesBeDamned,22,54,10,64,59,10,69,7,0.286918,0.302298,0.000664,0.000235,0.068115
SoftwareAny4990,11,19,13,32,24,15,39,7,0.279983,0.295615,0.000258,0.000162,0.018343
Stereo_Jungle_Child,31,38,8,46,53,10,63,7,0.288104,0.303828,0.00037,0.000276,0.026333
The_Amazing_Emu,20,13,12,25,40,19,59,7,0.273012,0.286337,0.000307,0.000156,0.009044
TinyFlamingo2147,17,9,5,14,35,14,49,7,0.286157,0.303168,0.000079,0.000223,0.010682
Top-Bootylover,13,5,6,11,17,12,29,8,0.243076,0.253141,0.000018,0.000123,0.002733
Verdeckter,11,12,7,19,26,8,34,7,0.259482,0.272234,0.000124,0.000186,0.002727
bettercaust,61,40,29,69,116,60,176,7,0.316205,0.33932,0.001131,0.000476,0.034996
dula_peep_says,23,15,7,22,35,12,47,7,0.277836,0.291868,0.000348,0.000244,0.004533
dvolland,42,30,22,52,115,52,167,7,0.30123,0.318412,0.001072,0.000543,0.016889
ecafyelims,17,9,5,14,34,8,42,8,0.269905,0.28307,0.000034,0.000119,0.004064
elysian-fields-,32,23,14,37,59,29,88,7,0.296575,0.3154,0.000519,0.000338,0.016971
emohelelwye,21,24,10,34,34,12,46,7,0.288416,0.301647,0.000371,0.000167,0.014693
hacksoncode,33,32,20,52,70,31,101,7,0.325453,0.348677,0.000964,0.000247,0.029886
iamintheforest,74,57,25,82,149,62,211,7,0.314689,0.336957,0.001427,0.000622,0.036343
kimariesingsMD,32,32,20,52,70,32,102,7,0.31125,0.331205,0.000976,0.00025,0.032114
lordtrickster,38,27,14,41,74,29,103,7,0.286048,0.301361,0.000363,0.000275,0.027659
muyamable,31,27,11,38,52,18,70,7,0.297276,0.314198,0.000348,0.000299,0.015254
throwaway75643219,14,14,7,21,30,12,42,7,0.286973,0.300927,0.000089,0.000166,0.015696
weedywet,16,20,5,25,37,9,46,7,0.277802,0.291884,0.000114,0.000172,0.021013
11289,15,3,14,17,4,22,26,8,0.254911,0.265341,0.001066,0.000166,0.000147
Asleep_Region,16,14,3,17,18,4,22,8,0.240036,0.247851,0.000288,0.000143,0.000462
Careless-Ability-748,19,33,6,39,42,7,49,8,0.251416,0.262033,0.001992,0.000251,0.002595
FairyCompetent,31,24,8,32,40,15,55,8,0.247649,0.257003,0.000931,0.000332,0.000926
False_Appointment_24,37,31,11,42,58,20,78,7,0.302014,0.31928,0.002412,0.000373,0.016511
LdiJ46,14,16,2,18,25,2,27,9,0.212539,0.218474,0.000096,0.000135,0.000438
Lucky_Volume3819,101,42,24,66,90,37,127,7,0.249381,0.26254,0.00429,0.000971,0.000537
NeverRarelySometimes,11,13,6,19,22,8,30,7,0.250429,0.259644,0.000422,0.000147,0.000403
Ok_Maintenance7716,32,12,3,15,36,19,55,8,0.19779,0.203719,0.001069,0.000381,0.000513
am_Nein,21,14,7,21,31,8,39,8,0.23361,0.241644,0.00039,0.000169,0.000337
annang,26,15,8,23,41,14,55,8,0.227428,0.237364,0.00061,0.000158,0.000311
ocnozix,15,5,0,5,5,0,5,0,0,0,0,0.000069,0.000066
redditstinkttotal,17,8,2,10,12,2,14,8,0.21025,0.216048,0.000046,0.000102,0.000206
sisterfunkhaus,15,14,7,21,18,7,25,8,0.243429,0.252593,0.000451,0.000213,0.000211
stroppo,23,18,7,25,26,7,33,7,0.259289,0.268581,0.001314,0.000236,0.000868
11grim,12,7,16,23,14,25,39,7,0.300531,0.317549,0.000075,0.00007,0.011619
5510,16,21,16,37,52,23,75,7,0.294914,0.311109,0.000508,0.000247,0.016363
Awkward-Estate-9787,71,27,23,50,105,55,160,7,0.312582,0.333529,0.000972,0.000465,0.017301
Cacafuego,27,21,8,29,63,24,87,7,0.282956,0.298381,0.000378,0.000337,0.022402
Full-Professional246,94,63,47,110,186,94,280,6,0.327074,0.351152,0.002946,0.000928,0.034461
HazyAttorney,112,78,45,123,228,89,317,6,0.335159,0.361827,0.003956,0.000784,0.060112
Healthy_Shine_8587,55,34,94,128,52,251,303,6,0.350732,0.378546,0.00562,0.000483,0.009716
Pale_Zebra8082,81,31,22,53,173,96,269,7,0.317958,0.339257,0.001468,0.000765,0.022256
Physical_Stop851,47,33,24,57,88,43,131,7,0.309866,0.330623,0.000851,0.000365,0.024115
RealisticTadpole1926,31,12,4,16,25,13,38,7,0.258948,0.271009,0.000489,0.000201,0.005554
Teddy_The_Bear_,33,28,13,41,68,24,92,7,0.281812,0.297092,0.00038,0.000298,0.022582
TheSauceeBoss,50,31,17,48,100,36,136,7,0.309802,0.332448,0.000831,0.000393,0.031223
fossil_freak68,41,20,14,34,70,39,109,7,0.291516,0.308634,0.000214,0.000367,0.011025
jatjqtjat,72,85,31,116,144,45,189,7,0.332501,0.35557,0.003443,0.000597,0.070391
phoenix823,35,36,11,47,54,16,70,7,0.292231,0.308803,0.000679,0.000297,0.02077
tnic73,16,17,5,22,28,8,36,7,0.279706,0.294198,0.00005,0.000096,0.017078
12bEngie,19,6,15,21,23,24,47,7,0.304123,0.324526,0.000213,0.00014,0.003975
FarConstruction4877,44,35,16,51,72,29,101,7,0.304881,0.323886,0.000702,0.00034,0.020511
GermanPayroll,24,30,19,49,47,21,68,6,0.311614,0.332465,0.000912,0.000257,0.018563
LEMO2000,10,7,4,11,19,11,30,7,0.263667,0.275879,0.000027,0.000149,0.00524
NaturalCarob5611,71,80,40,120,133,57,190,7,0.320388,0.343606,0.002549,0.000648,0.050883
RiverCityWoodwork,33,42,13,55,68,19,87,7,0.30125,0.318281,0.000541,0.000313,0.036868
Shadow_666_,34,48,27,75,81,33,114,7,0.304675,0.324764,0.001396,0.000351,0.042179
darthmcdarthface,23,15,7,22,54,10,64,7,0.250872,0.261786,0.000109,0.000218,0.009732
lifeisabowlofbs,32,40,16,56,71,20,91,7,0.315083,0.336764,0.000815,0.000217,0.048335
212312383,226,99,173,272,247,646,893,6,0.375975,0.416008,0.024854,0.001588,0.049836
Able_Enthusiasm2729,17,12,12,24,49,15,64,7,0.287191,0.30343,0.000131,0.000101,0.018611
AccountWasFound,17,6,6,12,15,8,23,7,0.284075,0.298597,0.000374,0.000077,0.003546
Actual_Confusion7140,11,12,9,21,19,12,31,7,0.276074,0.29188,0.000218,0.000126,0.012269
Alternative_Pin_7551,27,17,26,43,53,36,89,6,0.322211,0.343074,0.0011,0.000235,0.019782
Amoral_Abe,23,26,9,35,46,18,64,7,0.293481,0.31066,0.000523,0.00024,0.02115
AutistAstronaut,23,14,8,22,36,17,53,7,0.287537,0.302784,0.000152,0.00018,0.016825
Beneficial-Diet-9897,26,28,16,44,64,25,89,7,0.308095,0.326287,0.000532,0.000276,0.019488
Bodoblock,31,28,16,44,48,24,72,7,0.316758,0.337251,0.001618,0.000268,0.033288
CartographerKey4618,97,72,40,112,193,76,269,7,0.33976,0.364575,0.004143,0.000872,0.05838
ClockOfTheLongNow,735,206,184,390,1065,589,1654,7,0.352506,0.394911,0.03879,0.004929,0.129972
CurdKin,118,38,145,183,94,709,803,6,0.366365,0.403272,0.00646,0.000601,0.027915
DataCassette,10,19,9,28,29,12,41,7,0.282427,0.298619,0.000147,0.000131,0.026448
DonnPT,27,14,22,36,37,57,94,7,0.31213,0.33115,0.000263,0.000232,0.009949
DrNogoodNewman,37,22,18,40,75,30,105,7,0.313101,0.332747,0.000555,0.000367,0.014449
Dull_Conversation669,23,29,12,41,35,14,49,7,0.281567,0.300274,0.000565,0.000224,0.031309
Emotinonal_jiggolo,21,19,13,32,31,16,47,7,0.292931,0.308972,0.001426,0.000229,0.010627
EopNellaRagde,19,10,7,17,33,10,43,7,0.279068,0.294152,0.000062,0.000177,0.008989
Eric848448,21,23,12,35,41,16,57,8,0.264962,0.282426,0.000756,0.000271,0.024231
Factory-town,200,66,74,140,242,185,427,7,0.303288,0.333364,0.003667,0.001223,0.061771
Fantastic_Yam_3971,15,17,28,45,19,42,61,6,0.323039,0.345385,0.000557,0.00007,0.02883
FearTheAmish,13,13,9,22,28,16,44,7,0.294761,0.309557,0.000124,0.000128,0.017682
FenisDembo82,10,5,52,57,6,176,182,7,0.29478,0.320759,0.000594,0.000083,0.003379
FunOptimal7980,17,11,3,14,14,4,18,7,0.28052,0.295469,0.0002,0.00011,0.011667
GabaReceptors,12,4,3,7,21,11,32,7,0.260542,0.272882,0.000009,0.000083,0.004298
Gurrgurrburr,15,17,14,31,36,20,56,7,0.307176,0.325113,0.000244,0.000149,0.018712
HaikaiNoRenga,101,13,11,24,218,112,330,7,0.29193,0.304915,0.000505,0.001126,0.008084
Happy-Viper,23,8,6,14,48,19,67,7,0.295955,0.311178,0.000172,0.000186,0.009251
HardlyDecent,34,31,21,52,47,24,71,8,0.270841,0.290983,0.000501,0.000252,0.03805
Hellioning,84,68,26,94,126,49,175,7,0.328617,0.351481,0.00266,0.000595,0.056497
HexspaReloaded,12,17,16,33,23,66,89,7,0.298412,0.31611,0.000236,0.000107,0.023478
HolyToast,117,48,37,85,181,117,298,6,0.327998,0.351906,0.002283,0.001033,0.025198
I405CA,160,94,49,143,257,86,343,7,0.292912,0.319548,0.002834,0.001211,0.069694
InNominePasta,15,13,6,19,20,7,27,8,0.268226,0.285135,0.000271,0.000164,0.017473
Inner_Butterfly1991,35,35,18,53,71,29,100,7,0.303776,0.323497,0.001165,0.000284,0.029338
JustAdlz,12,14,10,24,29,11,40,7,0.280677,0.295678,0.000175,0.000097,0.016688
Known_Ad871,15,12,5,17,28,7,35,7,0.263897,0.276208,0.000058,0.000141,0.014364
KokonutMonkey,18,31,5,36,36,5,41,7,0.280886,0.296233,0.000234,0.000235,0.022866
Krytan,40,39,18,57,80,26,106,7,0.314754,0.335925,0.001107,0.00029,0.045313
L11mbm,16,21,6,27,36,10,46,7,0.290525,0.305653,0.000251,0.000197,0.016306
Logogram_alt,15,9,26,35,14,52,66,7,0.311207,0.332644,0.000466,0.000208,0.003536
Madrigall,17,18,8,26,32,12,44,7,0.26821,0.282557,0.000342,0.00021,0.01083
MaineHippo83,84,68,48,116,152,66,218,6,0.328331,0.352962,0.007562,0.000837,0.054047
MeasurementCreepy926,171,50,52,102,379,206,585,7,0.345672,0.371692,0.005529,0.001461,0.034384
MorganWick,26,30,26,56,48,31,79,7,0.30113,0.324255,0.001119,0.000191,0.038996
Most_Finger,54,21,21,42,117,46,163,7,0.296381,0.314378,0.001156,0.000485,0.01198
MrGraeme,125,43,33,76,192,100,292,7,0.322739,0.342355,0.002259,0.000924,0.020353
Murky-Magician9475,85,32,25,57,156,95,251,7,0.322441,0.34474,0.00078,0.000718,0.029926
Mvpbeserker,12,9,6,15,25,12,37,7,0.283328,0.29866,0.000073,0.000124,0.010029
MysteryBagIdeals,35,22,14,36,51,23,74,7,0.275822,0.29112,0.000221,0.000262,0.017482
Mztmarie93,26,23,26,49,33,33,66,7,0.287227,0.308811,0.000451,0.000197,0.027183
Next_Dragonfruit_415,15,11,7,18,22,12,34,7,0.289393,0.305548,0.000115,0.000119,0.012341
NotMyBestMistake,45,39,18,57,77,26,103,7,0.312539,0.332259,0.002185,0.000489,0.020049
Nrdman,317,141,89,230,542,273,815,7,0.348921,0.382327,0.0129,0.002562,0.083057
Obatala_,21,10,8,18,49,21,70,7,0.28411,0.299751,0.000098,0.000301,0.014082
Ornery-Ticket834,29,32,21,53,70,34,104,7,0.291516,0.308632,0.001341,0.00031,0.039872
Personal-Ad-6557,11,11,6,17,26,9,35,7,0.289153,0.305178,0.000156,0.000107,0.013599
Phage0070,65,34,19,53,101,49,150,7,0.302478,0.322392,0.000508,0.000486,0.025551
Potential_Wish4943,57,46,22,68,97,36,133,7,0.296401,0.313977,0.001597,0.000582,0.03576
Pure_Seat1711,12,13,2,15,25,7,32,7,0.275805,0.290014,0.00002,0.000115,0.018815
Rabbid0Luigi,25,29,16,45,51,28,79,6,0.314645,0.332457,0.000677,0.000254,0.026312
Randy_Watson,10,6,3,9,7,4,11,7,0.235309,0.24535,0.000043,0.00007,0.008624
Reasonable-Fee1945,153,60,79,139,217,247,464,7,0.335208,0.365587,0.00733,0.001242,0.042123
Redditributor,23,21,13,34,46,25,71,7,0.291366,0.305392,0.000752,0.000219,0.025401
Roadshell,68,57,23,80,117,44,161,7,0.331941,0.353984,0.002473,0.000508,0.046728
Sageblue32,35,20,29,49,42,40,82,7,0.276327,0.296843,0.000306,0.000147,0.031841
SantaClausDid911,13,21,10,31,33,14,47,7,0.289634,0.305927,0.000414,0.000128,0.038411
Senior-Friend-6414,11,8,6,14,16,10,26,8,0.270017,0.282596,0.000041,0.000127,0.006289
Smokey-McPoticuss,15,11,8,19,34,15,49,7,0.282515,0.29793,0.000148,0.000147,0.013101
SpaceCowboy34,13,17,8,25,27,11,38,7,0.278382,0.294935,0.000207,0.000141,0.015652
SpendAccomplished819,37,15,7,22,89,31,120,7,0.276986,0.29195,0.000432,0.000402,0.019168
Splenda,18,20,15,35,34,23,57,8,0.262733,0.280148,0.000146,0.000138,0.034757
StevenGrimmas,39,28,21,49,85,32,117,7,0.306718,0.325738,0.000616,0.000417,0.017963
StinkusMinkus2001,10,9,8,17,21,11,32,8,0.263897,0.276184,0.000141,0.000088,0.013191
StopblamingTeachers,28,21,7,28,62,26,88,7,0.266005,0.27881,0.000224,0.000416,0.017208
Successful_Cat_4860,25,34,5,39,53,16,69,7,0.280295,0.292396,0.000519,0.000208,0.043515
SuckMyBike,51,35,25,60,98,55,153,7,0.318585,0.340911,0.001076,0.000527,0.028074
Super_Mario_Luigi,16,25,11,36,34,11,45,7,0.295549,0.310177,0.000345,0.000126,0.024095
TheWhistleThistle,59,44,22,66,115,64,179,7,0.297413,0.315849,0.001426,0.000623,0.027117
TheYoinkiSploinki,17,13,9,22,35,16,51,7,0.283665,0.296133,0.000204,0.000207,0.012933
ThisOneForMee,21,24,14,38,37,19,56,7,0.298727,0.313632,0.001952,0.000218,0.017999
Toverhead,63,37,18,55,111,50,161,7,0.326603,0.34881,0.001544,0.00053,0.032462
Trylena,43,9,10,19,85,40,125,7,0.274685,0.288202,0.000091,0.00043,0.005787
Uhhyt231,151,73,43,116,237,93,330,7,0.325406,0.34563,0.013115,0.001104,0.035246
VortexMagus,11,12,8,20,27,11,38,7,0.278245,0.292431,0.000082,0.000149,0.012654
WinDoeLickr,43,36,20,56,95,49,144,7,0.33216,0.356177,0.001454,0.000453,0.035572
XenoRyet,103,75,39,114,154,163,317,6,0.344018,0.371712,0.003944,0.000752,0.05171
YetAnotherGuy2,15,12,7,19,15,7,22,7,0.278109,0.295482,0.000178,0.000096,0.017231
Z7-852,259,85,50,135,429,228,657,6,0.351439,0.37976,0.006263,0.001848,0.055857
ZoomZoomDiva,83,47,29,76,152,88,240,6,0.323546,0.342368,0.00245,0.000744,0.03286
addictedtolife78,66,20,23,43,93,75,168,7,0.303756,0.322428,0.000675,0.000582,0.011267
amrodd,16,14,13,27,54,28,82,7,0.288361,0.30623,0.000149,0.000192,0.01554
anewleaf1234,139,81,44,125,260,137,397,7,0.335134,0.360501,0.003596,0.001086,0.075632
bifewova234,13,11,2,13,31,10,41,8,0.244362,0.253946,0.000012,0.000172,0.017719
billpalto,39,34,8,42,62,11,73,7,0.274535,0.295429,0.000181,0.000253,0.045379
curiouslyjake,44,34,15,49,73,30,103,7,0.301291,0.319608,0.000409,0.000306,0.024462
das_war_ein_Befehl,31,29,18,47,45,28,73,7,0.287976,0.310114,0.000755,0.000319,0.027869
davidml1023,32,17,10,27,63,17,80,7,0.304819,0.323527,0.000539,0.000211,0.012186
fascistp0tato,86,35,78,113,82,279,361,6,0.359102,0.387672,0.006145,0.000528,0.021097
going_my_way0102,34,26,32,58,64,61,125,7,0.304409,0.32372,0.000902,0.000292,0.025356
h4ckerkn0wnas4chan,10,13,2,15,18,2,20,8,0.250553,0.261055,0.000083,0.000109,0.014354
heidismiles,27,27,16,43,56,19,75,7,0.321024,0.341722,0.001576,0.00022,0.02163
intothewoods76,71,27,16,43,123,33,156,7,0.305559,0.32512,0.002277,0.000541,0.01896
iosefster,17,29,15,44,32,15,47,7,0.316293,0.337431,0.001,0.000151,0.03209
link3945,14,11,5,16,15,7,22,8,0.244033,0.255342,0.000119,0.000068,0.016816
loverofmasterbation,11,5,3,8,12,4,16,7,0.274818,0.288735,0.000418,0.00007,0.008825
luigiamarcella,24,26,10,36,39,12,51,7,0.285004,0.299534,0.000927,0.00029,0.017166
medical_bancruptcy,34,18,19,37,65,40,105,7,0.289912,0.306557,0.00042,0.00031,0.015397
megacide84,15,7,6,13,15,15,30,8,0.262825,0.275193,0.00004,0.000147,0.004173
melissaphobia,20,12,7,19,34,12,46,7,0.286773,0.302428,0.000081,0.000242,0.006987
ninja-gecko,57,42,26,68,128,50,178,7,0.329766,0.352843,0.001838,0.000552,0.03565
nowthatswhat,14,9,5,14,26,13,39,8,0.251346,0.262406,0.000052,0.000131,0.010894
pomod,18,14,9,23,23,14,37,7,0.275152,0.291915,0.000135,0.000155,0.016436
poprostumort,62,41,27,68,113,49,162,7,0.328522,0.352637,0.001343,0.000452,0.037889
premiumPLUM,64,43,24,67,92,54,146,6,0.314864,0.335887,0.001192,0.000427,0.023581
ralph-j,24,29,11,40,46,16,62,7,0.274701,0.289421,0.000198,0.000222,0.016874
raynorelyp,32,9,31,40,21,64,85,7,0.327571,0.348389,0.000756,0.000185,0.005006
sardine_succotash,72,47,34,81,125,63,188,7,0.323361,0.346114,0.003133,0.000552,0.047247
satyvakta,73,85,36,121,175,50,225,7,0.321479,0.344705,0.004107,0.001014,0.053611
shhhOURlilsecret,11,4,2,6,21,7,28,7,0.273507,0.287427,0.000074,0.000154,0.005415
shouldco,36,41,31,72,78,40,118,7,0.318137,0.339019,0.00126,0.000379,0.038577
sneezywolf2,32,20,18,38,53,52,105,7,0.305951,0.324169,0.000325,0.000323,0.019528
speedingpullet,20,13,12,25,27,18,45,8,0.261369,0.277878,0.000127,0.00016,0.017899
speedyjohn,39,34,21,55,74,38,112,7,0.301271,0.320145,0.00079,0.000357,0.019669
stubble3417,11,10,10,20,19,11,30,7,0.260887,0.276185,0.000121,0.00016,0.0064
the_1st_inductionist,124,76,26,102,204,95,299,7,0.318944,0.342092,0.001958,0.000753,0.063097
whoami9427,10,17,6,23,28,8,36,7,0.291949,0.30895,0.000237,0.000189,0.01357
withlove_07,24,5,2,7,47,21,68,7,0.244917,0.25282,0.000007,0.000252,0.005784
yesrushgenesis2112,12,8,5,13,21,11,32,7,0.294053,0.311902,0.000114,0.000092,0.012278
zxxQQz,13,15,8,23,29,18,47,7,0.300013,0.318051,0.000083,0.000115,0.021141
3OAM,15,8,15,23,17,39,56,7,0.313969,0.334147,0.000361,0.000186,0.00404
00Oo0o0OooO0,13,15,6,21,22,10,32,8,0.276479,0.291849,0.000115,0.000146,0.00748
Appropriate_Owl_91,24,6,6,12,33,6,39,8,0.251681,0.262656,0.000017,0.000071,0.004769
Dave_A480,15,18,5,23,23,9,32,8,0.264916,0.278438,0.000488,0.000111,0.016019
Electronic_Mango1,11,8,9,17,29,14,43,7,0.271295,0.286882,0.000107,0.000094,0.01166
Giblette101,191,123,94,217,397,172,569,7,0.358109,0.388465,0.013039,0.001723,0.097865
Kaleb_Bunt,14,27,1,28,29,2,31,8,0.252368,0.263058,0.000039,0.00009,0.034665
Ok_Border419,107,70,155,225,122,649,771,7,0.362175,0.398114,0.012308,0.000938,0.037073
Xralius,17,10,4,14,29,16,45,8,0.251751,0.262121,0.000048,0.000216,0.003889
onethomashall,10,11,7,18,25,14,39,7,0.291516,0.307874,0.000086,0.000119,0.006961
ontologram,20,20,7,27,33,12,45,7,0.286555,0.302465,0.000358,0.000188,0.014646
stewmander,19,13,7,20,29,10,39,7,0.292495,0.307697,0.000105,0.000125,0.012968
4-5Million,18,8,10,18,20,24,44,7,0.289541,0.305792,0.000051,0.000173,0.002853
BarleyWineIsTheBest,61,34,32,66,132,84,216,7,0.322051,0.345818,0.001003,0.000518,0.027249
Kakamile,179,98,64,162,319,161,480,7,0.347636,0.377124,0.007703,0.001462,0.071516
PM_ME_YOUR_NICE_EYES,94,68,43,111,155,80,235,7,0.340578,0.365999,0.003702,0.000725,0.0518
YardageSardage,31,32,22,54,50,30,80,7,0.306947,0.326055,0.000992,0.00025,0.020945
arrgobon32,39,33,13,46,60,35,95,7,0.282886,0.298486,0.000536,0.000398,0.014295
programmerOfYeet,13,10,7,17,21,11,32,7,0.280764,0.294702,0.000052,0.000127,0.005654
45607,69,18,28,46,70,165,235,7,0.304062,0.323501,0.000592,0.000532,0.005715
AdAppropriate2295,74,38,35,73,169,90,259,6,0.337481,0.360433,0.002559,0.000758,0.030081
CocoSavege,59,52,36,88,110,58,168,7,0.323801,0.346499,0.001791,0.000443,0.042108
Falernum,74,60,35,95,133,66,199,7,0.313795,0.336269,0.001367,0.000593,0.034312
Far_Commission2655,67,26,23,49,106,53,159,6,0.324404,0.34505,0.001997,0.000462,0.021085
FerdinandTheGiant,73,35,27,62,131,48,179,7,0.31185,0.332002,0.000804,0.000461,0.030004
Glory2Hypnotoad,25,39,21,60,66,37,103,7,0.309485,0.329752,0.000674,0.000279,0.039231
JJExecutioner,13,11,7,18,17,11,28,7,0.278228,0.292737,0.000087,0.000115,0.014016
KaiBahamut,52,31,21,52,100,52,152,7,0.290693,0.309457,0.000723,0.000362,0.026206
Leylolurking,14,7,6,13,24,13,37,7,0.262855,0.27641,0.000035,0.000143,0.0049
Morthra,182,142,98,240,344,170,514,6,0.349757,0.383624,0.012931,0.001683,0.108317
Nemeszlekmeg,49,45,37,82,95,106,201,7,0.310994,0.332738,0.001988,0.00057,0.020565
NewCountry13,19,13,9,22,45,23,68,7,0.286501,0.301683,0.000148,0.00021,0.008077
Oborozuki1917,25,20,25,45,33,38,71,6,0.322028,0.342478,0.00219,0.000263,0.008638
RevolutionaryGur4419,74,27,24,51,141,74,215,7,0.297589,0.316245,0.001176,0.000657,0.016492
SupervisorSCADA,52,31,20,51,107,52,159,7,0.304409,0.326627,0.000767,0.000366,0.017433
TurbulentArcher1253,200,51,45,96,374,193,567,6,0.343522,0.369901,0.003897,0.001436,0.03619
Z-e-n-o,16,3,2,5,18,12,30,8,0.245621,0.255921,0.000003,0.00009,0.001089
ZozMercurious,11,8,7,15,16,9,25,7,0.277478,0.290865,0.000028,0.000102,0.003644
_Royalty_,16,19,7,26,31,9,40,7,0.270066,0.284989,0.000201,0.000173,0.018285
alfredo094,20,9,12,21,37,22,59,7,0.282233,0.297662,0.000359,0.000172,0.003137
comeon456,45,20,10,30,70,38,108,7,0.286827,0.302373,0.000307,0.000309,0.011127
eri_is_a_throwaway,12,15,5,20,23,9,32,7,0.281549,0.295867,0.000102,0.000113,0.013525
flairsupply,61,57,18,75,120,32,152,7,0.317713,0.338381,0.001919,0.000497,0.043667
spacebar30,43,26,16,42,84,42,126,7,0.29526,0.313534,0.000365,0.0004,0.022323
stockinheritance,88,69,43,112,172,79,251,6,0.350542,0.377202,0.005808,0.000875,0.045444
timmytissue,13,12,8,20,34,15,49,7,0.25975,0.271379,0.000219,0.000186,0.00452
urnever2old2change,24,15,13,28,31,26,57,7,0.287976,0.30415,0.000443,0.000225,0.009724
4Throw2My0Ass6Away9,45,7,11,18,25,44,69,7,0.268417,0.280022,0.000897,0.00037,0.000474
--o,11,10,8,18,27,12,39,7,0.256151,0.265915,0.000521,0.000199,0.002997
Ayjayz,27,18,10,28,45,13,58,7,0.273325,0.28662,0.000715,0.000193,0.017706
MS-07B-3,11,11,6,17,22,13,35,8,0.273573,0.287473,0.000232,0.000174,0.006034
NullIsUndefined,13,16,7,23,22,8,30,7,0.264359,0.275229,0.000438,0.000182,0.001347
Only-Finish-3497,36,21,12,33,58,33,91,7,0.271816,0.285386,0.001144,0.000431,0.002469
Pearberr,10,3,1,4,7,3,10,8,0.211626,0.217012,0.000004,0.000064,0.001431
Rainbwned,148,89,44,133,226,97,323,7,0.336729,0.361252,0.013689,0.001547,0.044915
Shotgun_Rynoplasty,12,15,7,22,20,12,32,7,0.279258,0.292865,0.000644,0.000123,0.004656
sir_mrej,16,8,2,10,13,3,16,9,0.192838,0.197232,0.000195,0.000354,0.000376
thatoneguy54,12,7,4,11,9,6,15,8,0.231142,0.239681,0.000177,0.00014,0.003555
xienwolf,15,9,4,13,15,6,21,8,0.23442,0.242312,0.000637,0.000217,0.000892
4rsenal4lyfe,16,3,4,7,6,6,12,8,0.246061,0.254427,0.000055,0.000078,0.001916
Cloud_N0ne,15,6,6,12,8,7,15,8,0.23093,0.238828,0.000101,0.000147,0.000968
Mountain-Fox-2123,14,13,5,18,15,6,21,8,0.231213,0.238952,0.000109,0.00024,0.001457
luniversellearagne,125,54,20,74,94,29,123,7,0.281742,0.296865,0.005396,0.000918,0.005929
4ss4ssinscr33d,12,5,9,14,11,50,61,7,0.280191,0.293504,0.000371,0.000146,0.001667
Bracioli-Felipe,23,7,4,11,42,18,60,8,0.235371,0.242691,0.000104,0.000353,0.000491
FlyLikeAnEarworm,32,12,30,42,23,77,100,6,0.297062,0.312276,0.001347,0.00024,0.000809
Greenhawk444,13,7,5,12,19,12,31,8,0.227245,0.23513,0.000041,0.000249,0.00033
Naos210,25,9,12,21,47,18,65,7,0.27658,0.28932,0.00056,0.000253,0.000946
New_Perception_7838,142,57,34,91,143,93,236,7,0.295916,0.315346,0.006628,0.001293,0.007416
TheMissingPremise,65,41,78,119,60,154,214,7,0.350027,0.382007,0.004876,0.000387,0.033367
mattronimus007,83,20,34,54,53,84,137,7,0.2847,0.301603,0.002506,0.0005,0.000815
system-Contr0l111,38,13,10,23,69,29,98,7,0.26715,0.279163,0.000862,0.000409,0.001677
taez555,15,11,3,14,17,4,21,8,0.24423,0.255296,0.000158,0.000218,0.009992
8NaanJeremy,53,25,25,50,59,85,144,7,0.314623,0.335908,0.000768,0.000277,0.014722
47ca05e6209a317a8fb3,20,26,7,33,37,11,48,7,0.304062,0.323394,0.000243,0.00017,0.02471
Adventurous_Art4009,10,5,1,6,19,5,24,8,0.236613,0.244039,0.000001,0.000165,0.00411
Fabulous-Suspect-72,28,10,5,15,51,28,79,8,0.250498,0.261564,0.000032,0.000328,0.004178
Ok-Round-1473,30,15,10,25,53,22,75,7,0.290992,0.306719,0.000145,0.000284,0.006211
SourceTheFlow,10,7,7,14,16,11,27,7,0.288729,0.303149,0.000064,0.000113,0.009329
gabagoolcel,24,13,9,22,33,20,53,7,0.28308,0.299255,0.000055,0.000193,0.007217
heroyoudontdeserve,28,27,17,44,71,29,100,7,0.301571,0.32121,0.000521,0.000256,0.029274
katilkoala101,11,15,5,20,23,7,30,7,0.292495,0.31011,0.000181,0.00013,0.012678
misanthpope,18,8,3,11,18,5,23,8,0.25,0.259613,0.000017,0.000111,0.007891
sh00l33,21,31,12,43,58,25,83,7,0.294934,0.311648,0.000256,0.000272,0.024381
yyzjertl,196,78,47,125,303,160,463,7,0.347689,0.376226,0.005012,0.001402,0.05717
96suluman,31,15,18,33,31,38,69,7,0.316979,0.335635,0.00122,0.000229,0.00991
DancingWithAWhiteHat,38,26,16,42,73,30,103,7,0.311893,0.331175,0.000744,0.000348,0.021496
Liad3008,24,8,3,11,24,8,32,7,0.248915,0.259013,0.000014,0.000186,0.004445
NoWin3930,38,24,23,47,48,57,105,7,0.322142,0.343667,0.001359,0.000279,0.01416
Ok_Cup_5454,18,6,5,11,9,9,18,8,0.25849,0.271906,0.000067,0.000085,0.005103
OpeningChipmunk1700,30,15,13,28,59,41,100,7,0.299122,0.316658,0.000732,0.000312,0.01035
ScrupulousArmadillo,34,26,14,40,66,31,97,7,0.284717,0.30117,0.000551,0.000345,0.015202
asafg8,21,13,6,19,30,12,42,7,0.292628,0.311628,0.000118,0.000155,0.009902
baes__theorem,28,27,12,39,50,16,66,7,0.307677,0.32772,0.001432,0.000315,0.022846
squirlnutz,26,18,48,66,25,108,133,7,0.30343,0.321447,0.004024,0.000225,0.00786
trullaDE,16,21,7,28,33,10,43,7,0.276648,0.291781,0.000157,0.000232,0.011715
AbleReflection459,27,3,60,63,4,151,155,7,0.30398,0.324693,0.000686,0.000117,0.000029
Anakin-vs-Sand,11,12,1,13,12,1,13,8,0.201755,0.206196,0.000045,0.000147,0.00083
BlundeRuss,12,8,26,34,11,62,73,7,0.278262,0.292475,0.000482,0.000103,0.000972
Discussion-is-good,17,11,8,19,33,16,49,7,0.270841,0.282306,0.000452,0.000129,0.008343
Grammar-Unit-28,17,7,4,11,11,8,19,8,0.228818,0.236295,0.000059,0.000228,0.000432
HelpDaren,14,7,5,12,31,11,42,8,0.229073,0.236095,0.00008,0.000275,0.00021
HeroBrine0907,25,20,10,30,36,22,58,7,0.298688,0.313078,0.000371,0.000218,0.018207
Huge_Wing51,65,20,13,33,104,50,154,7,0.297296,0.311222,0.00324,0.000537,0.004845
Intelligent_Pop1173,28,18,8,26,25,9,34,8,0.235407,0.243614,0.000218,0.000191,0.001349
JlUKOMOPbE,18,11,7,18,38,11,49,7,0.242712,0.251954,0.000549,0.000226,0.00085
Jolly_Ad2446,16,2,22,24,3,30,33,8,0.261068,0.273775,0.000062,0.000069,0.000162
LopsidedGrapefruit11,10,11,2,13,20,2,22,8,0.205901,0.21118,0.000026,0.000151,0.001233
Migraine_Megan,10,5,1,6,15,6,21,9,0.190334,0.194737,0.000001,0.000163,0.000341
NSA_van_3,81,43,27,70,84,38,122,7,0.263928,0.279023,0.00256,0.000643,0.00389
No_Baseball5846,14,10,4,14,23,6,29,7,0.258637,0.268669,0.000463,0.000175,0.003653
Noodlefanboi,14,10,4,14,16,7,23,8,0.224075,0.231254,0.000192,0.00022,0.002468
NotAFloorTank,32,35,8,43,50,15,65,8,0.266099,0.277118,0.001687,0.000256,0.004796
Notachance326426,31,20,13,33,69,23,92,7,0.284825,0.300319,0.000745,0.000247,0.009891
Ok-Juice-6857,13,3,3,6,4,4,8,8,0.210201,0.215734,0.00001,0.00007,0.00018
PasicT,11,6,1,7,6,1,7,9,0.20741,0.212541,0.000007,0.000068,0.001543
Psychological-Dig-29,11,6,6,12,17,7,24,8,0.254153,0.264789,0.000137,0.000099,0.000675
RDOCallToArms,14,11,3,14,14,3,17,8,0.214299,0.22037,0.00017,0.000213,0.000561
ReceptionLivid,13,10,5,15,22,9,31,8,0.239478,0.249093,0.000249,0.000198,0.0009
RedshirtBlueshirt97,12,5,29,34,7,55,62,8,0.267766,0.282644,0.000247,0.000097,0.000554
SamBind121,21,11,10,21,43,20,63,8,0.244599,0.253812,0.000581,0.000306,0.00119
SirVoltington,10,8,6,14,21,11,32,7,0.263375,0.275038,0.000191,0.000113,0.00231
SlipperWheels,53,21,12,33,95,48,143,7,0.303715,0.321551,0.000259,0.00038,0.017256
Sloppykrab,31,25,18,43,44,24,68,7,0.303126,0.318152,0.001878,0.00025,0.008744
Smasher31232,42,8,45,53,22,79,101,7,0.293025,0.310882,0.001071,0.000163,0.000472
SomewhereAggressive8,13,6,5,11,7,6,13,7,0.236835,0.244414,0.000142,0.000136,0.000407
Steeltoelion,13,4,2,6,13,3,16,9,0.204969,0.210869,0.00001,0.000077,0.000313
THElaytox,12,11,3,14,16,8,24,8,0.223665,0.230633,0.000086,0.000168,0.001537
TheArchitect515,26,18,8,26,55,11,66,8,0.247595,0.256887,0.000259,0.000249,0.001518
Unhaply_FlowerXII,38,23,15,38,77,23,100,7,0.312345,0.329845,0.001559,0.000309,0.011877
Wild-Spare4672,12,7,2,9,7,3,10,8,0.226824,0.234075,0.000077,0.000106,0.000607
Wonderful_Sorbet_546,19,3,2,5,13,13,26,8,0.229969,0.237787,0.000254,0.000193,0.00026
Xayne813,15,5,3,8,14,3,17,8,0.234834,0.243829,0.000048,0.000074,0.000463
aespaste,27,23,61,84,30,89,119,7,0.338111,0.36233,0.003854,0.000305,0.007765
banana_in_the_dark,13,6,11,17,10,34,44,8,0.235322,0.24593,0.000655,0.000152,0.000257
bluerog,19,8,11,19,17,29,46,7,0.278811,0.291785,0.000643,0.000237,0.001379
bostonbananarama,28,10,4,14,28,8,36,8,0.250609,0.260291,0.00024,0.000257,0.001574
ekydfejj,47,12,8,20,41,39,80,8,0.245901,0.255304,0.000214,0.000551,0.000717
empericisttilldeath,10,7,2,9,15,5,20,7,0.251304,0.260167,0.000179,0.000094,0.006713
homiegeet,11,8,3,11,18,4,22,9,0.201012,0.206348,0.000044,0.000115,0.000797
idonthaveanaccountA,12,12,3,15,17,3,20,8,0.261898,0.272167,0.00021,0.000116,0.002088
itsonmyprofile,17,7,5,12,23,7,30,8,0.243272,0.251166,0.000136,0.000094,0.001407
jgamez76,27,21,11,32,36,12,48,7,0.282815,0.297436,0.001095,0.000192,0.002232
juanzy,53,36,32,68,65,45,110,7,0.297159,0.314168,0.003875,0.000431,0.002613
loggerhead632,18,24,7,31,30,8,38,7,0.275169,0.287447,0.000349,0.000142,0.00353
luxsatanas,18,11,6,17,45,19,64,8,0.236082,0.244058,0.000171,0.000308,0.001215
maiastella,10,7,12,19,32,15,47,8,0.267577,0.279708,0.000432,0.000222,0.000497
mrsauceysauce,15,6,4,10,15,7,22,8,0.242634,0.25093,0.000105,0.000163,0.000383
proffesionalproblem,10,9,5,14,12,5,17,8,0.216585,0.222662,0.000308,0.000151,0.001545
rewt127,21,19,10,29,44,14,58,7,0.283151,0.296242,0.00078,0.000192,0.011827
rogan1990,11,12,3,15,22,3,25,8,0.245981,0.255002,0.000187,0.000093,0.001692
rollercostarican,26,9,7,16,29,17,46,7,0.265211,0.276419,0.000263,0.000173,0.000923
sarcasticorange,19,23,15,38,30,17,47,7,0.3027,0.318976,0.002455,0.000146,0.011857
w1n5t0nM1k3y,14,10,2,12,12,4,16,8,0.230777,0.237538,0.000058,0.000127,0.00129
wiiguyy,10,13,1,14,16,1,17,8,0.216719,0.222534,0.000016,0.000107,0.001394
Absolium,36,11,31,42,21,184,205,7,0.264807,0.278071,0.002005,0.0004,0.000037
AurynSharay,11,7,2,9,17,5,22,9,0.202215,0.207967,0.000493,0.000215,0.005459
Constant_Host_3212,13,15,5,20,30,10,40,7,0.22679,0.23552,0.000285,0.000165,0.000499
DarthRedYoga,11,17,7,24,25,10,35,7,0.241186,0.249981,0.000601,0.000252,0.000405
DefinitelyNotAliens,26,18,10,28,32,10,42,8,0.273259,0.284851,0.002201,0.000248,0.000881
Healthy_Brain5354,33,7,4,11,18,5,23,8,0.214056,0.220974,0.000223,0.000157,0.000152
Important_Pattern_85,10,13,10,23,23,15,38,7,0.286102,0.299215,0.002353,0.000166,0.012155
Key-Pickle5609,10,9,4,13,14,5,19,8,0.265195,0.27414,0.000527,0.000126,0.000869
Lurkyloo1987,14,5,4,9,18,12,30,7,0.230273,0.238743,0.000414,0.000225,0.000141
Moni_CSM,20,4,4,8,44,19,63,8,0.231508,0.238654,0.000425,0.000326,0.000175
NandoDeColonoscopy,33,7,6,13,32,17,49,7,0.243403,0.252386,0.000727,0.000259,0.000189
Ok-Knowledge9154,12,14,7,21,15,7,22,8,0.22054,0.229478,0.000257,0.000149,0.000293
Osiris0734,17,5,9,14,33,15,48,8,0.22433,0.233902,0.000137,0.000214,0.000078
RickRussellTX,45,34,19,53,79,23,102,7,0.30119,0.31677,0.00721,0.000354,0.021374
SheWhoIsNot,10,6,3,9,10,3,13,9,0.206549,0.212975,0.000041,0.000103,0.000196
South_Industry_1953,34,11,6,17,16,7,23,7,0.248478,0.257291,0.001014,0.000175,0.000194
Taisiecat,10,12,3,15,15,3,18,8,0.203121,0.209191,0.000093,0.00015,0.000151
ThePurplestMeerkat,39,15,12,27,55,21,76,7,0.245634,0.255297,0.001326,0.000372,0.000279
Travelgrrl,14,7,3,10,22,6,28,8,0.204941,0.211278,0.000034,0.000162,0.000168
Trevena_Ice,15,9,3,12,13,3,16,8,0.21071,0.216993,0.000358,0.000141,0.000228
darthoffa,10,3,2,5,24,11,35,9,0.189213,0.193199,0,0.000255,0.000053
ded517,10,8,4,12,10,4,14,8,0.21614,0.22402,0.000108,0.000074,0.000229
epicmooz,17,2,4,6,7,7,14,8,0.241688,0.249374,0.000105,0.000082,0.000045
jahubb062,39,10,12,22,40,16,56,7,0.238796,0.249459,0.000442,0.000239,0.000222
jamintime,10,14,3,17,17,3,20,8,0.212072,0.218936,0.000977,0.000147,0.000993
k23_k23,42,48,5,53,69,12,81,8,0.213894,0.221552,0.000462,0.000542,0.000895
makethatnoise,11,2,2,4,5,3,8,8,0.224753,0.232407,0.00001,0.000044,0.000089
notyourmartyr,34,11,8,19,53,28,81,8,0.254853,0.264069,0.000681,0.000319,0.000565
readergirl35,14,19,8,27,31,10,41,7,0.229351,0.238915,0.00066,0.000217,0.000746
rubylee_28,10,18,8,26,27,10,37,7,0.283683,0.296853,0.000789,0.000156,0.020921
AchillesFirstStand,62,6,8,14,42,51,93,8,0.244665,0.254918,0.000531,0.000687,0.000147
Cart700,19,5,5,10,17,17,34,8,0.222851,0.229542,0.000238,0.000248,0.000251
Dazz316,73,33,22,55,70,39,109,7,0.270388,0.284618,0.002342,0.000699,0.0032
Frost-Folk,28,14,8,22,31,14,45,7,0.265584,0.27561,0.000771,0.000285,0.005081
MysteriousConflict38,20,13,3,16,20,5,25,8,0.208431,0.214253,0.000082,0.000165,0.001332
RightHabit,19,12,5,17,20,8,28,8,0.23442,0.242357,0.000483,0.000627,0.000373
Swirlyflurry,51,33,5,38,46,7,53,8,0.215022,0.222064,0.001084,0.000472,0.001425
Active_Host6485,24,8,10,18,16,25,41,7,0.288233,0.304726,0.000116,0.00018,0.004885
GenTwour,34,10,5,15,52,30,82,7,0.265662,0.277648,0.000029,0.000235,0.007095
Relevant_Actuary2205,80,66,32,98,136,57,193,7,0.322808,0.34665,0.002652,0.000795,0.048391
Siukslinis_acc,24,19,12,31,41,24,65,7,0.296013,0.311055,0.000362,0.000241,0.008505
Tangentkoala,11,11,6,17,20,7,27,7,0.270066,0.282731,0.000029,0.000114,0.007628
TheVioletBarry,86,55,30,85,139,80,219,7,0.319754,0.341312,0.001908,0.000709,0.040521
cheddyvedder,10,4,3,7,11,8,19,7,0.269567,0.282603,0.000012,0.000104,0.00291
Actual_Parsnip4707,93,17,17,34,97,102,199,7,0.297628,0.315057,0.000409,0.000735,0.005684
Arthesia,29,30,10,40,46,16,62,7,0.298274,0.314796,0.000569,0.000248,0.023743
CauseAdventurous5623,27,27,20,47,55,35,90,7,0.311378,0.330228,0.000843,0.000262,0.021273
Constellation-88,68,33,21,54,111,45,156,7,0.305724,0.323424,0.001632,0.000428,0.018855
Im_Orange_Joe,11,7,4,11,12,6,18,8,0.250318,0.259927,0.000132,0.000131,0.001199
RegularEquipment3341,13,20,11,31,28,15,43,7,0.295955,0.314537,0.000155,0.000153,0.017567
Top_Neat2780,18,11,7,18,29,9,38,7,0.287903,0.303906,0.000124,0.000113,0.011021
cantantantelope,17,23,18,41,42,31,73,7,0.315039,0.33533,0.00099,0.000171,0.02499
robdingo36,10,8,6,14,22,12,34,7,0.273606,0.286529,0.000044,0.000121,0.00381
sapphireminds,51,10,9,19,87,49,136,7,0.280973,0.29562,0.000072,0.000404,0.009116
ActuatorOutside5256,75,11,25,36,51,95,146,7,0.32267,0.34225,0.00069,0.000418,0.003576
ChihuahuaNoob,26,23,16,39,70,33,103,7,0.294034,0.31265,0.000457,0.000305,0.015554
DerekVanGorder,26,6,5,11,53,23,76,7,0.27063,0.282363,0.000017,0.000349,0.002851
Elegant-Variety-7482,48,10,13,23,36,45,81,7,0.305704,0.324509,0.000292,0.000298,0.006141
Inner_Condition8955,16,8,5,13,31,11,42,7,0.278434,0.292404,0.000026,0.000162,0.005373
Karmaze,23,18,11,29,41,20,61,7,0.291629,0.308285,0.00011,0.000181,0.018578
Lanavis13,42,22,15,37,86,35,121,7,0.2819,0.297773,0.000413,0.000304,0.015342
Ok-Emu-2881,14,4,4,8,18,14,32,7,0.280503,0.294007,0.000011,0.000142,0.003335
Putrefied_Goblin,21,11,12,23,39,24,63,7,0.281182,0.297323,0.000137,0.000179,0.008946
Sirhc978,20,21,11,32,39,14,53,7,0.294512,0.311346,0.000213,0.000207,0.010607
Vesurel,41,19,11,30,75,36,111,7,0.289912,0.307869,0.000444,0.000347,0.014469
eyetwitch_24_7,27,20,7,27,53,21,74,7,0.277308,0.292817,0.000146,0.000297,0.017764
formandovega,28,30,21,51,54,31,85,7,0.316891,0.337938,0.001494,0.000313,0.022586
grandoctopus64,31,7,4,11,45,21,66,7,0.254553,0.264781,0.0001,0.00022,0.005389
majesticSkyZombie,474,150,137,287,825,406,1231,6,0.367554,0.398311,0.051642,0.004157,0.055327
squidgy617,12,3,2,5,17,13,30,8,0.248328,0.257195,0.000002,0.000112,0.002575
AdImmediate9569,27,15,18,33,28,39,67,7,0.307051,0.328673,0.000432,0.000219,0.009229
Alternative_Oil7733,52,34,24,58,90,39,129,7,0.301291,0.320487,0.000785,0.000385,0.029543
Both-Structure-6786,12,20,3,23,23,3,26,8,0.253484,0.265489,0.000066,0.000121,0.022945
DarroonDoven,12,12,9,21,17,14,31,7,0.290992,0.306691,0.000135,0.000097,0.009447
E-Reptile,24,15,8,23,38,19,57,7,0.29146,0.307475,0.000205,0.000187,0.011974
Goodlake,10,10,3,13,15,3,18,7,0.264328,0.2782,0.000019,0.000076,0.005765
HadeanBlands,390,130,91,221,652,299,951,6,0.350406,0.383319,0.011614,0.002749,0.080705
Jew_of_house_Levi,44,32,12,44,85,25,110,7,0.274269,0.290462,0.000444,0.000346,0.020459
Klutzy_Routine_9823,19,9,5,14,39,20,59,7,0.269407,0.282502,0.000023,0.000242,0.003921
RedOceanofthewest,92,57,35,92,123,64,187,7,0.32943,0.353552,0.002377,0.000561,0.047875
americafuckyea,13,12,9,21,19,14,33,7,0.269856,0.285039,0.000124,0.000163,0.005512
viaJormungandr,12,12,6,18,24,11,35,7,0.269455,0.282037,0.000036,0.000174,0.006018
AdamantForeskin,21,6,24,30,15,59,74,7,0.309126,0.33069,0.000172,0.000157,0.003694
68_hi,27,19,12,31,53,24,77,7,0.296245,0.315022,0.000379,0.00025,0.025389
Affectionate-War7655,65,42,19,61,125,63,188,7,0.323385,0.345119,0.000813,0.000567,0.050351
Finch20,36,27,14,41,58,33,91,7,0.319056,0.341045,0.000759,0.000338,0.015547
Gexm13,10,13,6,19,27,12,39,8,0.262551,0.275703,0.000047,0.000153,0.008764
ScreenTricky4257,68,30,17,47,131,48,179,7,0.310631,0.329716,0.000764,0.000505,0.036033
SiPhoenix,56,30,25,55,115,57,172,7,0.311593,0.332806,0.00113,0.000518,0.025976
aardvark_gnat,140,38,37,75,187,140,327,6,0.327193,0.352006,0.00199,0.001025,0.029168
badlyagingmillenial,14,19,7,26,29,7,36,7,0.277105,0.291698,0.000177,0.000153,0.012982
darkplonzo,17,18,9,27,36,14,50,7,0.290469,0.306304,0.000116,0.000195,0.011913
hermitix,12,9,4,13,19,4,23,8,0.263528,0.276463,0.000076,0.0001,0.004263
pavilionaire2022,14,16,9,25,26,11,37,7,0.282762,0.296897,0.000348,0.000186,0.010209
sokuyari99,17,6,6,12,20,16,36,7,0.24845,0.257679,0.000116,0.000197,0.002375
thegarymarshall,33,12,5,17,55,28,83,7,0.277648,0.291644,0.000297,0.000219,0.010948
yosisoy,11,8,5,13,20,6,26,8,0.252706,0.263204,0.000023,0.000077,0.00908
Additional-Leg-1539,20,10,16,26,23,37,60,7,0.293462,0.30996,0.000222,0.00022,0.004839
CaptCynicalPants,203,130,65,195,399,119,518,7,0.351904,0.380395,0.012295,0.001866,0.074224
Evening_Spot_5151,24,22,12,34,42,14,56,7,0.292703,0.311063,0.000295,0.000206,0.020098
Letters_to_Dionysus,41,58,20,78,88,27,115,7,0.294703,0.311552,0.001419,0.000504,0.039067
NeoLeonn3,17,12,8,20,25,12,37,7,0.260302,0.272816,0.00007,0.000213,0.003003
Putrid-Storage-9827,11,7,5,12,14,8,22,8,0.257945,0.269871,0.000053,0.000112,0.006046
Puzzleheaded-Bat-511,30,20,12,32,56,26,82,7,0.290749,0.306732,0.00024,0.000285,0.012229
VanHelsingBerserk,27,13,9,22,25,15,40,7,0.268099,0.279516,0.00056,0.00023,0.004349
alpicola,15,13,8,21,27,8,35,7,0.275135,0.288811,0.000214,0.000145,0.007598
yeahmanbombclaut,23,11,8,19,53,26,79,8,0.259185,0.271384,0.000089,0.00026,0.007244
Adorable_Standard_25,12,12,46,58,16,135,151,7,0.292062,0.318418,0.000149,0.000135,0.011531
Aazadan,17,16,12,28,28,14,42,7,0.274785,0.295119,0.000148,0.000159,0.019151
Ashmedai,56,43,37,80,81,47,128,7,0.294053,0.317827,0.001375,0.000385,0.052382
Balanced_Outlook,77,40,38,78,114,87,201,7,0.306635,0.330598,0.002468,0.000705,0.033535
Banes_Addiction,23,21,9,30,37,21,58,8,0.273095,0.290624,0.000087,0.000235,0.026068
BluesSuedeClues,241,99,193,292,271,571,842,6,0.332966,0.372867,0.013817,0.001581,0.061026
CelestialFury,21,12,9,21,36,17,53,8,0.267103,0.282668,0.000042,0.000174,0.014972
Cluefuljewel,17,14,8,22,30,12,42,7,0.26158,0.280305,0.000055,0.000123,0.024367
Dr_CleanBones,40,24,23,47,39,31,70,7,0.290843,0.312559,0.000709,0.000259,0.018478
Far_Realm_Sage,16,15,3,18,22,3,25,8,0.234457,0.244697,0.00001,0.000101,0.023963
Frank_JWilson,33,32,19,51,49,33,82,7,0.301652,0.32251,0.001351,0.000339,0.025149
Funklestein,90,34,20,54,99,58,157,7,0.273838,0.293441,0.00031,0.000572,0.037494
HowDoIEvenEnglish,10,8,10,18,18,11,29,7,0.289319,0.309444,0.000136,0.000061,0.010939
Kevin-W,12,20,20,40,29,22,51,7,0.271767,0.291499,0.000239,0.000119,0.026449
Leather-Map-8138,24,23,12,35,43,21,64,8,0.284753,0.305897,0.000511,0.000236,0.036557
Mist_Rising,51,33,39,72,74,49,123,8,0.290749,0.314826,0.001613,0.000337,0.03185
Mrgoodtrips64,27,21,17,38,33,23,56,7,0.27397,0.293334,0.000252,0.000215,0.024945
Nothing_Better_3_Do,96,57,34,91,135,63,198,7,0.284556,0.308909,0.001112,0.000681,0.049875
Petrichordates,76,49,37,86,112,62,174,8,0.284396,0.309039,0.001208,0.000592,0.037013
RCA2CE,159,67,39,106,218,106,324,8,0.279827,0.302252,0.001563,0.001033,0.056394
TaxLawKingGA,12,14,6,20,20,7,27,8,0.243941,0.25743,0.000019,0.000122,0.018808
TheNavigatrix,14,12,21,33,16,53,69,8,0.279758,0.301704,0.000163,0.000106,0.01176
Xanto97,12,12,7,19,26,8,34,8,0.255659,0.269084,0.000078,0.000187,0.004646
Xytak,20,21,12,33,30,22,52,8,0.262642,0.280456,0.000188,0.000217,0.014095
Zagden,36,30,17,47,52,28,80,7,0.259081,0.27682,0.000213,0.000304,0.028499
anti-torque,62,30,29,59,114,63,177,7,0.298392,0.321575,0.000493,0.000411,0.033918
baxterstate,123,61,33,94,156,65,221,7,0.310333,0.332668,0.005404,0.000766,0.047791
bl1y,332,101,121,222,532,286,818,7,0.315478,0.349042,0.006933,0.001952,0.061739
countrykev,19,16,11,27,32,19,51,8,0.252439,0.268086,0.000155,0.000167,0.016558
daretoeatapeach,14,7,8,15,20,17,37,8,0.265179,0.278982,0.000249,0.000142,0.008245
eh_steve_420,21,19,30,49,36,34,70,7,0.296945,0.320705,0.000544,0.000145,0.025734
ewokninja123,13,11,8,19,24,11,35,7,0.257901,0.274265,0.00004,0.000108,0.016702
frisbeejesus,24,30,14,44,43,19,62,7,0.296828,0.319254,0.001378,0.000257,0.039646
just_helping,93,48,58,106,109,97,206,7,0.299537,0.327732,0.001891,0.000593,0.049884
kingjoey52a,45,47,14,61,70,17,87,7,0.289597,0.311615,0.00133,0.000381,0.040129
kinkgirlwriter,20,22,18,40,40,21,61,7,0.285922,0.307586,0.000241,0.000172,0.027434
mrjcall,75,39,24,63,97,57,154,7,0.282304,0.304239,0.000599,0.00052,0.041052
slayer_of_idiots,83,38,17,55,106,44,150,7,0.269087,0.287118,0.001365,0.000551,0.025076
sunshine_is_hot,84,35,21,56,96,56,152,7,0.300431,0.319725,0.001509,0.000613,0.022359
zaoldyeck,187,72,57,129,300,194,494,7,0.309337,0.336017,0.005123,0.001486,0.051079
Advanced-Light317,32,3,19,22,3,86,89,7,0.262673,0.27402,0.000951,0.000083,0.000068
BlaineTog,22,13,6,19,19,14,33,8,0.243285,0.252331,0.000361,0.00017,0.000404
Entorien_Scriber,13,6,1,7,16,1,17,9,0.193473,0.197935,0.000011,0.000072,0.000125
Kaurifish,10,11,7,18,11,7,18,7,0.262596,0.27156,0.001202,0.000086,0.006809
LavishnessGeneral,10,5,2,7,6,3,9,9,0.179729,0.183939,0.00004,0.000131,0.000123
MennionSaysSo,13,18,10,28,27,11,38,7,0.292703,0.30773,0.001245,0.000126,0.012584
Moose-Live,16,20,9,29,28,10,38,7,0.272323,0.283672,0.00223,0.000204,0.000445
No-Assignment5538,58,29,14,43,63,18,81,8,0.233876,0.245939,0.002493,0.000521,0.000637
No_Scarcity8249,14,12,4,16,15,5,20,7,0.280903,0.2935,0.001156,0.000077,0.006602
On_my_last_spoon,10,14,7,21,22,8,30,7,0.240559,0.249602,0.000751,0.000086,0.001414
PomegranateZanzibar,11,12,5,17,24,5,29,8,0.233731,0.242085,0.000653,0.00012,0.000296
RealIsopodHours3,15,3,4,7,49,5,54,8,0.212221,0.218699,0.000037,0.000114,0.000125
SQ_Madriel,24,15,5,20,22,7,29,8,0.22371,0.231653,0.000413,0.000222,0.000286
maybebaebea,54,23,15,38,53,30,83,8,0.255457,0.269221,0.001057,0.000412,0.00107
oop_norf,34,26,14,40,42,20,62,8,0.222206,0.231856,0.002538,0.000542,0.000555
spid3rham90,25,19,9,28,31,13,44,8,0.236575,0.245344,0.000732,0.000323,0.000553
unsafeideas,55,16,12,28,33,17,50,8,0.21073,0.22094,0.000652,0.000369,0.000202
zouss,10,7,5,12,15,9,24,7,0.275102,0.288083,0.000139,0.000134,0.004323
Adventurous_Newt_668,11,3,7,10,4,8,12,8,0.204802,0.210871,0.000036,0.000115,0.000018
Individual_Ad_9213,26,16,3,19,19,3,22,9,0.194353,0.200995,0.000121,0.000271,0.000217
zealot_ratio,16,13,2,15,19,5,24,9,0.176907,0.181972,0.00006,0.000171,0.000328
Adymestic,10,3,8,11,3,10,13,8,0.251081,0.26092,0.000107,0.000073,0.000024
BuddhaFacepalmed,49,14,15,29,100,30,130,7,0.293881,0.309594,0.001151,0.000281,0.002629
Disorderly_Fashion,23,21,22,43,53,33,86,7,0.296342,0.312084,0.002132,0.000312,0.009817
Emcee_nobody,14,8,5,13,10,6,16,8,0.219972,0.227953,0.000152,0.000136,0.000627
HebiSnakeHebi,30,11,10,21,22,12,34,7,0.254767,0.264539,0.000515,0.000148,0.000658
New_General3939,30,27,10,37,36,11,47,7,0.28285,0.296376,0.001082,0.000237,0.009824
ZealousidealHeron4,13,9,9,18,16,13,29,8,0.269055,0.28154,0.000305,0.00011,0.001701
papayabush,13,6,7,13,19,10,29,8,0.238808,0.247574,0.000508,0.000117,0.000183
Aeshtrixx,11,2,2,4,4,7,11,8,0.20923,0.215325,0.000007,0.000187,0.000018
ScarletNotThatOne,129,60,17,77,93,23,116,7,0.251109,0.262884,0.004656,0.00119,0.000874
Afraid-Information88,21,0,5,5,0,9,9,7,0.22717,0.23415,0,0.000033,0
Beautiful-Produce-92,32,8,6,14,17,10,27,8,0.206558,0.211612,0.000469,0.000333,0.000067
LilpirahnaX,39,7,0,7,38,0,38,0,0,0,0,0.000175,0.000074
shestootight4you,66,29,10,39,34,11,45,7,0.260228,0.27041,0.006471,0.00034,0.001311
wozattacks,21,8,6,14,41,13,54,7,0.272208,0.285671,0.000309,0.000201,0.006852
AfricanAmericanTsar,65,28,106,134,62,247,309,6,0.349541,0.381504,0.003984,0.000508,0.009163
707theGOAT,11,4,3,7,19,12,31,8,0.246772,0.2572,0.000009,0.000121,0.004087
ARandomCanadian1984,17,5,4,9,36,15,51,7,0.273804,0.28663,0.000026,0.000184,0.004335
Aezora,17,16,7,23,33,11,44,7,0.28395,0.29796,0.000083,0.000135,0.019246
Anonymous_1q,60,34,21,55,146,43,189,7,0.316514,0.336962,0.001473,0.000522,0.022664
AnxiousChaosUnicorn,18,16,15,31,35,21,56,7,0.309231,0.329352,0.00071,0.000183,0.019651
BrownCongee,33,17,10,27,50,21,71,7,0.284449,0.299178,0.000208,0.000255,0.008302
Bunbatbop,18,14,7,21,30,11,41,7,0.283843,0.297923,0.000378,0.000218,0.007335
BurnedUp11,31,20,10,30,50,28,78,7,0.305333,0.32438,0.000466,0.000281,0.0226
CadenVanV,15,19,12,31,35,16,51,7,0.296401,0.314229,0.000228,0.000127,0.020115
Crash927,72,31,22,53,117,69,186,7,0.302417,0.321026,0.000765,0.000538,0.023242
Cyllindra,12,12,6,18,23,7,30,7,0.289319,0.306763,0.000207,0.000097,0.014777
Darkmayday,12,10,6,16,25,13,38,7,0.267119,0.281419,0.000075,0.00014,0.009383
Doub13D,227,76,48,124,396,191,587,7,0.329023,0.355018,0.004788,0.001851,0.055698
Exact-Inspector-6884,11,10,6,16,18,7,25,7,0.260812,0.273106,0.000035,0.000105,0.011226
Final-Prize2834,17,12,14,26,42,21,63,7,0.298,0.314137,0.000141,0.000212,0.011078
FineDingo3542,13,8,5,13,14,9,23,8,0.257476,0.26787,0.000196,0.00012,0.014143
First-Lengthiness-16,10,8,4,12,16,7,23,8,0.261399,0.272663,0.000287,0.000182,0.00654
GorgeousGal314,60,28,30,58,65,62,127,7,0.312906,0.331275,0.003098,0.00054,0.011066
Homey-Airport-Int,11,12,7,19,18,7,25,7,0.263115,0.275636,0.000087,0.000097,0.007969
IleGrandePagliaccio,68,32,21,53,136,70,206,7,0.299616,0.318977,0.001192,0.000612,0.025732
ImJustSaying34,10,12,8,20,23,10,33,7,0.288968,0.304793,0.000715,0.000146,0.009091
JawtisticShark,16,31,16,47,44,18,62,7,0.303695,0.32183,0.000385,0.000171,0.02862
Justame13,16,20,16,36,38,18,56,7,0.305148,0.323271,0.001485,0.000189,0.01148
Kangaroo_shampoo4U,13,3,4,7,25,11,36,7,0.26504,0.277096,0.00002,0.00014,0.007166
Km15u,57,39,23,62,108,45,153,7,0.309951,0.329891,0.001426,0.000461,0.030253
Kotoperek,39,34,28,62,58,52,110,7,0.316227,0.33786,0.000916,0.000295,0.018589
LettuceFuture8840,80,51,45,96,134,107,241,7,0.344018,0.372796,0.005473,0.000617,0.055088
Mairon12,53,28,15,43,74,31,105,7,0.29677,0.313876,0.000476,0.000441,0.015098
N7Longhorn,14,4,1,5,30,14,44,8,0.234943,0.243285,0.000001,0.000157,0.004507
NessaSamantha,18,21,10,31,39,18,57,7,0.304205,0.322042,0.000299,0.000196,0.023811
Only-Butterscotch785,18,12,10,22,42,25,67,7,0.280625,0.296516,0.000171,0.000198,0.006917
PeoplePerson_57,40,30,20,50,77,30,107,7,0.326579,0.34623,0.001137,0.000232,0.042068
Puzzleheaded_Quit925,16,17,6,23,27,12,39,7,0.292987,0.309769,0.000193,0.000124,0.014547
ReOsIr10,56,23,11,34,77,33,110,7,0.299934,0.316553,0.000305,0.000355,0.019625
RealJohnBobJoe,11,13,5,18,23,7,30,7,0.273507,0.288362,0.000064,0.000144,0.014511
Rhundan,65,49,41,90,112,67,179,7,0.322486,0.345829,0.001662,0.000476,0.029451
SilverWear5467,26,13,6,19,56,25,81,8,0.276125,0.290764,0.000109,0.000215,0.015726
Speerite,13,5,8,13,8,14,22,7,0.305848,0.32296,0.000117,0.000088,0.004645
StarChild413,46,49,62,111,118,77,195,6,0.332843,0.356701,0.006018,0.000452,0.036204
StartledMilk,28,20,14,34,46,21,67,7,0.308452,0.328015,0.000759,0.000183,0.025534
Sudden-Committee298,15,6,3,9,26,17,43,7,0.26504,0.277935,0.00001,0.000123,0.004215
SurviveDaddy,16,20,3,23,30,3,33,8,0.248956,0.259059,0.000244,0.000263,0.009539
TacticalCocoaBunny,11,8,2,10,22,2,24,8,0.243416,0.252161,0.000011,0.000104,0.010575
TemperatureThese7909,37,64,12,76,86,16,102,7,0.294378,0.310143,0.000953,0.000423,0.044554
Thoth_the_5th_of_Tho,54,44,27,71,85,37,122,7,0.315346,0.336694,0.001262,0.000416,0.03254
TurtleTurtleFTW,18,8,2,10,23,10,33,8,0.231852,0.239938,0.000011,0.000163,0.007885
Weak-Cat8743,12,34,5,39,45,8,53,7,0.279533,0.293497,0.000067,0.000146,0.038183
WindyWindona,12,12,8,20,33,12,45,7,0.286682,0.302122,0.000216,0.000186,0.008114
YouJustNeurotic,176,72,42,114,331,162,493,6,0.325476,0.350055,0.002884,0.001777,0.05725
angeldemon5,21,28,20,48,65,24,89,7,0.289467,0.306342,0.000541,0.000302,0.036717
angry_cabbie,26,21,11,32,52,25,77,7,0.299497,0.315526,0.000506,0.000281,0.017247
apri08101989,24,16,7,23,32,11,43,7,0.261278,0.271926,0.000457,0.000161,0.016373
badass_panda,56,29,17,46,113,46,159,7,0.293481,0.309905,0.000527,0.000487,0.017434
colt707,24,31,18,49,44,23,67,7,0.303858,0.322532,0.001778,0.000214,0.02014
flanneur,17,6,4,10,28,8,36,8,0.248587,0.258631,0.00005,0.000171,0.00428
joepierson123,21,24,8,32,41,9,50,7,0.293538,0.309638,0.000315,0.000167,0.018333
lobonmc,29,32,13,45,60,20,80,7,0.289726,0.307302,0.000318,0.000318,0.026306
poorestprince,27,23,8,31,48,24,72,7,0.283843,0.300584,0.000133,0.000213,0.022346
rightful_vagabond,46,49,33,82,116,50,166,7,0.319822,0.342826,0.001531,0.000557,0.037051
saintsithney,36,16,11,27,45,25,70,7,0.27316,0.286708,0.000409,0.000313,0.015219
scorpiomover,19,34,16,50,50,17,67,7,0.284717,0.301142,0.000803,0.000168,0.034121
themcos,51,57,34,91,111,46,157,6,0.33496,0.360219,0.002557,0.000504,0.042331
tigerzzzaoe,38,28,19,47,59,34,93,7,0.307384,0.327026,0.000434,0.000274,0.021375
timeless1991,26,35,14,49,62,19,81,7,0.290079,0.30772,0.000898,0.000425,0.01272
veggiesama,11,12,5,17,19,7,26,7,0.297823,0.313867,0.000129,0.000089,0.010847
AgUnityDD,20,8,47,55,9,111,120,7,0.312001,0.333996,0.00038,0.000112,0.002732
10thAmdAbsolutist,100,41,40,81,240,102,342,7,0.319867,0.344188,0.001886,0.00077,0.02935
AleristheSeeker,64,21,12,33,79,38,117,7,0.30111,0.319477,0.000174,0.000359,0.015235
Aslamtum,18,9,3,12,24,13,37,8,0.218318,0.224639,0.000131,0.000233,0.002214
BrooklynSmash,10,17,8,25,25,9,34,7,0.275906,0.288374,0.000163,0.000112,0.015498
ConversationAbject99,19,8,3,11,28,3,31,8,0.243246,0.252543,0.000015,0.000091,0.00389
Dare_Ask_67,27,14,24,38,18,76,94,7,0.312496,0.334015,0.0003,0.000163,0.00849
DigglerD,24,17,12,29,62,28,90,7,0.297023,0.31348,0.000432,0.000374,0.012146
Eat--The--Rich--,18,26,11,37,33,11,44,7,0.286501,0.302139,0.000418,0.000166,0.021517
Falsequivalence,13,7,3,10,25,11,36,7,0.285058,0.302046,0.00005,0.000132,0.011536
Flashy-Pizza-229,16,6,4,10,33,14,47,8,0.254925,0.26623,0.000014,0.000137,0.003685
Flor1daman08,130,40,40,80,204,135,339,7,0.326179,0.351894,0.003825,0.000896,0.048309
Kerostasis,66,66,41,107,122,59,181,7,0.346811,0.375541,0.005601,0.000528,0.056492
MaxwellKillMill,15,6,3,9,36,16,52,8,0.245861,0.257079,0.000027,0.000147,0.011744
Middle_Ad8183,22,15,14,29,42,24,66,7,0.287683,0.303184,0.000509,0.000214,0.017583
Ok_Artichoke_2928,19,8,3,11,24,8,32,7,0.26549,0.277157,0.000051,0.000123,0.010425
P4ULUS,36,23,7,30,52,10,62,7,0.273276,0.285941,0.000347,0.000253,0.015005
Qubit_Or_Not_To_Bit_,20,26,16,42,46,20,66,7,0.305045,0.32459,0.000811,0.000212,0.026952
RegressToTheMean,28,24,11,35,46,18,64,7,0.280572,0.296577,0.000648,0.000346,0.01452
Rusty-Shackleford000,56,22,16,38,112,41,153,7,0.30797,0.326371,0.000737,0.000444,0.020519
ScalesOfAnubis19,95,34,25,59,205,91,296,7,0.300272,0.317208,0.000942,0.000914,0.02284
Severe-Illustrator87,10,5,1,6,21,5,26,8,0.229015,0.23629,0.000001,0.000095,0.005085
Significant-Owl-2980,15,12,8,20,23,11,34,7,0.263928,0.273583,0.000241,0.000116,0.015666
SmartYouth9886,22,21,11,32,43,23,66,7,0.295781,0.312367,0.000643,0.000207,0.02173
Socialimbad1991,24,26,24,50,62,28,90,7,0.300631,0.321424,0.001182,0.000199,0.032629
Suspicious-Word-7589,13,12,9,21,24,11,35,7,0.257169,0.269692,0.00012,0.000089,0.013229
Utterlybored,15,20,8,28,21,10,31,8,0.244125,0.259368,0.000119,0.000151,0.02032
crashfrog05,46,22,11,33,79,38,117,7,0.288306,0.305156,0.000487,0.000398,0.014915
dirtysyncs,12,4,2,6,30,13,43,8,0.260093,0.271675,0.000003,0.000216,0.003022
dukeimre,36,23,15,38,61,26,87,7,0.315083,0.336217,0.000775,0.000186,0.024248
elCharderino,12,9,17,26,20,31,51,7,0.291986,0.305202,0.000791,0.000148,0.006126
mapadofu,15,13,4,17,26,13,39,7,0.272569,0.284943,0.000052,0.000157,0.00948
ryan_770,16,7,8,15,16,15,31,7,0.269247,0.283201,0.000067,0.000137,0.00391
Aggravating_Area6242,50,12,84,96,44,377,421,6,0.335606,0.365103,0.001807,0.000331,0.004147
-C4-,12,5,4,9,23,7,30,7,0.273095,0.286912,0.000013,0.000077,0.006014
33ITM420,55,31,7,38,99,33,132,7,0.28331,0.300697,0.000209,0.000376,0.033709
90daysismytherapy,22,7,6,13,37,13,50,7,0.287537,0.302001,0.000033,0.000128,0.007126
A_SNAPPIN_Turla,11,9,4,13,19,8,27,7,0.258019,0.270007,0.000039,0.000132,0.005968
According_Smell_6421,29,5,3,8,42,22,64,7,0.266459,0.279402,0.000011,0.000111,0.004431
Affectionate-Web3630,14,4,4,8,33,14,47,8,0.24165,0.251156,0.000005,0.000161,0.001644
BitcoinMD,16,25,7,32,37,8,45,7,0.297393,0.311381,0.000279,0.000178,0.025147
CgradeCheese,15,3,4,7,27,13,40,7,0.26563,0.27795,0.000013,0.00009,0.00161
Cheeseisgood1981,11,4,3,7,24,12,36,7,0.241843,0.251958,0.000004,0.000141,0.003235
DaveChild,32,18,17,35,63,33,96,7,0.299874,0.31738,0.000486,0.000203,0.023227
DonkeyDoug28,16,19,12,31,44,16,60,7,0.297237,0.315595,0.000267,0.000174,0.022481
Electronic-Chest7630,18,4,2,6,39,6,45,8,0.247689,0.257968,0.000005,0.00012,0.001517
ExtremeAd7729,12,8,4,12,26,12,38,8,0.230237,0.239163,0.000039,0.000163,0.00775
Forsaken-House8685,106,62,22,84,279,81,360,7,0.321913,0.345472,0.00294,0.001258,0.040974
Freedom_Crim,20,10,6,16,45,23,68,7,0.264653,0.277502,0.000038,0.000196,0.012469
GamemasterJeff,10,7,5,12,16,6,22,7,0.282621,0.295599,0.000202,0.000075,0.00791
Gatonom,82,39,28,67,174,96,270,7,0.310397,0.330285,0.001807,0.00079,0.03772
Greedy-Win-4880,26,9,8,17,18,13,31,7,0.290563,0.305717,0.000875,0.000155,0.005608
Gurpila9987,20,19,12,31,39,16,55,7,0.268337,0.284076,0.000425,0.000196,0.020792
Horselady234,21,21,16,37,43,20,63,7,0.287629,0.303346,0.000289,0.000171,0.030286
IslandSoft6212,11,19,10,29,34,13,47,7,0.292741,0.310868,0.000202,0.000117,0.0198
JohnLockeNJ,10,6,3,9,15,3,18,7,0.271996,0.285725,0.000018,0.000055,0.011728
JosephJohnPEEPS,21,28,11,39,46,16,62,7,0.274269,0.288034,0.000317,0.000263,0.026916
Jumpy_Childhood7548,29,16,2,18,47,2,49,7,0.292855,0.308108,0.0003,0.000083,0.023998
JustAGuyFromGermany,12,9,3,12,14,3,17,7,0.258785,0.271937,0.000032,0.000107,0.004474
KeySpecialist9139,15,11,4,15,35,8,43,7,0.277376,0.294002,0.000142,0.000199,0.009163
LivingGhost371,12,21,5,26,27,5,32,7,0.276817,0.289816,0.000098,0.000182,0.016021
Lumpy-Butterscotch50,122,57,35,92,214,96,310,7,0.318764,0.341472,0.002199,0.000951,0.04557
MissMenace101,35,14,24,38,22,32,54,8,0.279068,0.295989,0.001059,0.000223,0.003553
NoVacancyHI,29,19,9,28,47,21,68,7,0.28113,0.298008,0.000369,0.000245,0.01937
No_Material7583,71,17,9,26,152,67,219,7,0.27787,0.293805,0.000305,0.000691,0.011907
PassionV0id,15,12,9,21,39,20,59,7,0.293976,0.311047,0.000301,0.000198,0.016382
PineBNorth85,11,19,9,28,28,11,39,8,0.281147,0.297303,0.000259,0.000135,0.017071
ProbablyANoobYo,12,11,9,20,22,13,35,7,0.307886,0.326373,0.000143,0.000076,0.017794
Rufus_TBarleysheath,59,16,15,31,115,61,176,7,0.290302,0.305363,0.000218,0.000555,0.011764
SWnerd92,16,15,10,25,40,19,59,7,0.286863,0.302378,0.000214,0.000215,0.012155
SpecialistBet4656,19,13,17,30,59,36,95,7,0.299299,0.31636,0.000301,0.000215,0.014207
UnavailableBrain404,17,11,5,16,29,13,42,7,0.280277,0.292821,0.000291,0.00023,0.007022
Vegtam1297,128,81,53,134,284,145,429,7,0.341296,0.368376,0.005244,0.001054,0.070341
VisiblePiercedNipple,15,8,3,11,15,8,23,8,0.250581,0.261249,0.000049,0.000106,0.002564
WangSupreme78,19,12,5,17,23,9,32,7,0.272667,0.285989,0.000089,0.000133,0.00705
Wattabadmon,51,19,20,39,97,62,159,7,0.319213,0.338692,0.001331,0.000342,0.018577
Wolf_Protagonist,10,8,7,15,19,11,30,7,0.299379,0.317204,0.000157,0.000122,0.011618
Working-Exam5620,27,5,4,9,44,15,59,8,0.249381,0.25963,0.000031,0.000186,0.002096
YogurtclosetOwn4786,10,13,5,18,27,6,33,8,0.267656,0.283784,0.000101,0.000116,0.015117
abacuz4,68,37,26,63,90,47,137,7,0.315324,0.33773,0.001604,0.000419,0.032085
betterworldbuilder,28,23,20,43,44,32,76,7,0.305745,0.325122,0.000613,0.000172,0.023833
cctoot56,20,8,8,16,42,22,64,8,0.258697,0.270953,0.000114,0.000232,0.00711
chemguy216,12,11,9,20,31,14,45,7,0.268847,0.28305,0.000062,0.000135,0.008677
climbstuff32,15,21,7,28,31,10,41,7,0.278023,0.292708,0.000248,0.000159,0.025036
comment_i_had_to,14,19,5,24,31,9,40,7,0.287173,0.302656,0.000215,0.000184,0.02355
cuteman,17,12,10,22,22,13,35,7,0.272979,0.28755,0.000177,0.000127,0.00646
decrpt,40,30,26,56,91,52,143,7,0.31989,0.339407,0.001185,0.000406,0.028738
diamondmx,16,13,12,25,34,19,53,7,0.297023,0.314973,0.000809,0.000157,0.012039
discourse_friendly,145,78,56,134,206,124,330,7,0.327856,0.354737,0.006132,0.001061,0.068839
dontgiveahamyamclam,14,8,7,15,40,18,58,7,0.273408,0.287171,0.000044,0.000207,0.004021
eggynack,196,78,48,126,336,133,469,6,0.333874,0.362258,0.005936,0.001406,0.057217
jeffwhaley06,27,28,25,53,72,45,117,7,0.295357,0.312604,0.000855,0.000274,0.023161
nauticalsandwich,40,40,24,64,84,33,117,7,0.305394,0.325131,0.000947,0.000326,0.034263
neotericnewt,30,21,15,36,65,25,90,7,0.302862,0.319238,0.000527,0.000216,0.024983
oremfrien,30,24,21,45,63,28,91,7,0.299993,0.318958,0.00062,0.000256,0.017658
rndljfry,19,17,13,30,43,23,66,7,0.295145,0.309591,0.000532,0.0002,0.018155
theroha,19,24,13,37,40,15,55,7,0.274169,0.28862,0.001246,0.000246,0.016109
thinsoldier,21,25,12,37,52,18,70,7,0.287154,0.302403,0.000443,0.00025,0.034001
vf-guy,12,9,3,12,34,7,41,7,0.274935,0.288919,0.000033,0.000162,0.004133
xinorez1,10,11,11,22,24,11,35,7,0.275002,0.28861,0.00014,0.000091,0.016096
Agitated-Ad6744,11,2,6,8,3,7,10,8,0.245036,0.259515,0.000555,0.000077,0.000159
Hapankaali,41,20,13,33,55,31,86,8,0.254153,0.26704,0.000279,0.000322,0.023351
RKU69,42,25,24,49,59,30,89,7,0.281952,0.30208,0.000738,0.000311,0.024445
Agitated-Annual-3527,32,4,26,30,5,49,54,7,0.275604,0.29046,0.001213,0.000133,0.003249
Craig1974,10,4,3,7,9,4,13,8,0.200372,0.205558,0.000033,0.00006,0.000417
Creampied__Cadaver,16,10,2,12,11,2,13,9,0.200159,0.205378,0.000061,0.000129,0.000774
DiarrheaJoe1984,10,5,2,7,8,3,11,8,0.225234,0.233003,0.000034,0.00008,0.000304
InfidelZombie,32,24,14,38,41,18,59,7,0.273606,0.285799,0.000955,0.000307,0.013106
MinivanPops,30,15,9,24,27,15,42,8,0.222654,0.229875,0.000562,0.000374,0.001095
MrRoryBreaker_98,11,9,4,13,16,9,25,8,0.252932,0.261401,0.00009,0.000126,0.001585
Nojopar,28,18,16,34,58,29,87,7,0.299795,0.316055,0.000693,0.000262,0.015528
Ok_Ruin4016,26,20,12,32,31,16,47,7,0.284431,0.298275,0.001356,0.000233,0.011014
OldBanjoFrog,22,25,7,32,37,9,46,8,0.244164,0.254563,0.000565,0.000251,0.002304
Prestigious_Fella_21,24,3,5,8,15,15,30,8,0.228196,0.236975,0.000037,0.000175,0.000111
Single_Temporary8762,23,4,8,12,6,8,14,7,0.261716,0.271539,0.000235,0.00009,0.000219
SlartibartfastMcGee,14,7,3,10,20,3,23,8,0.230413,0.237941,0.000032,0.000115,0.000493
WindBehindTheStars,28,16,9,25,26,12,38,7,0.276665,0.289627,0.001218,0.000247,0.001967
fasterthanfood,26,14,11,25,24,13,37,8,0.266333,0.277462,0.000867,0.000167,0.002232
ltsmash1200,34,26,10,36,37,14,51,8,0.253442,0.263281,0.001957,0.000312,0.004408
mrsunshine1,11,9,4,13,14,5,19,7,0.272914,0.284734,0.000311,0.000114,0.001875
notadruggie31,56,29,25,54,62,49,111,7,0.283381,0.299323,0.002322,0.000465,0.003323
pinniped90,39,25,10,35,38,12,50,7,0.261475,0.272169,0.000821,0.000283,0.002339
stringbeagle,12,22,7,29,25,10,35,7,0.27013,0.282857,0.001631,0.000309,0.005276
Agouramemnon,18,4,18,22,12,33,45,7,0.281287,0.2955,0.000247,0.000189,0.00017
AnotherUN91,16,11,5,16,12,6,18,8,0.264174,0.274518,0.000512,0.000173,0.001375
Bruce-7892,58,24,25,49,51,39,90,7,0.290227,0.306402,0.002944,0.000539,0.002694
Coolthat6,23,14,47,61,31,106,137,7,0.331771,0.357377,0.001413,0.000239,0.014775
CrossXFir3,35,16,10,26,27,14,41,8,0.243325,0.253888,0.000394,0.00021,0.002426
DRamos11,12,12,6,18,15,9,24,8,0.243967,0.252679,0.000194,0.000187,0.000813
Opposite-Hat-4747,10,13,6,19,21,8,29,7,0.293709,0.310713,0.000289,0.000167,0.009652
TheGrumpyBear04,41,33,12,45,51,12,63,8,0.245102,0.256059,0.000845,0.000372,0.003091
TheUnderCrab,28,15,10,25,57,25,82,7,0.298255,0.317864,0.000263,0.00022,0.009786
Thin_Vermicelli_1875,21,16,8,24,24,9,33,8,0.262277,0.273605,0.000787,0.000286,0.001587
UnofficialMipha,14,10,5,15,17,7,24,8,0.23778,0.245148,0.00013,0.000156,0.001415
Weary-Technician5861,16,17,16,33,21,18,39,7,0.297237,0.31316,0.001196,0.000157,0.010997
Xeadriel,13,6,1,7,18,1,19,9,0.208134,0.213929,0.000005,0.000075,0.000467
donuttrackme,31,19,14,33,45,28,73,7,0.257256,0.268896,0.000732,0.000292,0.001575
Agreeable_Car5114,51,11,17,28,27,43,70,7,0.313036,0.329223,0.002267,0.000256,0.011913
Baron-Von-Mothman,10,5,2,7,8,4,12,8,0.234493,0.24328,0.000033,0.000059,0.001254
FlameStaag,38,38,8,46,48,8,56,8,0.254452,0.26344,0.000895,0.000354,0.003282
JidderS2,17,9,5,14,17,12,29,8,0.243927,0.25323,0.000123,0.000201,0.002053
Lower-Insect-3984,36,7,36,43,13,125,138,7,0.284968,0.300941,0.00089,0.00016,0.00028
OutisRising,11,6,3,9,22,6,28,8,0.230895,0.239194,0.000333,0.000089,0.000768
RazgrizInfinity,14,3,2,5,22,9,31,8,0.245328,0.252561,0.000005,0.000169,0.000383
Redacted_dact,10,12,1,13,20,2,22,7,0.268783,0.279281,0.000048,0.000086,0.00249
Valkrhae,19,8,5,13,12,9,21,7,0.256209,0.265166,0.000752,0.000141,0.000488
nykirnsu,21,10,10,20,63,18,81,7,0.291761,0.305116,0.000488,0.000223,0.003991
sonicpieman,13,4,2,6,8,5,13,8,0.235591,0.242805,0.000022,0.000102,0.000276
thelingeringlead,30,12,11,23,54,19,73,7,0.268147,0.280119,0.000597,0.000258,0.014095
AintASaintLouis,20,10,20,30,15,46,61,7,0.306241,0.322942,0.000223,0.000168,0.002922
Cultist_O,35,15,12,27,42,29,71,7,0.280208,0.294288,0.000124,0.000263,0.005923
Demi4TheDrama,11,6,27,33,9,95,104,7,0.32571,0.345568,0.000284,0.000105,0.003651
EdenSire0,21,12,5,17,31,6,37,7,0.283843,0.299594,0.000054,0.00007,0.01393
NeoConzz,17,5,45,50,10,384,394,6,0.332306,0.354195,0.000247,0.000082,0.005137
PaxNova,23,29,15,44,36,20,56,7,0.298727,0.315066,0.001115,0.000236,0.016389
PepperJack0526,12,7,4,11,21,10,31,7,0.276327,0.289207,0.000028,0.000128,0.009713
dejamintwo,43,23,45,68,45,132,177,7,0.340936,0.365333,0.001713,0.000254,0.010951
delimeats_9678,21,16,13,29,40,23,63,7,0.287793,0.302574,0.000775,0.000209,0.010092
le_fez,15,19,6,25,31,8,39,7,0.308011,0.325022,0.000409,0.00015,0.016127
AlexJRod,12,1,60,61,1,268,269,7,0.308158,0.326329,0.000427,0.000045,0.000009
7h4tguy,14,19,6,25,34,8,42,7,0.257154,0.266983,0.000514,0.000234,0.001432
ANewBeginningNow,11,19,2,21,21,2,23,8,0.2554,0.270514,0.000251,0.000157,0.023427
BartholomewVonTurds,38,12,9,21,49,11,60,8,0.24292,0.252184,0.00036,0.000186,0.000729
Bex1218,14,7,3,10,23,5,28,8,0.220411,0.227035,0.000034,0.000095,0.000599
BillyJayJersey505,18,10,3,13,15,3,18,7,0.29609,0.311147,0.000448,0.000099,0.006044
Cold-Fox9854,11,5,1,6,16,1,17,9,0.179936,0.183821,0.000007,0.000082,0.000572
Comprehensive-Menu44,15,9,5,14,11,7,18,7,0.276108,0.287794,0.000561,0.000132,0.001654
Decent_Flow140,15,8,6,14,28,7,35,7,0.266239,0.276835,0.000912,0.000093,0.001276
DizzyAstronaut9410,14,9,3,12,22,5,27,7,0.255428,0.267128,0.000028,0.000131,0.008514
DogsOnMyCouches,16,11,4,15,26,8,34,8,0.25011,0.25933,0.001467,0.000218,0.005588
DrCrazyFishMan1,13,5,3,8,9,6,15,9,0.18972,0.194009,0.000022,0.000159,0.000225
Exciting_Stock2202,12,9,4,13,11,4,15,8,0.237568,0.246249,0.000051,0.000072,0.007226
Fast-Penta,11,4,1,5,14,1,15,8,0.212849,0.219087,0.000008,0.000066,0.000281
FrequentAirline1554,30,10,22,32,14,45,59,7,0.283364,0.296493,0.000762,0.000104,0.004344
GalaXion24,30,33,17,50,67,27,94,7,0.299557,0.319063,0.000853,0.000258,0.036286
GreyerGrey,28,20,17,37,49,21,70,7,0.294282,0.30794,0.002386,0.000195,0.009528
Guardian-Boy,10,4,3,7,21,3,24,8,0.217302,0.223188,0.000116,0.000082,0.000315
Gullible_Papaya5505,26,13,5,18,31,14,45,7,0.274202,0.286346,0.000775,0.000378,0.002095
KendroNumba4,14,12,6,18,25,7,32,8,0.258151,0.268351,0.000576,0.000193,0.003335
MT_Ancap75,10,9,5,14,25,9,34,8,0.242582,0.251229,0.000129,0.000113,0.001237
Many-Cartographer278,15,7,1,8,13,3,16,9,0.196973,0.201321,0.000027,0.000121,0.001798
Mortwight,10,1,2,3,1,2,3,9,0.19059,0.19486,0.000001,0.000033,0.000182
NefariousnessBig9037,15,12,5,17,21,7,28,8,0.234894,0.242439,0.000118,0.0002,0.000782
Nice_Put4300,12,7,4,11,26,5,31,8,0.239934,0.248611,0.00009,0.000117,0.000909
No-Stretch-9230,24,7,3,10,20,16,36,8,0.244204,0.253073,0.000042,0.000113,0.001047
Ok_Possession_6457,11,21,5,26,28,5,33,8,0.258239,0.26854,0.000312,0.000171,0.003338
PaleBoomer,16,3,2,5,14,8,22,8,0.209598,0.214702,0.000221,0.000066,0.000416
PomPomMom93,18,11,6,17,78,14,92,9,0.221337,0.229311,0.000057,0.000159,0.001468
Racing_Fox,25,6,4,10,28,23,51,8,0.230906,0.239722,0.000082,0.000297,0.000303
Redwings1927,13,7,3,10,18,10,28,8,0.254238,0.264437,0.000126,0.000127,0.00415
RepulsiveCockroach7,10,3,1,4,14,1,15,9,0.190984,0.195459,0.000005,0.000059,0.000279
ScoobyDone,18,9,4,13,24,12,36,8,0.241199,0.249762,0.000085,0.000223,0.000736
Stinky_Toes12,10,5,1,6,9,2,11,8,0.211873,0.216876,0.000002,0.000118,0.000592
Temporary-Comfort307,14,6,5,11,11,9,20,7,0.250928,0.26041,0.000076,0.000158,0.000729
TheBitchenRav,42,21,21,42,59,50,109,7,0.325172,0.344824,0.001187,0.000382,0.016823
Yota8883,10,6,3,9,18,3,21,8,0.215042,0.221077,0.000011,0.000114,0.001107
Yuck_Few,28,16,8,24,34,12,46,8,0.2496,0.259468,0.000467,0.000414,0.000864
Zestyclose-Coyote906,13,4,2,6,7,2,9,8,0.241148,0.25005,0.000019,0.000055,0.000493
broken_soul696,12,6,4,10,13,4,17,8,0.241135,0.248577,0.000077,0.000079,0.000732
glasgowgeg,10,3,2,5,11,10,21,8,0.2496,0.258461,0.000035,0.000105,0.000603
hansislegend,14,5,3,8,27,10,37,8,0.21333,0.218753,0.000049,0.000191,0.000489
jackfaire,27,21,14,35,26,17,43,7,0.267972,0.2795,0.00054,0.000184,0.002354
jstnpotthoff,13,10,6,16,15,7,22,8,0.244375,0.252883,0.000169,0.000131,0.002098
laylarei_1,12,5,3,8,16,9,25,8,0.231012,0.238329,0.000019,0.000104,0.000472
numbersthen0987431,48,51,30,81,92,41,133,7,0.339964,0.358646,0.013294,0.000372,0.034687
rolyfuckingdiscopoly,11,17,7,24,25,10,35,7,0.291892,0.307057,0.001208,0.00013,0.015764
thingstopraise,12,5,1,6,19,1,20,9,0.188136,0.191697,0.000007,0.000104,0.000537
tvieno,12,14,1,15,14,1,15,8,0.216078,0.222533,0.000071,0.000082,0.00141
vorzilla79,82,19,17,36,76,42,118,8,0.262825,0.275737,0.001329,0.000528,0.001777
AlexZedKawa02,162,74,259,333,141,1152,1293,6,0.387293,0.432469,0.020883,0.001113,0.02512
Abaris_Of_Hyperborea,12,4,3,7,23,12,35,8,0.246825,0.256268,0.000011,0.00017,0.008867
Abracadelphon,12,14,8,22,24,16,40,7,0.291479,0.309117,0.000205,0.0001,0.020054
Aggravating_Lab_1432,34,29,11,40,64,31,95,7,0.277122,0.29132,0.000781,0.00082,0.014327
Aggressive-Story3671,75,45,28,73,157,50,207,7,0.312431,0.330835,0.001648,0.00069,0.030418
Alesus2-0,26,31,9,40,42,13,55,7,0.283151,0.297438,0.000333,0.000208,0.02225
Allenobriann,22,9,5,14,39,14,53,8,0.246248,0.255694,0.000036,0.000183,0.010958
AmbitiousCattle3879,11,8,5,13,19,9,28,8,0.23665,0.245369,0.000144,0.000192,0.009967
Appropriate_Cut_3536,12,5,9,14,15,14,29,7,0.277376,0.291754,0.000067,0.000083,0.006194
Appropriate_Fly_6711,12,12,1,13,19,5,24,8,0.229398,0.236874,0.000004,0.000088,0.024092
Available_Year_575,16,9,6,15,31,9,40,7,0.289171,0.304783,0.000075,0.000138,0.012512
AzMoonbeamer,11,12,4,16,25,7,32,7,0.282515,0.297825,0.000083,0.000117,0.024676
Bananaseverywh4r,12,18,10,28,33,11,44,8,0.281217,0.296497,0.000355,0.000181,0.018429
Bastiat_sea,28,35,15,50,49,23,72,7,0.297961,0.315155,0.001825,0.000283,0.024783
BillionaireBuster93,45,51,45,96,126,60,186,7,0.325032,0.348499,0.002809,0.000349,0.065282
BlueStarSpecial,11,10,3,13,24,8,32,7,0.245781,0.255049,0.000025,0.000146,0.016494
Bud_Buffalo,35,12,5,17,54,5,59,7,0.281304,0.293316,0.001657,0.000359,0.008731
Calaveras-Metal,11,26,9,35,36,12,48,7,0.308662,0.326984,0.000475,0.000112,0.040183
Cerael,15,5,3,8,19,8,27,7,0.282603,0.298259,0.000045,0.000081,0.007163
Character_Resort72,27,27,15,42,55,22,77,7,0.300093,0.316456,0.001549,0.000445,0.018508
Cheshire_Khajiit,25,25,10,35,58,21,79,7,0.301411,0.318618,0.000671,0.000278,0.024624
CleverJames3,13,8,5,13,22,12,34,7,0.265724,0.278663,0.000027,0.000127,0.010931
Competitive_Jello531,25,31,11,42,52,16,68,7,0.302579,0.321904,0.00041,0.000201,0.040839
Counterboudd,28,13,5,18,40,9,49,8,0.246947,0.25641,0.000071,0.00016,0.014795
CrazyCoKids,21,12,43,55,30,97,127,7,0.339429,0.362757,0.000959,0.0001,0.015029
CreativeCraver,10,7,3,10,18,5,23,8,0.257169,0.267542,0.000046,0.00009,0.013098
Credible333,12,11,5,16,17,5,22,7,0.272159,0.28522,0.000061,0.000089,0.011348
DBDude,136,56,35,91,236,74,310,7,0.320751,0.346094,0.003315,0.000816,0.051986
DJ_HouseShoes,11,23,3,26,26,4,30,8,0.227097,0.233882,0.00045,0.000297,0.014651
Dependent-Mode-3119,42,22,17,39,89,34,123,7,0.308242,0.328141,0.000544,0.000297,0.019571
Destroyer_2_2,77,28,19,47,125,60,185,7,0.324962,0.347698,0.001534,0.00061,0.024038
Doc_ET,16,26,13,39,35,13,48,7,0.288637,0.303158,0.000421,0.000159,0.021229
DrawPitiful6103,14,15,5,20,30,9,39,7,0.268895,0.282138,0.000069,0.00012,0.017148
Dregride,28,15,13,28,56,31,87,7,0.296304,0.314184,0.000411,0.000351,0.013102
DuhChappers,10,5,8,13,25,10,35,7,0.304001,0.321258,0.000024,0.000061,0.007981
Dunadan734,11,16,7,23,29,8,37,7,0.28461,0.301116,0.00015,0.000098,0.020094
ElOsoPeresozo,15,14,10,24,35,16,51,8,0.262871,0.275102,0.000132,0.00017,0.011587
ElephantLife8552,12,4,7,11,12,11,23,7,0.294416,0.311273,0.000103,0.000111,0.004254
ElysiX,28,28,16,44,53,31,84,7,0.295762,0.312667,0.000845,0.000287,0.019114
Expert-Diver7144,77,43,35,78,149,64,213,7,0.332428,0.356209,0.00231,0.000568,0.030021
FairDinkumMate,14,8,84,92,13,310,323,7,0.328188,0.353763,0.000752,0.000118,0.006243
Finklesfudge,26,26,12,38,60,27,87,7,0.294167,0.314539,0.000443,0.000304,0.019978
Fit-Order-9468,67,41,27,68,129,57,186,7,0.307886,0.328337,0.00116,0.000482,0.042787
FlanneryODostoevsky,112,42,81,123,145,303,448,7,0.343731,0.371107,0.006706,0.000872,0.025595
FluffyB12,36,30,38,68,63,82,145,7,0.320478,0.343698,0.001515,0.000262,0.033966
Former_Function529,34,43,20,63,95,30,125,7,0.31517,0.336149,0.00155,0.000347,0.044672
Foxhound97_,22,17,9,26,29,13,42,7,0.300431,0.317608,0.000386,0.000105,0.018275
French_Breakfast_200,11,4,3,7,8,6,14,7,0.286066,0.300406,0.000271,0.000076,0.004274
FrontAd9873,37,7,7,14,67,17,84,7,0.294569,0.309173,0.000806,0.000248,0.004663
Funny-Attempt3260,17,11,4,15,31,9,40,7,0.266239,0.279056,0.000129,0.000175,0.007899
Galious,36,13,7,20,42,31,73,7,0.27316,0.286794,0.000117,0.000211,0.010154
GasPsychological5997,12,10,4,14,24,9,33,7,0.263759,0.277002,0.000034,0.000114,0.01595
Grand-Expression-783,16,25,3,28,29,5,34,7,0.257227,0.266335,0.000087,0.000143,0.034078
Green__lightning,52,58,19,77,106,35,141,7,0.340296,0.364277,0.002611,0.000538,0.05078
HogCrankrr,10,5,3,8,22,10,32,7,0.282005,0.297028,0.000022,0.000155,0.007386
HoldFastO2,38,23,20,43,81,35,116,7,0.3094,0.326472,0.003649,0.000358,0.015905
Hothera,24,18,12,30,39,17,56,7,0.3027,0.321394,0.000349,0.000128,0.026812
Ill-Description3096,83,43,25,68,113,57,170,7,0.312259,0.335178,0.002692,0.000491,0.039732
Illustrious_Comb5993,23,20,5,25,43,13,56,7,0.291217,0.307708,0.000234,0.00017,0.020667
Impossible-anarchy,47,29,15,44,89,31,120,7,0.294301,0.313775,0.000476,0.000377,0.021528
Impressive-Reading15,23,17,13,30,59,29,88,7,0.296614,0.312694,0.000499,0.000259,0.022121
IndependenceIcy9626,22,18,12,30,40,22,62,7,0.297667,0.314723,0.000526,0.000291,0.016157
Ionrememberaskn,18,21,10,31,45,17,62,7,0.297217,0.314377,0.000195,0.000189,0.021831
JDMultralight,17,18,10,28,43,13,56,7,0.285112,0.301683,0.000223,0.000163,0.021912
Johnnadawearsglasses,17,29,7,36,39,11,50,7,0.295472,0.312051,0.000506,0.000178,0.025921
Josvan135,65,65,20,85,132,44,176,7,0.314056,0.3352,0.003027,0.000827,0.032122
KJongsDongUnYourFace,23,11,6,17,40,24,64,7,0.268179,0.282571,0.000112,0.000245,0.008999
KindaQuite,11,8,5,13,20,9,29,7,0.27149,0.286252,0.000109,0.00011,0.007765
Knave7575,10,15,3,18,23,4,27,8,0.265304,0.27704,0.000028,0.000111,0.016016
Known_Safety_7145,11,8,5,13,22,11,33,7,0.285345,0.301274,0.000035,0.000106,0.011225
LanaDelHeeey,50,29,17,46,83,37,120,7,0.312733,0.333291,0.001271,0.000371,0.029728
Loki1001,16,16,10,26,37,17,54,7,0.295839,0.310525,0.00024,0.000181,0.020764
LordJesterTheFree,14,9,7,16,20,7,27,7,0.277682,0.29282,0.000128,0.000076,0.014734
Low-Company-6450,13,9,6,15,24,8,32,7,0.274119,0.288636,0.000074,0.000076,0.016446
LowHelicopter7180,26,20,32,52,32,57,89,7,0.313904,0.336219,0.001008,0.000287,0.010207
ManufacturerSea7907,32,15,12,27,60,17,77,7,0.304123,0.322256,0.000271,0.000261,0.009274
Mental-Cupcake9750,19,16,4,20,36,13,49,7,0.263115,0.276604,0.000072,0.000136,0.021334
Miriam_A_Higgins,27,8,15,23,27,52,79,7,0.298216,0.315072,0.000138,0.000211,0.006892
Mrs_Crii,48,43,24,67,104,41,145,7,0.297491,0.314541,0.001529,0.000539,0.03115
NOLA-Bronco,12,14,7,21,29,9,38,7,0.28052,0.294956,0.000311,0.000165,0.017755
Natural-Arugula,23,28,12,40,48,16,64,7,0.319461,0.339499,0.000337,0.000171,0.039348
NewRefrigerator7461,13,12,5,17,33,14,47,7,0.28436,0.299538,0.000086,0.000169,0.01338
No_Radio5740,17,19,8,27,40,9,49,7,0.283896,0.299223,0.000185,0.000198,0.020078
Noob_Al3rt,83,41,29,70,177,75,252,7,0.312431,0.334397,0.001974,0.000626,0.030657
OrizaRayne,11,5,3,8,17,6,23,7,0.284753,0.30022,0.000014,0.000087,0.00756
Parzival_1775,26,27,30,57,43,41,84,7,0.327405,0.352287,0.000963,0.000273,0.028244
Plastic-Abroc67a8282,87,27,27,54,110,105,215,7,0.313991,0.3357,0.000847,0.000661,0.013345
PlasticMechanic3869,12,15,12,27,33,15,48,7,0.299478,0.316421,0.000217,0.000156,0.017452
Polyodontus,108,37,34,71,131,89,220,7,0.309591,0.333463,0.002138,0.000751,0.034134
Popular_Kangaroo5446,21,9,6,15,42,13,55,7,0.287994,0.304833,0.000176,0.0002,0.008142
PreviousCurrentThing,47,44,34,78,82,48,130,7,0.333899,0.358429,0.003137,0.000326,0.048107
Puzzleheaded_Ant3378,23,6,2,8,9,2,11,7,0.279775,0.294719,0.000245,0.000059,0.010371
Quankers,18,13,6,19,40,18,58,7,0.269119,0.282576,0.000122,0.000208,0.013126
RadioSlayer,12,7,7,14,23,13,36,7,0.296439,0.313527,0.000034,0.000109,0.012207
Rhomya,26,9,7,16,35,24,59,7,0.30486,0.32089,0.000655,0.000237,0.008147
Salanmander,13,9,5,14,15,6,21,7,0.272536,0.286531,0.000031,0.000068,0.013786
Smart-Status2608,20,14,11,25,46,22,68,7,0.278023,0.29321,0.000245,0.000225,0.014998
Solondthewookiee,71,25,16,41,114,62,176,7,0.29853,0.315983,0.000669,0.000555,0.028916
StandardLocal3929,10,12,7,19,23,8,31,7,0.290787,0.308218,0.000147,0.000143,0.012104
SuccessValuable6924,18,7,5,12,37,16,53,7,0.26284,0.274428,0.000059,0.000124,0.012904
Sulfamide,19,7,9,16,38,21,59,7,0.312173,0.332039,0.000123,0.000123,0.010845
TetraThiaFulvalene,15,8,9,17,16,11,27,7,0.293291,0.308706,0.000489,0.000094,0.010005
TheMan5991,35,17,9,26,67,30,97,7,0.289116,0.304435,0.000413,0.000262,0.015114
ThirteenOnline,20,18,8,26,35,15,50,7,0.276496,0.289749,0.000152,0.000203,0.011408
TipResident4373,17,9,5,14,28,9,37,7,0.266099,0.279205,0.000049,0.000112,0.009497
TopDownRiskBased,22,4,4,8,19,17,36,7,0.284753,0.300533,0.000244,0.000165,0.004591
TraditionalSpirit636,22,12,18,30,57,31,88,7,0.317424,0.337305,0.000421,0.000217,0.016127
TrumpetDuster,46,20,29,49,50,123,173,7,0.329095,0.35396,0.000731,0.000328,0.016108
Tweez07,15,15,5,20,28,10,38,7,0.262612,0.275422,0.000132,0.000159,0.022681
UselessprojectsRUS,11,18,13,31,23,15,38,7,0.298196,0.316504,0.000212,0.000118,0.021982
What_the_8,33,27,12,39,55,18,73,7,0.293044,0.311972,0.000376,0.000208,0.024442
X-calibreX,10,9,5,14,23,7,30,7,0.275805,0.290764,0.000056,0.000122,0.010078
Xer0day,16,9,5,14,35,15,50,7,0.254853,0.265431,0.00003,0.000214,0.011274
Yesyesnaaooo,16,8,3,11,20,15,35,8,0.238808,0.248009,0.000017,0.000218,0.006316
ZorgZeFrenchGuy,18,23,12,35,40,13,53,7,0.287246,0.302391,0.000298,0.00019,0.026661
_ParadigmShift,24,13,12,25,45,22,67,7,0.30103,0.320432,0.000099,0.000157,0.01451
annabananaberry,36,14,12,26,69,19,88,7,0.298766,0.314601,0.001768,0.000334,0.008838
aqulushly,12,4,2,6,20,9,29,7,0.280781,0.295823,0.000013,0.000081,0.005801
bgaesop,20,18,17,35,33,22,55,7,0.299161,0.316391,0.000464,0.000209,0.02196
bluepillarmy,169,78,279,357,150,1352,1502,6,0.382323,0.431342,0.02365,0.001116,0.032483
cat_of_danzig,35,28,21,49,66,33,99,7,0.309485,0.32848,0.000968,0.000302,0.027787
dave-t-2002,21,13,7,20,49,18,67,7,0.272897,0.287308,0.000087,0.000285,0.013365
dr_eh,10,11,3,14,22,5,27,8,0.253144,0.262352,0.000024,0.000097,0.017062
eggs-benedryl,12,12,8,20,19,10,29,7,0.296536,0.312921,0.000113,0.000118,0.011634
everydaywinner2,25,33,19,52,53,21,74,7,0.311378,0.332355,0.000796,0.000184,0.039518
ffxivthrowaway03,28,18,16,34,75,28,103,7,0.303065,0.322675,0.000381,0.000191,0.017535
funglegunk,45,13,10,23,74,28,102,7,0.293367,0.310084,0.000184,0.000395,0.00703
glopthrowawayaccount,58,24,19,43,69,46,115,7,0.304266,0.321444,0.000743,0.000403,0.020458
hi_imjoey,10,12,6,18,20,7,27,7,0.29553,0.312398,0.00022,0.000142,0.009207
hillswalker87,15,26,18,44,45,20,65,7,0.304041,0.322116,0.000416,0.000205,0.02704
horshack_test,52,20,12,32,95,44,139,7,0.30123,0.320042,0.000408,0.00042,0.01345
ihatepasswords1234,48,22,17,39,106,51,157,7,0.295607,0.314283,0.000334,0.000357,0.016791
irespectwomenlol,14,17,3,20,29,5,34,8,0.247784,0.256234,0.000047,0.0002,0.015978
jadnich,32,21,12,33,45,19,64,7,0.308746,0.331193,0.000695,0.000215,0.030431
kangorooz99,53,30,26,56,112,50,162,7,0.312345,0.330173,0.001225,0.00051,0.022673
lakotajames,13,9,6,15,24,8,32,7,0.273904,0.287136,0.000068,0.000132,0.007202
lotharingian-lemur,16,9,7,16,43,11,54,7,0.25752,0.268373,0.000069,0.000225,0.005188
mishaxz,77,50,28,78,146,48,194,7,0.30902,0.330206,0.001715,0.000608,0.043267
ncolaros,11,18,10,28,31,15,46,7,0.297941,0.313962,0.00038,0.000186,0.022049
nefarious_planet,14,9,7,16,17,10,27,7,0.287885,0.299533,0.002705,0.000132,0.008282
olidus,33,17,14,31,65,25,90,7,0.312065,0.332806,0.000684,0.00028,0.01367
omrixs,24,12,9,21,38,21,59,7,0.288968,0.306467,0.000153,0.000223,0.008127
other_view12,18,19,7,26,39,19,58,7,0.281444,0.295959,0.000262,0.000204,0.02291
pumpkinspeedwagon86,39,25,42,67,49,117,166,6,0.332452,0.358258,0.001484,0.00026,0.024464
reddituserperson1122,86,38,37,75,180,85,265,7,0.325289,0.347606,0.002353,0.00079,0.028861
rhiao,55,29,53,82,50,145,195,7,0.331528,0.35699,0.002209,0.000407,0.019819
skate1243,34,15,7,22,56,16,72,7,0.285453,0.301148,0.000948,0.000324,0.010832
southernfirm,10,5,2,7,14,5,19,8,0.21316,0.218712,0.000221,0.000121,0.005503
theAltRightCornholio,19,21,13,34,28,17,45,7,0.302236,0.323106,0.000894,0.000205,0.018396
thefrozenflame21,20,33,10,43,54,14,68,7,0.291817,0.309237,0.000758,0.000235,0.032541
toodledootootootoo,27,6,6,12,52,16,68,8,0.257037,0.268647,0.000021,0.000158,0.01013
traanquil,10,10,3,13,18,3,21,8,0.247676,0.257746,0.000024,0.000099,0.016703
urquhartloch,48,40,16,56,108,36,144,6,0.310908,0.330544,0.001055,0.000516,0.023836
way2lazy2care,26,25,14,39,37,21,58,7,0.297569,0.315921,0.001089,0.000267,0.018538
xboxhaxorz,26,33,11,44,56,14,70,7,0.2939,0.309345,0.000721,0.000211,0.033145
xraysteve185,12,6,4,10,25,15,40,8,0.228426,0.235735,0.000139,0.000239,0.004315
ygmc8413,51,15,13,28,104,51,155,7,0.279413,0.293612,0.000223,0.00048,0.010535
youwillbechallenged,47,30,15,45,68,18,86,7,0.30398,0.32146,0.001688,0.000272,0.033923
zstock003,14,9,7,16,35,17,52,7,0.262932,0.276054,0.000284,0.000307,0.008746
Alex_Danko,51,15,144,159,36,1120,1156,6,0.357289,0.391047,0.004148,0.000335,0.004157
---AI---,14,8,6,14,28,11,39,8,0.257872,0.26929,0.000097,0.000138,0.003568
Acceptable-Remove792,14,8,3,11,27,11,38,8,0.229433,0.237105,0.000019,0.00024,0.006325
AdministrativeSet419,10,10,1,11,20,3,23,8,0.23005,0.236896,0.000076,0.000146,0.004199
Antique-Ad-9081,29,18,12,30,48,23,71,7,0.298688,0.316524,0.000743,0.00024,0.010599
Apathetic_Villainess,12,3,3,6,20,10,30,7,0.270679,0.283848,0.000011,0.000103,0.002292
Apprehensive_Run238,34,5,3,8,61,22,83,8,0.211093,0.217002,0.000014,0.000269,0.001901
Apprehensive_Set_105,20,9,4,13,42,15,57,8,0.263391,0.274375,0.000012,0.000217,0.004275
ArguteTrickster,33,7,6,13,67,31,98,8,0.254438,0.264856,0.000206,0.000319,0.002505
Automatic_Tackle_406,15,19,17,36,44,18,62,7,0.301752,0.318673,0.000925,0.000162,0.013137
Background-Major-567,12,6,5,11,20,11,31,7,0.255731,0.266423,0.000022,0.000109,0.004382
BaguetteFetish,15,14,87,101,25,335,360,7,0.346069,0.378022,0.001516,0.000139,0.014639
Biffs_bunny,29,16,12,28,49,19,68,7,0.279395,0.293396,0.000401,0.000265,0.004483
BigMax,12,22,9,31,35,10,45,7,0.299636,0.31739,0.001111,0.000164,0.019077
Bilabong127,37,13,6,19,68,12,80,8,0.247284,0.255103,0.000854,0.000225,0.01264
Brilliant_Trade_9162,17,9,6,15,25,14,39,7,0.284396,0.302145,0.000048,0.000103,0.011002
Charlie4s,15,8,4,12,32,7,39,7,0.260332,0.273117,0.000182,0.000089,0.011013
Commercial-Print-,30,16,8,24,55,24,79,7,0.271914,0.2859,0.000208,0.000238,0.009974
ConstitutionalGato,10,15,10,25,27,14,41,7,0.290488,0.305774,0.000405,0.000137,0.011673
ConsultJimMoriarty,41,27,22,49,108,40,148,7,0.297354,0.313536,0.000768,0.000483,0.015226
DaddyRocka,18,13,12,25,38,16,54,7,0.290693,0.308625,0.000316,0.000165,0.010372
FaithfulPichu,10,4,5,9,16,8,24,7,0.26473,0.276619,0.000012,0.00008,0.003484
Fichek,13,10,7,17,25,9,34,7,0.277071,0.29188,0.00006,0.00009,0.007797
Foyles_War,12,7,9,16,29,15,44,7,0.275738,0.288729,0.000146,0.000105,0.003578
HellfireXP,22,10,7,17,40,16,56,7,0.281619,0.296152,0.0001,0.000188,0.008689
IDVDI,12,20,11,31,36,14,50,7,0.288435,0.305427,0.000291,0.000146,0.02895
Ieam_Scribbles,16,8,7,15,21,15,36,8,0.277614,0.291062,0.000064,0.000109,0.005114
InfamousDeer,14,23,12,35,25,13,38,7,0.304471,0.323945,0.000768,0.00018,0.020375
Infinite_Collar_7610,19,5,2,7,43,21,64,8,0.229922,0.237909,0.000065,0.000226,0.007619
JoffreeBaratheon,22,19,5,24,33,10,43,7,0.29276,0.307278,0.000526,0.000231,0.007216
Kaiisim,13,27,6,33,31,6,37,7,0.289597,0.307339,0.000279,0.000156,0.026562
Key_Cheetah7982,59,34,34,68,150,55,205,7,0.312733,0.335093,0.00205,0.000464,0.031087
Kikikididi,12,6,5,11,36,13,49,8,0.251067,0.261466,0.000046,0.000169,0.008033
Kirstemis,13,5,2,7,18,11,29,7,0.256513,0.266903,0.000073,0.000109,0.003841
LivingLikeACat33,62,22,16,38,88,47,135,7,0.302256,0.31842,0.000891,0.000334,0.019181
Majestic_Horse_1678,17,13,4,17,31,7,38,8,0.269055,0.284311,0.000064,0.000106,0.012414
ManufacturerVivid164,87,39,24,63,160,77,237,7,0.312259,0.331724,0.001083,0.000667,0.03806
Maximumoverdrive76,22,14,12,26,39,15,54,7,0.290227,0.304735,0.001169,0.000118,0.017862
MeanderingDuck,38,19,15,34,49,31,80,7,0.324683,0.343812,0.001521,0.00032,0.01246
MeanestGoose,10,19,5,24,30,6,36,7,0.269119,0.281858,0.000095,0.000151,0.013354
Melodic_Contract8155,21,6,21,27,14,37,51,7,0.31561,0.335028,0.000238,0.000093,0.005023
MrPoopMonster,18,10,8,18,24,15,39,7,0.274169,0.286889,0.000126,0.000154,0.0058
Myrvoid,17,12,6,18,36,17,53,7,0.284735,0.300383,0.000163,0.000138,0.014275
Na7vy,10,8,15,23,12,28,40,6,0.310014,0.329341,0.000085,0.000095,0.006162
NefariousnessMost660,15,8,7,15,24,16,40,8,0.263574,0.276412,0.000276,0.000222,0.003977
Nsfwacct1872564,13,8,8,16,26,12,38,7,0.273904,0.287852,0.000045,0.000101,0.00519
Pac_Eddy,13,6,4,10,20,5,25,8,0.236538,0.243233,0.000267,0.000069,0.003977
PassionGlobal,12,9,5,14,21,13,34,7,0.26864,0.281532,0.000091,0.00012,0.007279
Philstar_nz,23,20,8,28,43,18,61,7,0.290899,0.306601,0.000167,0.000201,0.02508
Plenty_Advance7513,17,10,9,19,34,12,46,7,0.30095,0.319085,0.000282,0.000158,0.010428
Puzzleheaded_Mix4160,24,8,6,14,52,21,73,8,0.238972,0.246676,0.000404,0.000242,0.002148
Rawlott1620,13,9,8,17,38,15,53,8,0.288655,0.302138,0.000159,0.000168,0.006962
Rivercitybruin,28,33,9,42,48,14,62,7,0.274685,0.290557,0.000487,0.00026,0.037351
Rollingforest757,10,7,7,14,29,8,37,7,0.275487,0.289208,0.000087,0.000096,0.00239
RubyMae4,35,8,9,17,68,29,97,7,0.281987,0.296396,0.000082,0.000291,0.004947
ScoutsHonorHoops,15,7,1,8,20,5,25,9,0.216212,0.226051,0.000004,0.000087,0.008938
SheWhoLovesSilence,22,15,47,62,32,362,394,7,0.326414,0.350915,0.000912,0.000195,0.011864
Technical-Revenue-48,11,11,6,17,30,14,44,7,0.26588,0.278137,0.000087,0.000187,0.005212
ToSAhri,31,22,10,32,57,21,78,7,0.28871,0.30712,0.000437,0.000155,0.023042
Unitaco90,10,8,3,11,12,4,16,7,0.284825,0.300758,0.000039,0.000056,0.011889
WakeoftheStorm,17,19,6,25,38,8,46,8,0.270566,0.285248,0.000116,0.000119,0.03059
WarbleDarble,179,53,50,103,336,193,529,7,0.307823,0.331696,0.003162,0.001551,0.045491
Waste-Menu-1910,10,15,4,19,23,6,29,8,0.261958,0.2725,0.000044,0.000104,0.020289
alelp,12,14,9,23,30,15,45,7,0.28783,0.304771,0.000313,0.000157,0.015151
allbusiness512,15,7,3,10,30,13,43,7,0.235677,0.243437,0.000015,0.000147,0.004776
assistantprofessor,10,12,4,16,18,5,23,7,0.311293,0.330125,0.000313,0.000099,0.017894
aythekay,10,9,6,15,29,11,40,8,0.271214,0.283463,0.000116,0.000187,0.006838
bizarre_coincidence,10,7,4,11,15,6,21,8,0.240508,0.249084,0.000023,0.000096,0.006188
cindad83,24,25,33,58,45,54,99,7,0.321342,0.340793,0.001072,0.000308,0.01883
cstar1996,89,34,29,63,176,95,271,7,0.311079,0.331775,0.001643,0.000806,0.023587
dbandroid,13,9,5,14,25,11,36,7,0.271214,0.28469,0.000031,0.000128,0.006982
energirl,35,25,21,46,69,34,103,7,0.296168,0.314605,0.000879,0.000257,0.024088
eternally_insomnia,19,23,11,34,30,11,41,7,0.301732,0.317896,0.001003,0.000155,0.023434
ferdaw95,12,9,4,13,17,9,26,8,0.258505,0.269409,0.000074,0.000115,0.00691
freezeemup,12,4,1,5,14,1,15,8,0.215339,0.221836,0.000002,0.000046,0.009192
jimmyxtang,12,4,3,7,29,9,38,7,0.260078,0.270312,0.000007,0.000142,0.002183
jinjuwaka,14,12,13,25,39,17,56,6,0.301913,0.319566,0.000844,0.000184,0.008774
joittine,40,33,21,54,91,40,131,7,0.310908,0.332732,0.000957,0.000338,0.033053
jrssister,10,10,4,14,20,12,32,7,0.262536,0.274445,0.000052,0.000181,0.00687
knightbane007,14,16,11,27,31,12,43,7,0.278914,0.292855,0.000223,0.000149,0.013226
koolaid-girl-40,27,29,6,35,67,11,78,7,0.277003,0.290414,0.000262,0.000332,0.027777
lee1026,86,50,33,83,150,85,235,7,0.30799,0.326781,0.002244,0.000724,0.031452
mallardramp,13,12,8,20,38,16,54,7,0.283452,0.299996,0.000146,0.000146,0.015777
marcelsmudda,13,6,2,8,21,5,26,8,0.219737,0.227221,0.000017,0.000105,0.0114
myfirstnamesdanger,28,12,8,20,65,30,95,7,0.274368,0.285899,0.000693,0.000332,0.0082
myrd13,12,4,5,9,10,10,20,7,0.254839,0.265272,0.000013,0.000102,0.002309
natelion445,22,9,7,16,36,15,51,7,0.293748,0.310838,0.00014,0.000139,0.008057
punta_del_diablo,13,7,3,10,27,12,39,8,0.235885,0.244019,0.000015,0.000147,0.006406
real-bebsi,23,7,7,14,37,15,52,7,0.259959,0.271477,0.000117,0.000159,0.003133
rnason,25,25,15,40,40,17,57,7,0.312819,0.329072,0.004476,0.000244,0.019339
serene_brutality,12,19,2,21,23,2,25,7,0.287866,0.304347,0.000313,0.000098,0.021335
silverionmox,148,41,45,86,257,102,359,7,0.322923,0.345457,0.003326,0.000814,0.031453
spiteful-vengeance,12,17,13,30,40,17,57,7,0.29501,0.308753,0.002183,0.000138,0.016965
stoneimp,24,17,9,26,44,15,59,8,0.277274,0.293911,0.000533,0.000164,0.027061
teenageIbibioboy,20,7,4,11,32,12,44,8,0.258401,0.268614,0.000029,0.000159,0.005254
the_brightest_prize,25,26,12,38,50,21,71,7,0.289061,0.305028,0.000529,0.000241,0.031727
vote4bort,87,39,17,56,179,68,247,7,0.278245,0.293002,0.000836,0.000878,0.022913
AlexandrTheTolerable,67,23,49,72,42,127,169,7,0.296517,0.320918,0.001179,0.000319,0.017162
Alive_Shoulder3573,48,17,15,32,93,39,132,8,0.267276,0.285174,0.000183,0.000455,0.012849
Ana_Na_Moose,17,17,11,28,28,12,40,8,0.25883,0.27409,0.000134,0.000171,0.026948
AnotherHumanObserver,28,16,4,20,51,21,72,8,0.272175,0.289903,0.000014,0.000264,0.024453
BRAINSPLATTER16,13,4,4,8,5,6,11,8,0.231757,0.243767,0.00001,0.000091,0.001736
Delta-9-,33,21,17,38,54,35,89,8,0.272798,0.293699,0.000224,0.000295,0.025227
DisabledToaster1,11,12,2,14,13,2,15,8,0.236538,0.24574,0.000022,0.00011,0.009464
Edgar_Brown,11,9,4,13,18,6,24,8,0.241264,0.252134,0.000931,0.000082,0.008483
Fargason,60,14,15,29,55,53,108,8,0.275169,0.292999,0.000095,0.000319,0.009778
FrozenSeas,14,12,6,18,18,8,26,8,0.243901,0.256393,0.000024,0.000115,0.015381
Hyndis,22,17,16,33,28,18,46,7,0.281444,0.301654,0.000201,0.000172,0.018529
IniNew,34,20,15,35,56,27,83,7,0.286863,0.307552,0.000267,0.000266,0.027702
Interrophish,71,39,51,90,107,101,208,7,0.305292,0.330631,0.00238,0.000505,0.039954
IntrepidAd2478,26,19,12,31,41,21,62,8,0.265117,0.280557,0.000088,0.000215,0.018241
Jen0BIous,15,6,3,9,18,13,31,8,0.255977,0.269038,0.000158,0.000105,0.006067
ManBearScientist,55,33,24,57,69,41,110,7,0.281952,0.298677,0.000918,0.000424,0.038855
Moccus,69,35,36,71,68,64,132,8,0.290023,0.313702,0.000879,0.000485,0.031324
Objective_Aside1858,216,134,301,435,339,1453,1792,7,0.372696,0.423168,0.044324,0.001575,0.088009
Sarmq,17,5,5,10,18,13,31,8,0.24727,0.260246,0.000026,0.000116,0.006338
StanDaMan1,10,9,6,15,17,6,23,7,0.254153,0.270263,0.000023,0.000082,0.012157
Storyteller-Hero,15,17,5,22,25,6,31,7,0.256049,0.271109,0.000052,0.000138,0.020412
TheMikeyMac13,55,29,17,46,78,31,109,8,0.2711,0.291057,0.000324,0.000398,0.024986
UnfoldedHeart,64,49,39,88,110,50,160,7,0.30069,0.323525,0.002166,0.000441,0.0451
WhiteWolf3117,12,11,6,17,23,12,35,7,0.285886,0.303953,0.000069,0.000168,0.014008
XXXCincinnatusXXX,17,10,6,16,26,7,33,8,0.245036,0.258503,0.000013,0.000111,0.01083
clios_daughter,20,4,5,9,15,6,21,7,0.287775,0.306511,0.000157,0.00012,0.003356
mskmagic,22,11,7,18,28,19,47,7,0.263759,0.280018,0.000039,0.000186,0.009979
neosituation_unknown,12,9,0,9,10,0,10,0,0,0,0,0.000084,0.010937
phoenix1984,15,11,5,16,19,9,28,8,0.24279,0.254394,0.000043,0.000198,0.0143
punninglinguist,15,20,8,28,25,10,35,7,0.27626,0.292509,0.000396,0.000242,0.016735
serious_sarcasm,19,7,11,18,32,18,50,7,0.280035,0.300497,0.000029,0.000115,0.008878
skyfishgoo,11,15,5,20,23,8,31,8,0.243311,0.255005,0.000021,0.000141,0.022789
sllewgh,205,36,25,61,211,116,327,8,0.281602,0.303289,0.002089,0.001048,0.015339
sunfishtommy,10,15,13,28,25,15,40,8,0.278126,0.298621,0.000114,0.000125,0.020457
theyfellforthedecoy,37,24,19,43,37,21,58,8,0.257593,0.275175,0.000157,0.000188,0.028475
wheres_my_hat,17,8,5,13,26,19,45,7,0.263943,0.280356,0.000061,0.000156,0.008559
zayelion,18,18,5,23,27,8,35,8,0.260018,0.27605,0.0002,0.000112,0.025643
AlpineSuccess-Edu,22,20,120,140,30,457,487,6,0.344935,0.376691,0.003108,0.000333,0.002839
AdHopeful3801,13,29,9,38,47,13,60,7,0.288692,0.305734,0.000237,0.000126,0.039712
Apprehensive-Let3348,27,30,14,44,55,21,76,7,0.29019,0.306003,0.00046,0.000217,0.027646
BigDaddyDumperSquad,14,9,5,14,34,16,50,7,0.266584,0.278324,0.000422,0.000182,0.013754
Browler_321,24,10,7,17,42,21,63,7,0.289893,0.308447,0.000126,0.000137,0.012741
Chocolat3City,13,9,38,47,16,83,99,7,0.335308,0.35884,0.00049,0.000157,0.006934
Clever-username-7234,10,12,5,17,22,6,28,7,0.262947,0.276092,0.000031,0.000094,0.014611
CosmicLovepats,16,17,6,23,40,14,54,7,0.283701,0.297811,0.000183,0.000177,0.022472
DTF_Truck,10,7,4,11,19,6,25,8,0.235628,0.244216,0.000242,0.000094,0.008566
DrRealName,10,14,4,18,30,6,36,7,0.26249,0.275285,0.000151,0.000154,0.019837
DuetWithMe99,17,13,15,28,20,35,55,7,0.307907,0.326956,0.000299,0.000181,0.00868
DungeonJailer,23,19,10,29,42,17,59,7,0.292628,0.308301,0.00016,0.000176,0.019671
FnakeFnack,12,10,6,16,16,8,24,7,0.277887,0.292989,0.000075,0.000137,0.005065
FockerXC,16,10,6,16,21,12,33,8,0.265693,0.279951,0.000121,0.000223,0.006321
Front-Finish187,21,13,9,22,49,19,68,7,0.272045,0.283466,0.000407,0.000207,0.005416
HombreDeMoleculos,12,6,5,11,16,8,24,7,0.277139,0.290613,0.000046,0.000096,0.006382
Jake0024,23,38,21,59,74,29,103,7,0.314208,0.333913,0.003828,0.000348,0.041268
KlausVonChiliPowder,11,15,6,21,33,7,40,7,0.27013,0.283671,0.000117,0.000191,0.00979
Korimito,35,12,7,19,65,29,94,7,0.292968,0.309197,0.000065,0.000217,0.014103
LIONS_old_logo,13,6,5,11,18,14,32,8,0.271409,0.286997,0.000018,0.000067,0.010053
Leon_Thomas,33,12,6,18,57,30,87,7,0.27123,0.28441,0.000488,0.000211,0.008967
Lethkhar,16,22,12,34,43,19,62,7,0.277716,0.293039,0.000167,0.000176,0.017367
LowNoise9831,16,14,8,22,33,12,45,7,0.274751,0.288957,0.000127,0.000165,0.011835
NittanyOrange,10,10,4,14,22,8,30,7,0.263482,0.275386,0.000053,0.000107,0.008124
Odd-Fly-1265,12,6,6,12,18,12,30,7,0.26704,0.278687,0.000046,0.000147,0.004709
Ok_Cap9557,14,14,6,20,31,14,45,7,0.289837,0.304534,0.000093,0.000127,0.011588
Ok_Soft_4575,27,10,6,16,59,27,86,7,0.281269,0.298131,0.000118,0.000271,0.007901
Papaofmonsters,16,16,6,22,27,12,39,7,0.267798,0.282444,0.000099,0.000173,0.009745
Ramguy2014,48,16,9,25,76,45,121,7,0.292874,0.309869,0.000326,0.000533,0.012747
Randomousity,27,21,20,41,55,31,86,7,0.30523,0.321935,0.000485,0.00023,0.016238
ReturnPresent9306,27,29,18,47,53,24,77,7,0.293919,0.311364,0.000901,0.000207,0.037381
Santa5511,10,6,3,9,17,6,23,8,0.273507,0.287526,0.000027,0.000116,0.009113
Secret-Put-4525,25,20,5,25,42,12,54,7,0.271686,0.283594,0.000186,0.000147,0.020119
SirWillae,10,17,2,19,21,2,23,8,0.266616,0.281549,0.000037,0.000082,0.022295
Sky-Trash,15,18,16,34,35,19,54,7,0.299478,0.317192,0.00024,0.000153,0.022551
Spaniardman40,19,25,8,33,38,17,55,7,0.29242,0.308169,0.000736,0.000222,0.029337
Sufficient_Show_7795,24,9,12,21,58,29,87,7,0.261943,0.273329,0.000121,0.000237,0.009771
Supercollider9001,23,14,8,22,39,15,54,7,0.299577,0.318865,0.000415,0.000197,0.021253
Talik1978,53,19,9,28,92,36,128,7,0.284932,0.299668,0.000278,0.000314,0.015784
Team503,54,24,25,49,143,68,211,7,0.300531,0.318706,0.000909,0.000497,0.015991
Tengoatuzui,19,11,7,18,30,11,41,6,0.316072,0.332873,0.000266,0.000103,0.019146
TheDrakkar12,43,23,80,103,36,397,433,6,0.338288,0.368003,0.002746,0.000364,0.009118
Total_Literature_809,33,20,12,32,45,20,65,7,0.283169,0.297262,0.000486,0.000211,0.011008
Trauma_Hawks,16,14,8,22,33,11,44,7,0.286482,0.301464,0.000349,0.000153,0.007463
Unexpected_Gristle,24,9,8,17,39,19,58,7,0.274418,0.288479,0.000419,0.00022,0.013166
Warchief_Ripnugget,29,20,16,36,48,25,73,7,0.302943,0.323341,0.00069,0.000188,0.02504
YogurtclosetFair5742,17,14,6,20,23,8,31,7,0.299636,0.315389,0.000953,0.000109,0.006764
a_null_set,12,9,6,15,29,17,46,7,0.274485,0.288017,0.000353,0.000247,0.003954
aurora-s,21,14,10,24,38,21,59,7,0.288582,0.305372,0.000352,0.000194,0.006
blyzo,33,26,18,44,52,26,78,7,0.30678,0.325389,0.000813,0.000265,0.026729
cbf1232,25,13,11,24,46,16,62,7,0.27392,0.288087,0.000149,0.000171,0.005871
cloudsofdoom,12,5,6,11,17,11,28,7,0.270566,0.284124,0.000027,0.000103,0.002145
epelle9,13,7,6,13,15,10,25,7,0.281724,0.295611,0.000735,0.000161,0.004963
evilcherry1114,12,24,21,45,55,26,81,7,0.314056,0.33453,0.000273,0.000177,0.022581
fizzbish,11,9,8,17,25,13,38,7,0.28255,0.300261,0.000202,0.000122,0.011595
idontknowhow2reddit,22,24,6,30,54,7,61,7,0.296149,0.312608,0.000668,0.000259,0.011304
ladylucifer22,33,14,6,20,71,27,98,7,0.266898,0.280573,0.000165,0.000376,0.009725
moboticus,15,16,10,26,31,15,46,7,0.298098,0.314595,0.000163,0.000126,0.022333
qchisq,11,14,5,19,22,8,30,7,0.286193,0.30405,0.000361,0.000122,0.01477
suitupyo,24,14,5,19,44,13,57,8,0.248219,0.261063,0.000048,0.000212,0.010743
uberprodude,10,11,3,14,19,7,26,8,0.242634,0.252116,0.000177,0.00014,0.010673
unordinarilyboring,13,17,7,24,42,16,58,7,0.277427,0.292081,0.00029,0.000275,0.010314
whyrestwhenicandream,12,5,3,8,28,14,42,8,0.231935,0.239079,0.000011,0.000182,0.00397
wulfgar_beornegar,55,12,14,26,62,48,110,8,0.284413,0.305744,0.000296,0.000355,0.01354
Jakyland,28,38,12,50,44,12,56,7,0.296498,0.310212,0.001927,0.000229,0.021047
Utapau301,29,21,14,35,67,24,91,7,0.289912,0.305687,0.000464,0.000467,0.014992
YeOldButchery,13,23,5,28,31,9,40,7,0.277836,0.291929,0.000318,0.00025,0.012792
ginger_and_egg,65,22,16,38,115,62,177,7,0.302903,0.320918,0.001212,0.000599,0.01525
sailorbrendan,15,10,5,15,24,12,36,7,0.266946,0.279225,0.000015,0.000135,0.005037
springcabinet,13,7,4,11,17,9,26,7,0.272651,0.286501,0.000017,0.000095,0.004384
Amaz_the_savage,16,12,23,35,27,59,86,7,0.309231,0.33076,0.000562,0.000206,0.008256
Budobudo,11,5,4,9,20,9,29,8,0.25821,0.270954,0.00002,0.000095,0.003243
DiscussTek,17,12,7,19,19,12,31,7,0.279689,0.292801,0.000107,0.000141,0.007018
FionaLunaris,10,6,1,7,18,1,19,8,0.244151,0.252633,0.000006,0.000115,0.002323
Sayakai,16,7,5,12,31,15,46,7,0.265024,0.277575,0.000012,0.000187,0.003016
Stanchthrone482,16,8,5,13,16,6,22,8,0.260497,0.271899,0.00003,0.000076,0.007097
gate18,55,36,12,48,116,48,164,7,0.288876,0.305735,0.000507,0.000528,0.030016
libra00,17,19,5,24,45,13,58,7,0.269615,0.283199,0.000177,0.000164,0.018255
Ambitious_Carrot3747,11,3,53,56,3,100,103,6,0.294569,0.311143,0.000879,0.000076,0.000013
Boris-_-Badenov,14,18,8,26,24,9,33,8,0.245594,0.255824,0.000604,0.000296,0.001324
Bubbly_Chicken_9358,27,20,3,23,35,9,44,9,0.212979,0.219561,0.000567,0.000366,0.000786
Chaser_Of_The_Abyss,17,10,2,12,28,7,35,8,0.222983,0.229467,0.000111,0.00014,0.001975
ClaireL58,12,7,5,12,18,6,24,8,0.225021,0.233,0.000146,0.000124,0.000243
Crazyandiloveit,10,6,6,12,9,7,16,7,0.232459,0.241412,0.00028,0.000114,0.000169
Dizzy_Try4939,10,4,4,8,14,4,18,7,0.282992,0.296323,0.000492,0.000057,0.003331
HuntersAngel,15,7,5,12,21,10,31,7,0.215308,0.22111,0.000183,0.000301,0.000168
Illustrious_Tart_258,10,6,1,7,15,4,19,8,0.234214,0.241982,0.000044,0.000073,0.002812
K_A_irony,14,10,2,12,16,3,19,8,0.205546,0.210082,0.00014,0.000206,0.000268
Kami_Sang,28,21,8,29,22,8,30,7,0.213471,0.222433,0.000482,0.000279,0.000279
KrofftSurvivor,10,7,3,10,11,3,14,8,0.237406,0.244889,0.000444,0.000145,0.000213
LazyAd622,14,26,1,27,27,1,28,8,0.219588,0.225115,0.000348,0.000229,0.000585
Lcdmt3,19,4,3,7,18,11,29,8,0.206653,0.212767,0.000003,0.000145,0.000121
LisaCabot,13,6,2,8,14,3,17,9,0.195199,0.199761,0.000016,0.000166,0.000175
Ok-Flamingo2801,12,9,3,12,26,9,35,8,0.257169,0.268761,0.000085,0.0001,0.00801
Perdendosi,14,35,3,38,44,3,47,8,0.252791,0.261946,0.000449,0.000293,0.017094
Plus_Ad_9181,21,27,5,32,37,7,44,8,0.220518,0.229376,0.000854,0.000224,0.000909
QuestionMaker207,21,7,5,12,22,12,34,7,0.222293,0.229695,0.000198,0.000264,0.000138
Several-Adeptness-83,11,4,2,6,6,2,8,9,0.199129,0.204686,0.000011,0.00006,0.000131
SigSauerPower320,24,19,3,22,24,5,29,7,0.220368,0.227915,0.00096,0.000264,0.000665
Spare-Article-396,17,5,3,8,7,3,10,8,0.199709,0.205814,0.000033,0.000061,0.000246
TALKTOME0701,26,13,6,19,29,8,37,8,0.215052,0.222825,0.000588,0.000218,0.000344
TomdeHaan,15,9,3,12,18,3,21,8,0.24061,0.248745,0.000322,0.000119,0.005445
Unit_08_Pilot,14,13,7,20,18,9,27,8,0.243338,0.252655,0.000669,0.000127,0.002527
anglflw,13,7,1,8,13,1,14,8,0.204543,0.210464,0.000054,0.000097,0.000224
auntlynnie,11,4,1,5,4,1,5,9,0.177622,0.180815,0.000013,0.000082,0.000198
c0l245,12,11,4,15,35,15,50,7,0.287027,0.306207,0.000351,0.000155,0.007773
cans-of-swine,19,17,7,24,31,8,39,8,0.255861,0.264552,0.000902,0.000191,0.00162
lammcmahan656,10,4,1,5,10,3,13,9,0.179615,0.183255,0.000005,0.000104,0.000191
lmchatterbox,26,12,2,14,29,18,47,9,0.172724,0.176869,0.000045,0.000355,0.000218
lotteoddities,15,5,2,7,15,2,17,8,0.223853,0.230781,0.000063,0.000064,0.000257
mrtnmnhntr,10,10,2,12,13,3,16,8,0.200851,0.207279,0.000028,0.000066,0.000285
pottersquash,32,14,7,21,19,8,27,8,0.208893,0.215822,0.000836,0.000321,0.000317
smol9749been,20,12,6,18,17,9,26,7,0.242089,0.250144,0.00069,0.000169,0.000484
xicor,10,6,3,9,9,3,12,9,0.199595,0.204888,0.000117,0.00016,0.000118
yeahipostedthat,11,5,2,7,6,3,9,8,0.244996,0.252203,0.000054,0.000084,0.000177
Ambitious_Table_8585,16,12,58,70,14,247,261,6,0.323754,0.349279,0.001116,0.000175,0.004596
DewinterCor,11,18,6,24,37,14,51,7,0.279154,0.293233,0.000113,0.000205,0.0218
DuePersonality8585,21,12,7,19,39,12,51,7,0.263559,0.277923,0.000053,0.000132,0.011643
Dyn-O-mite_Rocketeer,16,7,5,12,25,13,38,7,0.261173,0.273495,0.000018,0.000151,0.003525
Elman89,10,14,7,21,25,11,36,8,0.273854,0.286922,0.000068,0.000158,0.01665
FrickinLazerBeams,54,21,21,42,133,64,197,7,0.306843,0.324539,0.000711,0.000483,0.015763
GenericUsername19892,13,13,7,20,28,12,40,7,0.278502,0.293473,0.000089,0.000119,0.012508
HackPhilosopher,10,12,6,18,16,7,23,7,0.275152,0.290469,0.000091,0.000096,0.011166
ImprovementPutrid441,79,33,25,58,163,82,245,7,0.31517,0.334042,0.001466,0.000865,0.024502
JKilla1288,17,31,10,41,40,14,54,7,0.296323,0.313701,0.000756,0.00022,0.029898
Legitimate_Gas2966,22,6,4,10,38,18,56,7,0.260242,0.272523,0.000037,0.000231,0.003064
Miserable_Ground_264,48,32,15,47,79,33,112,6,0.304266,0.32608,0.001066,0.000238,0.027995
Ok-Hunt7450,15,12,4,16,25,12,37,7,0.254925,0.264577,0.000065,0.000108,0.011701
Owlblocks,14,22,5,27,36,16,52,7,0.277037,0.291232,0.000074,0.000116,0.024367
ParfaitBurnera,13,7,4,11,23,13,36,7,0.270033,0.28254,0.000049,0.000125,0.00682
RYouNotEntertained,10,13,10,23,30,14,44,7,0.2869,0.302113,0.00025,0.00018,0.011938
Sea-Chain7394,35,21,12,33,47,22,69,7,0.280208,0.295013,0.000531,0.000236,0.014466
SingleMaltMouthwash,28,23,11,34,37,13,50,7,0.291123,0.309552,0.0003,0.000154,0.02236
SnugglesMTG,40,16,11,27,74,38,112,7,0.291873,0.30792,0.000195,0.000402,0.012297
SpeaksDwarren,11,7,5,12,20,7,27,8,0.254983,0.265385,0.000142,0.000118,0.003541
Tacenda8279,23,17,10,27,51,19,70,7,0.282409,0.297603,0.000186,0.000224,0.009404
TastyWillingness4475,14,5,8,13,17,26,43,7,0.28211,0.295549,0.000082,0.000117,0.001693
Thestral84,13,4,4,8,8,5,13,8,0.202712,0.207972,0.000407,0.000046,0.00387
Thriftless_Ambition,37,25,18,43,84,36,120,7,0.301732,0.319504,0.002121,0.000389,0.01341
TonberryFeye,11,9,2,11,19,3,22,7,0.247095,0.257944,0.000017,0.000091,0.008755
VilleKivinen,15,11,1,12,16,1,17,8,0.239655,0.247403,0.000022,0.000102,0.008571
WithMaliceTowardFew,19,14,13,27,35,20,55,7,0.293576,0.309307,0.000309,0.000162,0.013568
bawdiepie,12,8,4,12,21,8,29,7,0.291385,0.308749,0.000298,0.00012,0.011779
citizen_x_,23,10,5,15,48,18,66,7,0.264745,0.277716,0.000034,0.00018,0.009748
eldankus,15,13,9,22,33,18,51,7,0.277631,0.292339,0.000121,0.000194,0.007589
fuckounknown,23,15,11,26,51,26,77,7,0.281304,0.297661,0.000203,0.000313,0.009517
imthesqwid,12,15,7,22,21,8,29,7,0.286973,0.301563,0.000117,0.000089,0.015414
sanguinemathghamhain,27,15,9,24,36,15,51,7,0.280433,0.29485,0.000203,0.000142,0.017046
wydileie,45,20,12,32,63,30,93,7,0.309168,0.328022,0.000555,0.000266,0.021891
Anna-Amos,17,4,36,40,5,94,99,8,0.273259,0.287997,0.00113,0.000091,0.000073
Alarmed-Speaker-8330,10,9,2,11,26,6,32,8,0.210926,0.215981,0.000094,0.000133,0.00027
AnotherBogCryptid,12,9,2,11,14,3,17,9,0.187762,0.193054,0.000074,0.000098,0.000229
Cudi_buddy,31,20,16,36,60,23,83,7,0.289079,0.303064,0.003316,0.000204,0.003092
Deep-Okra1461,11,48,0,48,49,0,49,0,0,0,0,0.000253,0.001064
Disastrous-Nail-640,28,14,6,20,28,9,37,8,0.243377,0.250825,0.000459,0.000159,0.000991
Educational_Land197,10,5,5,10,14,10,24,8,0.204313,0.210313,0.000024,0.000103,0.00016
Environmental_Art591,11,6,5,11,10,5,15,9,0.218128,0.225961,0.000071,0.000064,0.000138
Kitastrophe8503,24,12,4,16,20,5,25,8,0.232233,0.238998,0.000238,0.000179,0.000415
Latter_Republic1719,33,12,13,25,52,33,85,8,0.252932,0.264035,0.000737,0.000497,0.000244
Legitimate-March9792,10,9,3,12,9,3,12,7,0.241276,0.247802,0.000182,0.000071,0.000327
Lows-andHighs,10,10,4,14,15,5,20,8,0.226348,0.234944,0.000223,0.000092,0.000396
Nymph-the-scribe,15,10,5,15,14,6,20,8,0.207895,0.215028,0.000058,0.000113,0.00022
OniyaMCD,13,5,4,9,9,4,13,7,0.244375,0.252537,0.000054,0.000067,0.000171
PhotoForward2499,13,8,4,12,15,9,24,8,0.204377,0.211558,0.000093,0.000293,0.000071
Polish_girl44,10,16,14,30,18,17,35,8,0.232782,0.244203,0.001057,0.000107,0.000733
PushPopNostalgia,13,12,5,17,19,6,25,7,0.271214,0.281963,0.001148,0.000076,0.009847
Puzzleheaded-Ad7606,10,13,8,21,17,11,28,7,0.228242,0.238435,0.000694,0.000115,0.000881
RemarkableRadish5664,15,5,3,8,9,4,13,9,0.235935,0.242227,0.000205,0.000129,0.000246
Rubycon_,16,8,8,16,30,17,47,8,0.217041,0.225709,0.000348,0.000198,0.000082
ServelanDarrow,11,14,1,15,16,1,17,8,0.207173,0.21361,0.000484,0.000129,0.000539
Turbulent_Cow2355,17,15,17,32,58,22,80,7,0.252565,0.26537,0.000918,0.000228,0.000467
West-Scale-6800,11,4,1,5,8,2,10,9,0.19325,0.197039,0.000007,0.000085,0.000157
Worth-Season3645,12,12,2,14,14,2,16,9,0.202251,0.208174,0.00007,0.000146,0.000346
angelerulastiel,18,11,4,15,23,4,27,9,0.199059,0.205836,0.000314,0.000159,0.000203
camebacklate,15,8,4,12,27,8,35,8,0.217971,0.226117,0.000423,0.000176,0.000184
meechmeechmeecho,17,13,9,22,35,13,48,7,0.279706,0.293793,0.000496,0.00017,0.012161
AnswerSingle1566,18,1,5,6,1,7,8,7,0.21578,0.221165,0.000119,0.000054,0.000006
Butter-and-Bourbon,28,4,1,5,6,2,8,8,0.17648,0.179647,0.000013,0.000118,0.000058
Live_Angle4621,16,11,6,17,17,6,23,7,0.242154,0.249822,0.000827,0.000149,0.000561
AntigoneIMT,15,7,11,18,10,22,32,7,0.301391,0.319775,0.000139,0.000112,0.003615
R_V_Z,11,21,7,28,22,7,29,8,0.258431,0.272737,0.000119,0.000141,0.020887
Snipedzoi,11,6,4,10,12,6,18,7,0.271523,0.284686,0.000013,0.000077,0.005981
ZestSimple,22,8,5,13,40,18,58,7,0.255934,0.266808,0.000108,0.000212,0.010729
facefartfreely,25,16,11,27,42,27,69,7,0.288692,0.30477,0.000121,0.000224,0.008206
parentheticalobject,24,24,12,36,43,23,66,7,0.289726,0.305698,0.000258,0.000274,0.011663
Antonius_Palatinus,69,8,13,21,62,85,147,7,0.293557,0.30851,0.00013,0.000491,0.002498
DebutsPal,70,46,40,86,118,68,186,7,0.341296,0.367769,0.00283,0.000635,0.02696
JurisCommando,25,24,12,36,44,16,60,7,0.291704,0.306434,0.000181,0.000244,0.013293
Modern_Klassics,25,14,13,27,47,26,73,7,0.291254,0.308139,0.000151,0.00022,0.008461
RavensQueen502,13,10,9,19,19,12,31,7,0.289411,0.30415,0.000079,0.000097,0.006841
Zestyclose_Peanut_76,30,31,15,46,53,31,84,7,0.315566,0.336138,0.00061,0.000276,0.023677
canned_spaghetti85,29,15,4,19,46,22,68,8,0.253939,0.265445,0.000075,0.000276,0.016506
Any-Oven-9389,28,4,12,16,5,21,26,7,0.277223,0.290276,0.000125,0.0001,0.000315
AdventurousWorker176,13,6,2,8,6,2,8,8,0.254253,0.263594,0.000114,0.000074,0.00077
Resident_Course_3342,11,8,4,12,11,4,15,8,0.237133,0.245519,0.000123,0.000137,0.002716
iphxne,16,4,3,7,23,4,27,7,0.251165,0.259742,0.000031,0.000093,0.000477
jjr4884,21,17,7,24,20,10,30,8,0.247622,0.257172,0.000682,0.000324,0.001559
revanite3956,15,17,1,18,19,1,20,7,0.236575,0.243326,0.000157,0.000231,0.001027
Apartment-Drummer,84,28,34,62,62,79,141,7,0.31078,0.328462,0.004401,0.00075,0.002455
424f42_424f42,14,10,5,15,19,8,27,8,0.257432,0.267566,0.000172,0.000161,0.001575
DiegoIntrepid,33,10,15,25,44,29,73,7,0.269535,0.282211,0.000554,0.000232,0.000922
Honeycove91,26,6,3,9,10,5,15,8,0.245328,0.253698,0.000055,0.000133,0.000781
MinerUser,20,9,3,12,9,3,12,8,0.241585,0.249466,0.000114,0.00012,0.00075
Moonlit_Shade,12,4,1,5,14,9,23,8,0.237108,0.244285,0.00001,0.000113,0.00144
MrJigglyBrown,22,16,9,25,32,14,46,8,0.249669,0.259773,0.000315,0.000196,0.001399
MrWindblade,23,8,6,14,38,19,57,8,0.258107,0.268207,0.000164,0.000247,0.007363
QuestionSign,32,20,13,33,38,20,58,7,0.272061,0.285684,0.001021,0.000341,0.001651
Specialist-Ad5796,11,20,5,25,27,6,33,8,0.258136,0.268874,0.00072,0.000181,0.003528
ThePhilVv,48,31,20,51,52,30,82,7,0.275369,0.289309,0.005318,0.00055,0.004682
True_Falsity,11,3,3,6,14,13,27,8,0.257417,0.266791,0.000047,0.000145,0.000783
doublestitch,15,13,6,19,17,10,27,8,0.266208,0.276719,0.000274,0.000164,0.001031
pplatt69,19,15,4,19,18,4,22,8,0.248928,0.257558,0.000268,0.000113,0.001814
rccrisp,22,16,5,21,23,6,29,8,0.245794,0.254223,0.00027,0.000327,0.000912
somepeoplewait,14,4,3,7,21,11,32,8,0.241251,0.249079,0.000029,0.000148,0.000541
tultommy,16,9,3,12,19,8,27,7,0.269023,0.279814,0.000313,0.0002,0.001742
Apostate_Mage,51,11,29,40,24,47,71,7,0.286337,0.300674,0.00159,0.000249,0.00057
AfraidOstrich9539,16,6,5,11,12,8,20,7,0.214087,0.220856,0.000273,0.000136,0.00011
BookWormPerson,12,8,4,12,12,4,16,8,0.235971,0.244787,0.000152,0.000075,0.001223
DancingDaffodilius,12,10,4,14,18,6,24,8,0.236292,0.243852,0.000144,0.000154,0.001029
Forward_Party_5355,10,7,1,8,8,2,10,9,0.198484,0.203093,0.000003,0.000101,0.000997
FrostyIcePrincess,10,12,6,18,15,7,22,8,0.234712,0.243278,0.000192,0.000146,0.001051
NikRsmn,16,10,8,18,20,14,34,7,0.279741,0.29344,0.000406,0.000171,0.004999
NoahtheRed,67,51,20,71,65,21,86,7,0.292156,0.306768,0.004294,0.000779,0.004916
SparkleSelkie,78,46,30,76,98,41,139,7,0.30075,0.318934,0.006579,0.000771,0.00434
TemporaryApartment19,16,5,3,8,13,8,21,8,0.238481,0.245862,0.000084,0.000101,0.00025
Y0___0Y,39,36,14,50,49,21,70,8,0.252143,0.267549,0.00046,0.000403,0.034677
forlackofabetterpost,136,44,22,66,124,64,188,7,0.285148,0.300019,0.003644,0.001223,0.005118
Appropriate_Cook_508,15,5,9,14,7,16,23,7,0.292043,0.306575,0.000058,0.000127,0.002413
FattestPokemonPlayer,12,18,3,21,24,4,28,7,0.269471,0.281597,0.000225,0.000141,0.010072
Ok-Eye658,15,11,8,19,30,15,45,7,0.286754,0.301081,0.000054,0.00014,0.006543
WippitGuud,23,15,7,22,46,20,66,7,0.290637,0.30438,0.000084,0.000269,0.018193
Ariesgh0st,17,1,9,10,1,12,13,8,0.215359,0.224564,0.000042,0.000077,0.000005
Antique-Agent-2992,10,8,2,10,10,3,13,9,0.182422,0.187919,0.000121,0.000128,0.00006
Flat-Replacement4828,114,39,19,58,91,41,132,8,0.236575,0.249111,0.004892,0.001297,0.000628
pinkpink0430,17,7,4,11,16,6,22,9,0.195806,0.200518,0.00026,0.000287,0.000121
quincebush,16,8,3,11,15,5,20,8,0.222687,0.230601,0.000085,0.000138,0.000118
Arkhamman367,27,6,12,18,11,36,47,7,0.283062,0.299265,0.000102,0.000117,0.003918
Smee76,13,6,4,10,22,13,35,7,0.273474,0.28647,0.000015,0.000112,0.00353
StillLikesTurtles,36,47,26,73,83,41,124,7,0.325266,0.348434,0.001721,0.000331,0.030632
StobbstheTiger,12,8,6,14,26,9,35,7,0.268497,0.281192,0.000021,0.000125,0.003472
Successful-Shopping8,191,53,118,171,226,430,656,6,0.352479,0.38776,0.007566,0.001085,0.022673
TarumK,11,11,6,17,26,11,37,8,0.256006,0.268332,0.000081,0.000135,0.006505
ThoseThatComeAfter,39,10,18,28,49,63,112,7,0.315039,0.336673,0.000217,0.000329,0.008341
Arnaldo1993,50,33,28,61,72,108,180,6,0.321959,0.346254,0.001278,0.000388,0.029281
AxlLight,11,11,6,17,25,8,33,7,0.270453,0.285573,0.000205,0.000148,0.009098
BootyMcStuffins,26,8,5,13,48,22,70,7,0.310418,0.326412,0.00031,0.000293,0.01299
Noodlesh89,41,31,21,52,79,43,122,6,0.300133,0.318231,0.000392,0.000397,0.019445
nightshade78036,12,5,3,8,14,9,23,8,0.258637,0.27061,0.000008,0.000089,0.002465
y0da1927,17,12,9,21,28,15,43,7,0.27063,0.284844,0.000078,0.00016,0.004517
Artistic_Kangaroo932,11,1,3,4,1,4,5,8,0.232782,0.240997,0.000005,0.000043,0.000005
Artistic_Remote_4665,11,3,10,13,4,13,17,8,0.226495,0.236222,0.00005,0.000083,0.000005
DawgMom67,12,11,0,11,14,0,14,0,0,0,0,0.000121,0.000283
JeanSchlemaan,20,22,9,31,30,11,41,8,0.227714,0.237501,0.001641,0.000281,0.000552
Juilek,17,24,21,45,38,27,65,7,0.240815,0.254036,0.002368,0.000304,0.000265
OglioVagilio,11,10,10,20,16,12,28,8,0.230624,0.241301,0.000504,0.000128,0.000136
PiccoloImpossible946,12,8,10,18,20,15,35,7,0.237294,0.247449,0.00037,0.000181,0.000164
ThrowItAway4Evaa,16,9,7,16,14,7,21,8,0.230039,0.239615,0.000656,0.000179,0.000189
Usrname52,26,15,8,23,38,11,49,8,0.274585,0.285337,0.002372,0.000238,0.000927
Zestyclose-Height-36,12,6,2,8,8,2,10,9,0.188567,0.193015,0.000009,0.000056,0.000158
ZookeepergameOld3851,19,16,11,27,34,16,50,7,0.233105,0.243559,0.001459,0.000197,0.000342
AtheneOrchidSavviest,39,27,38,65,55,90,145,6,0.342924,0.370328,0.001441,0.000284,0.024746
BCMakoto,20,15,11,26,33,24,57,7,0.304839,0.323536,0.000471,0.000161,0.012242
Due_Satisfaction2167,10,10,4,14,19,5,24,8,0.262718,0.275609,0.000019,0.000103,0.006805
Gygsqt,43,22,23,45,67,40,107,6,0.299339,0.31465,0.001324,0.0004,0.011281
Raznill,12,18,11,29,34,17,51,7,0.296071,0.312526,0.000298,0.000175,0.013988
Rosimongus,19,13,11,24,37,20,57,7,0.28113,0.295762,0.000109,0.000167,0.007441
im-obsolete,27,16,6,22,60,15,75,7,0.28849,0.306463,0.000459,0.000307,0.015018
mattyoclock,15,12,5,17,18,8,26,8,0.26764,0.27921,0.000042,0.000135,0.00619
mred245,12,8,5,13,30,12,42,7,0.260123,0.272199,0.000074,0.000197,0.00561
pickleparty16,11,14,6,20,32,13,45,7,0.280764,0.295628,0.000061,0.000183,0.010521
rollem,18,17,6,23,43,9,52,8,0.252988,0.263873,0.000144,0.000224,0.007328
AutoModerator,40,0,75,75,0,491,491,6,0.357312,0.384007,0,0.000033,0
-Ch4s3-,53,31,23,54,99,41,140,7,0.303654,0.321422,0.000789,0.000429,0.021356
20twentytwos,16,5,2,7,12,5,17,8,0.243941,0.253324,0.000013,0.000087,0.001669
AnalogMojo23,17,5,3,8,37,14,51,8,0.222282,0.22894,0.000026,0.000234,0.000889
AspirationAtWork,50,31,20,51,96,45,141,7,0.314732,0.331626,0.001553,0.000434,0.018931
Criminal_of_Thought,15,25,14,39,34,16,50,7,0.297628,0.314032,0.000584,0.000199,0.011824
Diego_Pepos,24,17,15,32,54,22,76,7,0.271279,0.284063,0.000895,0.00025,0.002133
Downtown-Act-590,79,41,95,136,83,381,464,7,0.360819,0.393834,0.008045,0.000472,0.024387
Embarrassed_Base_389,14,3,1,4,23,3,26,8,0.225514,0.232162,0.000005,0.000081,0.001988
JohnWittieless,22,19,13,32,31,18,49,7,0.296614,0.314132,0.000251,0.000149,0.011681
MalfoyHolmes14,11,22,5,27,31,8,39,7,0.251779,0.261748,0.000452,0.000127,0.003444
Mindless_Giraffe6887,16,17,55,72,25,125,150,7,0.312409,0.331858,0.003337,0.000224,0.002273
No-Necessary7448,10,12,5,17,24,7,31,8,0.234894,0.242647,0.000415,0.000255,0.001613
ReasonableBroccoli56,27,8,20,28,14,34,48,7,0.281077,0.297568,0.00012,0.000171,0.002228
RefrigeratorOk7848,30,17,13,30,37,18,55,8,0.254367,0.265236,0.000388,0.000234,0.002479
SirCatsworthTheThird,38,10,56,66,28,203,231,7,0.31213,0.33227,0.002333,0.000301,0.001225
SlurpingDischarge,25,19,13,32,58,22,80,7,0.291254,0.3072,0.000202,0.00029,0.008187
Strict_Berry7446,34,16,31,47,32,67,99,7,0.319236,0.341431,0.001091,0.000255,0.015796
Type-APersonality,22,12,36,48,23,66,89,6,0.324288,0.347818,0.000757,0.00016,0.005871
Wismuth_Salix,18,12,9,21,54,19,73,8,0.263299,0.275039,0.000307,0.000163,0.001937
XimiraSan,10,10,62,72,19,256,275,7,0.340066,0.369909,0.000608,0.000119,0.004579
andstillthesunrises,11,12,5,17,19,5,24,8,0.24727,0.256097,0.00042,0.000137,0.002221
atinylittlebug,14,5,2,7,28,3,31,8,0.221478,0.228635,0.000011,0.000093,0.001857
ballcheese808,37,10,6,16,13,10,23,8,0.224486,0.232321,0.000056,0.000144,0.001887
bbw420x,31,14,26,40,31,131,162,7,0.290488,0.305916,0.002342,0.000345,0.001436
bibliophile222,20,14,4,18,26,6,32,8,0.245621,0.25542,0.000285,0.000165,0.001712
dummythicktransslut,15,14,119,133,18,654,672,7,0.352589,0.382831,0.003053,0.000183,0.00348
ennsea,41,11,24,35,17,56,73,8,0.273854,0.287326,0.000964,0.000283,0.001017
for-a-dreamer,10,3,2,5,21,8,29,8,0.213421,0.219304,0.000005,0.000157,0.000799
jaggsy,20,8,4,12,16,8,24,8,0.220261,0.226625,0.00016,0.000218,0.000952
lightbulb20seven,22,14,17,31,19,52,71,7,0.304983,0.323801,0.000266,0.000192,0.006991
nofallingupward,11,17,3,20,21,3,24,8,0.223886,0.231281,0.000534,0.000121,0.002495
pokemonfanj,21,7,4,11,46,12,58,8,0.242764,0.252082,0.000057,0.000141,0.002242
spoilerdudegetrekt,10,7,4,11,22,10,32,8,0.246289,0.25598,0.000015,0.000163,0.004301
stonerbaby369,12,2,10,12,2,15,17,7,0.25143,0.261474,0.000103,0.000059,0.000746
throwquestions_away,43,14,16,30,30,38,68,7,0.306448,0.325635,0.002416,0.000299,0.008654
yuejuu,26,10,6,16,24,18,42,8,0.26249,0.273601,0.000192,0.000189,0.003978
Awesomeuser90,189,58,178,236,140,919,1059,7,0.337935,0.378186,0.00963,0.001132,0.033534
-ReadingBug-,14,14,7,21,23,8,31,8,0.266333,0.283644,0.000135,0.000136,0.023533
-SOFA-KING-VOTE-,49,23,16,39,87,42,129,8,0.264452,0.283684,0.00021,0.000367,0.013204
1QAte4,29,41,12,53,48,15,63,8,0.257886,0.274773,0.000157,0.000298,0.037871
8to24,67,49,27,76,101,43,144,7,0.273507,0.295366,0.000877,0.000622,0.037793
AT_Dande,13,14,8,22,21,11,32,7,0.258756,0.274147,0.000061,0.000154,0.017322
Arthur_Edens,12,8,7,15,24,7,31,7,0.293957,0.311707,0.000235,0.000092,0.015041
Ashamed_Job_8151,10,16,10,26,21,10,31,8,0.26249,0.278862,0.000069,0.000109,0.023525
Aureliamnissan,15,5,5,10,20,14,34,8,0.276074,0.293748,0.000025,0.00013,0.008136
CellularSavant,10,7,3,10,10,4,14,7,0.253158,0.268709,0.000012,0.000075,0.010324
CharlieandtheRed,22,12,11,23,38,22,60,7,0.276952,0.29683,0.000157,0.000205,0.014033
Comfortable-Policy70,10,10,5,15,10,5,15,7,0.277904,0.297082,0.000175,0.000058,0.018915
Corellian_Browncoat,30,21,19,40,60,37,97,8,0.282603,0.304237,0.000254,0.000267,0.022596
DCBuckeye82,11,7,6,13,24,14,38,8,0.267766,0.280583,0.000155,0.000136,0.009114
DarkExecutor,12,6,5,11,16,9,25,8,0.246691,0.261158,0.000004,0.000101,0.008911
DrPlatypus1,12,6,2,8,14,4,18,9,0.223544,0.233741,0.000001,0.00007,0.007991
ERedfieldh,20,24,14,38,34,14,48,7,0.265319,0.283171,0.000302,0.000159,0.030379
Fragrant-Luck-8063,32,21,14,35,38,23,61,7,0.261913,0.279612,0.000159,0.000234,0.019812
GarbledComms,10,9,6,15,12,8,20,8,0.26252,0.278628,0.000073,0.000089,0.007474
GiantPineapple,29,32,21,53,48,25,73,7,0.279206,0.300326,0.000371,0.0003,0.028972
GoldenInfrared,11,12,5,17,20,6,26,7,0.276142,0.290478,0.000102,0.000107,0.011254
GrandMasterPuba,18,16,9,25,19,10,29,8,0.257096,0.273484,0.000079,0.000157,0.020027
H_Mc,14,12,10,22,25,14,39,7,0.282921,0.299395,0.000134,0.000181,0.010402
HeloRising,17,11,5,16,26,11,37,8,0.261113,0.277275,0.000037,0.00015,0.017663
I-Here-555,34,29,20,49,51,27,78,7,0.283683,0.305233,0.000958,0.000298,0.026111
IceNein,33,31,16,47,54,26,80,7,0.286954,0.305436,0.0005,0.000362,0.027762
Ind132,20,11,4,15,32,10,42,8,0.236674,0.24866,0.00003,0.000162,0.012826
JKlerk,133,65,43,108,191,96,287,7,0.293805,0.317516,0.002468,0.000792,0.058116
JQuilty,38,16,12,28,47,32,79,7,0.279896,0.30053,0.000671,0.000297,0.019798
JonDowd762,21,16,20,36,36,25,61,7,0.282269,0.30423,0.000154,0.000195,0.018773
JuniorFarcity,16,23,12,35,36,17,53,8,0.275252,0.294034,0.000167,0.000221,0.019508
Kedulus,14,20,2,22,29,6,35,7,0.273325,0.287918,0.000098,0.000158,0.020366
Kitchner,12,4,6,10,18,12,30,8,0.258166,0.273374,0.000008,0.000074,0.00705
Kronzypantz,117,41,88,129,129,297,426,7,0.305086,0.335498,0.002274,0.000774,0.033267
Kuramhan,45,33,22,55,77,33,110,8,0.287045,0.308126,0.000871,0.000415,0.043324
Lanracie,21,19,9,28,43,17,60,7,0.288196,0.305769,0.000379,0.000265,0.029637
LifesARiver,27,22,12,34,56,26,82,7,0.273193,0.287973,0.000277,0.000254,0.027575
MoonBatsRule,26,14,9,23,29,20,49,8,0.260992,0.276352,0.000035,0.000194,0.012548
Mountain-Resource656,13,17,10,27,27,11,38,7,0.288508,0.304302,0.000299,0.000179,0.01153
MurrayBothrard,38,21,14,35,37,17,54,7,0.269744,0.289833,0.000245,0.000236,0.021072
NoExcuses1984,20,19,19,38,27,22,49,7,0.282691,0.303806,0.000155,0.000135,0.019335
Olderscout77,10,12,13,25,35,18,53,7,0.282427,0.299539,0.000188,0.000096,0.021961
OutrageousSummer5259,13,9,5,14,20,8,28,8,0.246195,0.258151,0.000011,0.000126,0.011145
Party_Combination131,17,9,20,29,22,81,103,7,0.284306,0.307294,0.000136,0.000154,0.010427
Raichu4u,44,24,109,133,46,357,403,7,0.314623,0.347373,0.001214,0.000246,0.02115
Randolpho,20,13,7,20,38,14,52,7,0.281917,0.296454,0.0002,0.000181,0.016628
Randomn355,11,7,5,12,17,8,25,8,0.266005,0.279799,0.000635,0.000143,0.003571
RexDraco,10,5,2,7,11,4,15,8,0.236711,0.249109,0.000045,0.00006,0.010984
Riokaii,27,23,13,36,44,26,70,7,0.287939,0.309752,0.000225,0.000271,0.034748
Santosp3,41,44,17,61,92,35,127,7,0.308894,0.32985,0.001834,0.00059,0.025349
Sapriste,35,39,18,57,77,36,113,7,0.307802,0.327993,0.001722,0.000315,0.050004
ScoobiusMaximus,23,14,7,21,22,16,38,8,0.269151,0.287962,0.000023,0.000152,0.020523
SenoraRaton,10,10,9,19,20,11,31,7,0.278057,0.29558,0.000266,0.000096,0.013719
Serious-Top7925,11,11,8,19,17,13,30,7,0.257359,0.275225,0.000024,0.000112,0.013707
Significant-Cancel70,52,22,16,38,52,37,89,7,0.295087,0.318588,0.000695,0.000259,0.029699
SpoofedFinger,20,19,7,26,39,11,50,8,0.243665,0.256682,0.00009,0.000174,0.026204
The-Polite-Pervert,22,18,11,29,52,21,73,8,0.262718,0.279788,0.000164,0.000375,0.017758
ThePensiveE,14,16,5,21,29,8,37,7,0.274435,0.291049,0.000129,0.000114,0.023534
TheTrueMilo,22,23,17,40,30,20,50,8,0.285399,0.306103,0.000202,0.000179,0.026209
The_Law_of_Pizza,88,66,31,97,127,47,174,7,0.308452,0.331556,0.003393,0.000861,0.040383
ThemesOfMurderBears,16,19,17,36,27,22,49,7,0.268863,0.289236,0.000313,0.000133,0.029685
Tired8281,19,6,5,11,24,16,40,8,0.262566,0.27992,0.000045,0.000136,0.009247
Vast-Information4565,15,6,8,14,11,16,27,8,0.255702,0.269949,0.000076,0.000141,0.0048
VodkaBeatsCube,225,60,49,109,402,256,658,7,0.304409,0.332094,0.002563,0.002006,0.055435
WavesAndSaves,97,62,134,196,139,436,575,7,0.321913,0.356744,0.004861,0.000805,0.045442
Wetness_Pensive,12,19,12,31,24,13,37,7,0.28248,0.303557,0.000155,0.000146,0.021023
ZorbaTHut,21,6,4,10,27,9,36,8,0.250415,0.262626,0.000015,0.000097,0.011472
airbear13,14,9,6,15,22,8,30,8,0.272914,0.290693,0.000095,0.000104,0.01125
barchueetadonai,10,13,13,26,26,19,45,7,0.263268,0.280153,0.000164,0.000132,0.020608
betty_white_bread,29,11,18,29,65,29,94,8,0.267893,0.287346,0.000126,0.000186,0.010337
bigdon802,44,19,17,36,88,42,130,7,0.309189,0.332736,0.001166,0.000355,0.026678
bleahdeebleah,16,12,11,23,25,17,42,8,0.275353,0.295867,0.000426,0.000198,0.015885
bruce_cockburn,11,7,6,13,14,13,27,8,0.256383,0.272524,0.000009,0.00013,0.009475
calguy1955,18,17,6,23,26,6,32,8,0.275755,0.293559,0.000134,0.000151,0.018507
callmejay,14,11,7,18,17,10,27,7,0.285922,0.300292,0.000097,0.000099,0.009975
chiaboy,51,25,16,41,99,48,147,7,0.298255,0.316468,0.00079,0.00045,0.025454
cowboyjosh2010,11,9,2,11,18,4,22,8,0.23717,0.249924,0.00001,0.00009,0.0152
curien,35,26,14,40,68,35,103,7,0.296692,0.315791,0.000868,0.000315,0.029554
davethompson413,11,11,5,16,18,8,26,8,0.249326,0.263881,0.00005,0.000175,0.008104
ddoyen,12,8,5,13,27,12,39,8,0.27229,0.289758,0.000021,0.00016,0.010395
digbyforever,17,28,13,41,34,13,47,7,0.30339,0.323402,0.000978,0.000217,0.024324
eggoed,17,12,6,18,27,9,36,8,0.249931,0.261016,0.000081,0.000162,0.011199
epsilona01,80,35,27,62,106,64,170,8,0.275839,0.29843,0.000885,0.00059,0.03143
etoneishayeuisky,29,13,7,20,62,28,90,7,0.270663,0.286667,0.00013,0.000225,0.022295
flat6NA,16,11,7,18,27,12,39,8,0.260093,0.276431,0.000104,0.000141,0.01438
gregaustex,13,20,5,25,25,5,30,8,0.267497,0.286066,0.000419,0.000363,0.021087
hblask,28,11,6,17,51,18,69,7,0.254538,0.270111,0.00002,0.000254,0.014473
jetpacksforall,71,37,38,75,110,76,186,7,0.287483,0.312617,0.000835,0.000544,0.035398
jfchops3,44,33,34,67,54,43,97,7,0.307656,0.332173,0.001761,0.000365,0.028035
jmnugent,20,13,8,21,20,13,33,7,0.252171,0.264522,0.000185,0.000138,0.010324
jmtrader2,10,14,7,21,18,8,26,8,0.250886,0.265583,0.000035,0.000125,0.014618
kormer,27,21,17,38,42,20,62,8,0.276007,0.297074,0.000162,0.000208,0.023986
l1qq,24,27,10,37,48,14,62,8,0.252242,0.26569,0.000142,0.000277,0.02887
lafigatatia,10,3,4,7,3,4,7,8,0.254238,0.269192,0.000658,0.000049,0.003152
luminatimids,14,9,4,13,24,10,34,7,0.251025,0.26692,0.000018,0.000108,0.017746
mcgunner1966,32,18,12,30,63,28,91,7,0.269263,0.287591,0.00013,0.000294,0.021792
morrison4371,10,7,7,14,14,7,21,7,0.253654,0.269272,0.000007,0.000048,0.01904
mycall,10,12,6,18,12,7,19,8,0.242257,0.255106,0.000019,0.00008,0.021747
nanoatzin,16,14,6,20,35,11,46,8,0.262886,0.279507,0.000034,0.000162,0.0196
nylockian,11,8,3,11,15,7,22,8,0.234639,0.246223,0.000003,0.000106,0.011935
ptmd,27,8,9,17,49,26,75,7,0.265242,0.28348,0.000104,0.000273,0.007621
reasonably_plausible,19,15,11,26,19,13,32,7,0.274086,0.292382,0.000324,0.00013,0.021061
rollingrock16,24,9,6,15,44,25,69,7,0.296867,0.314763,0.000132,0.000144,0.013449
satyrday12,46,37,25,62,55,33,88,7,0.279551,0.298899,0.000554,0.000316,0.03489
semideclared,51,23,25,48,98,54,152,8,0.264128,0.282664,0.000319,0.000399,0.026274
siberianmi,26,24,12,36,55,19,74,7,0.278023,0.297892,0.000216,0.000323,0.023898
socialistrob,28,15,18,33,28,20,48,7,0.268385,0.288386,0.00006,0.00013,0.018937
the_calibre_cat,60,31,43,74,85,76,161,7,0.299974,0.324438,0.0015,0.000407,0.034147
theresourcefulKman,13,7,2,9,17,7,24,9,0.222687,0.233537,0.000007,0.000142,0.011258
ttown2011,99,55,35,90,135,67,202,7,0.291855,0.314971,0.001476,0.00082,0.044556
yo2sense,21,10,8,18,34,21,55,8,0.254596,0.269617,0.000047,0.000188,0.013916
Axlerodriguez,20,12,28,40,16,40,56,6,0.319596,0.340958,0.000578,0.000163,0.005682
ChirpyRaven,49,38,15,53,74,33,107,7,0.285489,0.301061,0.000431,0.000452,0.021564
EdelgardSexHaver,23,25,13,38,43,17,60,7,0.292458,0.307703,0.000574,0.000214,0.015265
GoldenEagle828677,26,13,7,20,37,21,58,7,0.262947,0.276645,0.000065,0.000194,0.016612
Imadevilsadvocater,60,56,48,104,145,81,226,6,0.354243,0.381129,0.004651,0.000565,0.039899
Orphan_Guy_Incognito,27,24,15,39,64,22,86,7,0.297745,0.316106,0.000433,0.000344,0.015738
Starfleet-Time-Lord,13,15,7,22,27,10,37,7,0.263774,0.276186,0.000089,0.000207,0.007079
c0i9z,85,45,39,84,169,93,262,7,0.323685,0.349371,0.001632,0.000647,0.033077
couldbemage,13,22,29,51,51,38,89,6,0.313947,0.334268,0.000705,0.000195,0.018245
deep_sea2,39,33,20,53,68,34,102,7,0.318137,0.338601,0.001225,0.000385,0.01804
orangutanDOTorg,11,8,4,12,8,4,12,8,0.230566,0.238533,0.000092,0.000056,0.001337
vuzz33,30,7,8,15,69,38,107,7,0.286138,0.302415,0.00003,0.000304,0.004635
zyrkseas97,16,15,8,23,34,16,50,7,0.30101,0.318562,0.000333,0.000164,0.012291
Ay_respiracion,17,1,12,13,7,26,33,7,0.255702,0.264921,0.000133,0.000083,0.000001
ExtendedMacaroni,11,7,2,9,16,5,21,7,0.269985,0.280988,0.000129,0.000103,0.001634
MikrokosmicUnicorn,11,7,10,17,9,22,31,7,0.267735,0.279144,0.000607,0.000118,0.000825
boringexplanation,11,15,7,22,19,9,28,8,0.265428,0.278613,0.001189,0.000154,0.013667
B-RapShoeStrap,11,9,9,18,14,16,30,7,0.273722,0.285918,0.000434,0.000177,0.000683
Choperello,39,29,20,49,87,49,136,7,0.313447,0.333361,0.001654,0.000401,0.019864
NoTomato7740,19,16,7,23,35,12,47,7,0.284861,0.297951,0.000324,0.000132,0.010789
OkCluejay172,13,11,7,18,12,8,20,8,0.253413,0.2635,0.000224,0.000118,0.001605
BB_Nips,10,4,11,15,6,18,24,7,0.301471,0.321901,0.000073,0.000071,0.002848
BeatSteady,20,5,2,7,37,16,53,8,0.230378,0.239206,0.000012,0.000191,0.009317
JunktownRoller,10,8,5,13,21,7,28,7,0.256513,0.26828,0.000032,0.000084,0.011362
Subtleiaint,17,9,12,21,23,25,48,7,0.308767,0.329783,0.000119,0.000133,0.00729
TanStewyBeinTanStewy,36,21,11,32,66,32,98,7,0.279602,0.293677,0.000361,0.00027,0.019106
BECSP-TEB,31,17,19,36,50,30,80,7,0.312668,0.332278,0.00124,0.000245,0.013441
LucidLeviathan,42,27,18,45,99,42,141,7,0.291029,0.308441,0.000359,0.000403,0.018131
scrambledhelix,37,17,12,29,88,37,125,7,0.274651,0.288338,0.000348,0.000298,0.015029
Babygall99,10,2,4,6,3,5,8,8,0.249821,0.260024,0.000014,0.000037,0.000249
Ok_Requirement_3116,13,15,2,17,20,2,22,10,0.173658,0.176962,0.000051,0.00009,0.003981
ATXoxoxo,15,22,7,29,41,13,54,7,0.278691,0.293157,0.000197,0.000274,0.008048
Alethia_23,13,8,8,16,19,11,30,7,0.275436,0.291386,0.000141,0.000122,0.009607
AppropriateScience9,14,12,8,20,36,17,53,8,0.272798,0.287449,0.000047,0.000166,0.013655
Bonesquire,11,9,14,23,26,16,42,7,0.285453,0.300172,0.000179,0.000102,0.004693
Bradybigboss,34,23,111,134,46,959,1005,6,0.353276,0.384743,0.004269,0.00039,0.009796
BurningEmbers978,24,10,5,15,48,8,56,8,0.247757,0.257802,0.000059,0.000105,0.01641
Chinohito,10,7,5,12,25,10,35,7,0.273111,0.287722,0.000042,0.000164,0.006801
Dazzling_Instance_57,43,26,23,49,106,41,147,7,0.294857,0.312353,0.000765,0.000424,0.026679
Didntlikedefaultname,29,19,5,24,45,18,63,7,0.256761,0.266794,0.000118,0.000245,0.015936
EDRootsMusic,16,12,9,21,28,14,42,7,0.279292,0.293501,0.00013,0.000143,0.010685
EvilBubblePopper,51,18,17,35,51,45,96,7,0.317802,0.339248,0.000787,0.000331,0.008572
JSmith666,20,21,11,32,31,18,49,7,0.289559,0.303335,0.000632,0.000202,0.014211
JimDee01,27,14,7,21,45,12,57,8,0.262536,0.276856,0.000099,0.000146,0.023173
JoJoeyJoJo,33,15,9,24,54,12,66,7,0.288563,0.304423,0.000134,0.000174,0.010253
No-Field3266,16,5,6,11,33,10,43,7,0.261429,0.27307,0.000018,0.000107,0.004559
Reaverion,11,6,5,11,31,17,48,8,0.266005,0.278515,0.000243,0.000227,0.006491
Regarded-Illya,19,10,8,18,39,20,59,7,0.276142,0.290875,0.00006,0.000196,0.006672
Salty_Map_9085,24,16,11,27,29,18,47,7,0.289485,0.304461,0.000674,0.00019,0.011654
Sufficient-Bat-5035,14,18,2,20,27,2,29,8,0.262947,0.27628,0.000089,0.000076,0.025308
TacoBelle2176,11,7,4,11,26,11,37,7,0.277207,0.291806,0.000051,0.000115,0.008969
TellItLikeItIs1994,13,12,8,20,25,9,34,7,0.274053,0.287253,0.000128,0.000098,0.01757
VeganKiwiGuy,41,30,24,54,96,43,139,7,0.30751,0.327659,0.000725,0.000346,0.023633
ancientmarin_,34,23,21,44,49,40,89,8,0.281182,0.297796,0.000613,0.000316,0.012212
anewaccount69420,20,18,8,26,29,8,37,7,0.287556,0.30519,0.001419,0.000144,0.018861
chaucer345,182,67,135,202,190,672,862,7,0.358932,0.398085,0.011066,0.001393,0.037167
crawling-alreadygirl,54,24,21,45,90,42,132,7,0.295646,0.314563,0.000845,0.000352,0.014618
dickpierce69,88,40,12,52,177,68,245,7,0.288895,0.306253,0.000911,0.000747,0.032964
harpyprincess,14,10,5,15,21,14,35,8,0.252017,0.263511,0.000052,0.000176,0.008488
iodfuse,19,15,9,24,45,19,64,7,0.278143,0.292255,0.000154,0.000197,0.013406
isocher,14,7,6,13,34,9,43,7,0.260123,0.271085,0.000039,0.000098,0.006372
joet889,15,5,3,8,10,4,14,8,0.256863,0.267936,0.000009,0.000067,0.003684
jwrig,62,35,26,61,113,63,176,7,0.317891,0.339337,0.00136,0.000516,0.029838
my-two-centses,31,28,17,45,86,33,119,7,0.308662,0.329054,0.000561,0.000312,0.02806
pcgamernum1234,41,17,9,26,91,41,132,7,0.283452,0.299258,0.000242,0.000501,0.019602
rainystast,13,10,6,16,29,15,44,7,0.267956,0.282073,0.000114,0.000161,0.013246
rollingForInitiative,12,14,7,21,26,10,36,7,0.281882,0.296935,0.000162,0.000113,0.013319
sandwiches_are_real,11,7,5,12,29,12,41,7,0.267166,0.279497,0.000081,0.000192,0.002984
sourcreamus,55,27,20,47,94,37,131,7,0.309147,0.330259,0.001022,0.000352,0.025859
spiral8888,18,12,7,19,29,13,42,7,0.291723,0.308709,0.000437,0.00017,0.015735
ultradav24,36,27,39,66,72,61,133,7,0.336004,0.362842,0.001788,0.000217,0.027316
DanforthWhitcomb_,149,55,64,119,151,120,271,7,0.305931,0.333948,0.003625,0.000821,0.043835
ItsAGoodDay,10,6,3,9,11,5,16,8,0.240495,0.250883,0.000011,0.000093,0.006472
Sarlax,22,13,10,23,39,27,66,8,0.273804,0.293509,0.000098,0.000227,0.014653
WingerRules,29,24,21,45,34,26,60,7,0.287337,0.309135,0.000241,0.000252,0.023992
Balarian,18,7,15,22,12,36,48,7,0.308788,0.329599,0.000071,0.00011,0.005479
BarneyLaurance,31,10,14,24,27,40,67,7,0.306926,0.326344,0.000319,0.000285,0.00267
Adequate_Images,13,12,7,19,22,14,36,7,0.2898,0.304168,0.00023,0.000123,0.011263
Devourerofworlds_69,15,16,7,23,26,10,36,7,0.283027,0.296573,0.000147,0.000136,0.009973
Potential_Being_7226,15,13,5,18,26,10,36,7,0.273193,0.285839,0.00003,0.000189,0.005205
djbuu,15,5,3,8,18,12,30,7,0.25631,0.267296,0.000013,0.000141,0.001725
BarryKentJr,10,2,6,8,8,14,22,7,0.273738,0.285496,0.000039,0.000142,0.000085
CinderrUwU,46,31,6,37,38,7,45,7,0.27402,0.286354,0.000899,0.000411,0.004259
RunnyDischarge,30,10,11,21,40,27,67,8,0.26382,0.275933,0.00059,0.000265,0.000506
SupaSaiyajin4,31,7,10,17,11,16,27,8,0.241792,0.251562,0.000333,0.000132,0.000348
ottoandinga88,36,20,4,24,37,16,53,7,0.276378,0.288815,0.000872,0.000263,0.009677
Basic_Cockroach_9545,32,13,18,31,28,35,63,7,0.308473,0.326509,0.000565,0.000255,0.006172
OrganicFall5526,13,9,15,24,11,31,42,7,0.302518,0.32145,0.000197,0.000112,0.004052
Basic_Mobile2792,26,11,12,23,21,27,48,7,0.30751,0.327477,0.000314,0.000185,0.008932
HiddenThinks,22,6,4,10,22,19,41,7,0.242452,0.251817,0.000122,0.000239,0.001199
ProRuckus,17,11,4,15,27,11,38,7,0.278502,0.292364,0.000052,0.000135,0.00588
Basnap,28,11,18,29,19,43,62,7,0.321434,0.34389,0.000688,0.000173,0.009022
DMTwolf,37,17,15,32,57,42,99,7,0.315874,0.336706,0.000337,0.00026,0.016845
Icy_River_8259,105,43,26,69,202,93,295,7,0.317046,0.339253,0.001288,0.000847,0.023317
dinjamora,16,9,7,16,26,16,42,7,0.266036,0.278812,0.000042,0.000162,0.003654
parsonsrazersupport,31,24,19,43,68,35,103,7,0.299954,0.317279,0.00063,0.000405,0.010666
unseemly_turbidity,13,5,3,8,22,7,29,8,0.250831,0.2599,0.000079,0.000184,0.001214
Battlefeather,10,15,60,75,15,194,209,6,0.331261,0.357842,0.001354,0.000158,0.006296
A_Duck_Using_Reddit,29,19,12,31,58,19,77,7,0.286627,0.300654,0.000283,0.000268,0.012081
BigbunnyATK,13,6,3,9,30,7,37,7,0.253017,0.262621,0.000026,0.000104,0.004598
Chemical_Series6082,22,14,11,25,41,27,68,7,0.290824,0.306816,0.000221,0.000229,0.010264
Dakk85,26,21,18,39,68,25,93,7,0.305477,0.323586,0.001065,0.000246,0.012513
DevelopmentSad2303,13,8,7,15,23,13,36,7,0.277563,0.290242,0.000078,0.000128,0.006949
FearlessResource9785,100,37,19,56,139,54,193,7,0.310354,0.330706,0.001123,0.0007,0.018829
Jaymac720,11,13,1,14,15,2,17,9,0.184767,0.188562,0.00006,0.00028,0.003196
LewisCarroll95,66,20,91,111,58,226,284,7,0.326015,0.353342,0.002715,0.000557,0.010938
Meii345,37,21,17,38,63,25,88,7,0.311143,0.330559,0.000631,0.000216,0.015604
Message_10,12,12,9,21,18,11,29,7,0.285723,0.301075,0.000114,0.000115,0.006648
NegevThunderstorm,73,34,21,55,179,79,258,7,0.307072,0.326817,0.001118,0.000702,0.031583
Objective-District39,20,18,12,30,44,22,66,7,0.278126,0.293264,0.000156,0.000207,0.012938
Pastadseven,23,12,6,18,50,20,70,8,0.266631,0.281396,0.000088,0.000335,0.011928
ProfessionalTap2400,59,24,61,85,56,182,238,6,0.331528,0.357956,0.00127,0.000402,0.011293
RaskyBukowski,44,35,34,69,57,57,114,6,0.342328,0.368573,0.003059,0.000306,0.030049
RecycledPanOil,14,7,4,11,18,12,30,8,0.254925,0.267014,0.000054,0.000113,0.002926
Rude_Lengthiness_101,10,6,6,12,14,11,25,7,0.272667,0.286206,0.000042,0.00013,0.002655
Slackjawed_Horror,37,24,25,49,90,48,138,7,0.314099,0.335523,0.001058,0.000366,0.01958
_phish_,12,6,1,7,6,1,7,8,0.236885,0.245467,0.000008,0.000041,0.009958
amonkus,13,12,9,21,26,16,42,7,0.279637,0.292618,0.000256,0.00012,0.010748
ethical_arsonist,12,6,4,10,26,8,34,7,0.270162,0.282355,0.000015,0.000104,0.007031
lalahair,108,63,58,121,135,167,302,6,0.336578,0.363726,0.004556,0.000774,0.038852
lordnacho666,12,14,6,20,21,10,31,7,0.279983,0.294253,0.000076,0.000123,0.01097
monkeysky,15,9,5,14,26,11,37,7,0.264005,0.277901,0.0001,0.000149,0.007414
snotick,36,7,5,12,66,28,94,7,0.263207,0.275893,0.000034,0.000282,0.003575
svdomer09,13,7,6,13,24,10,34,7,0.273722,0.286941,0.000047,0.000143,0.007622
Beautiful-Blood-8712,16,4,15,19,6,21,27,7,0.304655,0.323731,0.000065,0.000081,0.003172
Accomplished-Park480,12,12,3,15,20,8,28,8,0.25227,0.26336,0.000022,0.000111,0.0056
EasternHo,19,11,7,18,24,11,35,7,0.275873,0.290132,0.000039,0.000112,0.00865
bradlap,12,19,8,27,31,9,40,7,0.281234,0.295936,0.000223,0.000178,0.018258
Beautiful-Fold-3234,13,6,14,20,8,26,34,7,0.313491,0.334151,0.0002,0.000102,0.005202
Bedevyr,11,3,11,14,10,33,43,7,0.301471,0.319387,0.000071,0.000094,0.002658
yelling_at_moon,18,12,9,21,32,21,53,7,0.297042,0.315336,0.000116,0.000155,0.00976
Big-Progress3280,13,8,17,25,11,36,47,7,0.307301,0.327701,0.000141,0.000119,0.003316
Big_Mek_Orkimedes,10,9,8,17,28,15,43,7,0.281619,0.297129,0.000068,0.000132,0.006261
DoeCommaJohn,27,39,13,52,61,14,75,7,0.2886,0.304927,0.000692,0.000424,0.016805
Live_Background_3455,18,24,13,37,48,20,68,7,0.281043,0.297021,0.000255,0.000263,0.014019
BigBandit01,13,4,16,20,9,28,37,7,0.30443,0.324561,0.000111,0.000113,0.003298
CaptainONaps,13,13,4,17,20,6,26,7,0.264637,0.278325,0.000052,0.000137,0.006433
InThreeWordsTheySaid,10,9,6,15,11,10,21,7,0.264267,0.276481,0.000035,0.000117,0.002916
JuicingPickle,15,9,6,15,21,10,31,7,0.294129,0.311837,0.000098,0.000103,0.0079
PrimaryInjurious,53,33,27,60,101,45,146,7,0.318406,0.340202,0.000944,0.000439,0.019979
RedMarsRepublic,10,10,3,13,16,4,20,7,0.267972,0.280378,0.00003,0.000096,0.006794
Big_Sea_5912,37,10,64,74,15,182,197,7,0.332623,0.359239,0.000824,0.000137,0.006475
AtmosphericReverbMan,13,16,11,27,45,13,58,7,0.286102,0.301958,0.000259,0.000138,0.018524
Aware-Computer4550,22,18,7,25,40,14,54,7,0.278742,0.293019,0.000591,0.000195,0.010223
Brilliant-Lab546,12,13,7,20,28,7,35,7,0.301351,0.317584,0.000199,0.000133,0.015495
CaliMassNC,11,6,4,10,15,11,26,8,0.254954,0.265553,0.000019,0.000161,0.003996
Evilsushione,16,13,9,22,36,12,48,7,0.288747,0.303298,0.000169,0.000222,0.01082
GrowFreeFood,22,21,16,37,44,29,73,7,0.289319,0.306583,0.00065,0.000249,0.019128
LifeofTino,11,10,5,15,19,5,24,7,0.314995,0.335433,0.000208,0.000086,0.016963
PlusAd4034,14,5,3,8,23,7,30,8,0.24826,0.259096,0.00001,0.000107,0.00426
Successful-Crazy-126,12,13,2,15,19,3,22,8,0.256775,0.265812,0.000306,0.000065,0.014446
Successful-Silver485,10,4,3,7,25,13,38,7,0.2486,0.258644,0.000007,0.00012,0.002752
TurnYourHeadNCough,12,5,4,9,19,9,28,7,0.272683,0.28628,0.000019,0.000117,0.003292
airboRN_82,140,33,27,60,172,120,292,7,0.332209,0.353973,0.001727,0.000604,0.030279
cairnrock1,11,6,3,9,23,3,26,8,0.232698,0.24112,0.000007,0.000089,0.007371
deepstaterecords,14,9,9,18,43,15,58,8,0.277308,0.294865,0.00013,0.000234,0.006964
dowker1,29,14,9,23,31,15,46,7,0.278622,0.291325,0.000713,0.000174,0.012786
ertri,10,9,5,14,23,6,29,7,0.261083,0.271267,0.00043,0.000302,0.003076
iamcleek,20,16,5,21,41,10,51,8,0.256484,0.26869,0.000073,0.000226,0.008513
martco17,73,44,109,153,79,339,418,6,0.354909,0.388128,0.005143,0.000481,0.032166
revertbritestoan,21,14,10,24,32,13,45,7,0.290488,0.305692,0.000077,0.000095,0.013494
rzelln,11,6,7,13,11,7,18,8,0.266474,0.281945,0.000068,0.000081,0.006976
shthappens03250322,11,21,7,28,26,9,35,7,0.291254,0.308917,0.000872,0.000134,0.026691
stevie-antelope,14,12,5,17,30,16,46,7,0.265009,0.279219,0.000083,0.00013,0.011796
washingtonu,18,13,11,24,36,22,58,7,0.306884,0.325917,0.000566,0.000178,0.015086
Big_Trash_7504,41,2,6,8,3,28,31,7,0.21242,0.217626,0.00017,0.0001,0
BeforeAndAfterMeme,11,4,2,6,9,3,12,7,0.199982,0.204503,0.000755,0.000067,0.000139
Dull_Banana1377,15,3,2,5,3,2,5,9,0.175183,0.180058,0.000039,0.000084,0.000002
No_Lynx1343,18,5,1,6,7,1,8,8,0.173538,0.176384,0.000099,0.000138,0.000021
nothanks1312,15,5,3,8,17,5,22,7,0.220572,0.226116,0.000434,0.000169,0.000073
BitFiesty,11,4,31,35,4,58,62,7,0.285381,0.301425,0.000545,0.000078,0.000265
ChemicalCat4181,11,14,7,21,20,8,28,7,0.262368,0.271035,0.00082,0.000199,0.002127
DosZappos,11,10,7,17,20,12,32,8,0.247595,0.257365,0.00038,0.000321,0.001047
ElGranJerkador,10,9,3,12,12,4,16,8,0.23361,0.242013,0.000058,0.000134,0.001178
Hambredd,28,17,11,28,29,13,42,8,0.249408,0.260153,0.000348,0.00029,0.001167
HeadGuide4388,14,15,7,22,17,7,24,7,0.248723,0.257336,0.000297,0.000159,0.00367
K9WorkingDog,45,8,8,16,45,20,65,8,0.248723,0.259975,0.000491,0.000201,0.000712
Kimolainen83,13,14,5,19,28,6,34,8,0.243455,0.252659,0.000382,0.00014,0.002944
TegridyPharmz,28,12,4,16,26,11,37,9,0.215986,0.222238,0.000156,0.000235,0.001373
Trinikas,17,42,7,49,47,8,55,7,0.2939,0.308901,0.001537,0.000183,0.028756
adviceforthrowawayy,26,14,6,20,30,8,38,7,0.274768,0.286758,0.000453,0.000148,0.006146
alphamalejackhammer,24,5,14,19,14,77,91,7,0.275973,0.288604,0.000453,0.00021,0.000125
baddecision116,22,7,2,9,28,11,39,8,0.227737,0.234649,0.000032,0.000263,0.00067
clutzyninja,44,27,18,45,49,30,79,7,0.263146,0.275207,0.001459,0.000556,0.002643
duskfinger67,51,28,24,52,72,54,126,7,0.314514,0.335328,0.001489,0.000369,0.013073
gitismatt,12,12,6,18,19,7,26,8,0.226677,0.234825,0.000212,0.000258,0.001108
joelene1892,13,7,3,10,11,4,15,8,0.236366,0.244393,0.000099,0.000112,0.001615
the_urban_juror,12,3,3,6,15,5,20,9,0.200124,0.205618,0.000008,0.000105,0.000091
vicente8a,13,7,4,11,16,6,22,8,0.26249,0.273165,0.000263,0.000104,0.005411
Bitter-Sherbert1607,15,8,24,32,14,52,66,7,0.320229,0.339282,0.00033,0.000127,0.005271
Bilbo332,12,5,3,8,17,4,21,8,0.251919,0.262354,0.000013,0.000067,0.008138
Just_Nefariousness55,12,18,8,26,29,15,44,7,0.268242,0.281542,0.000099,0.00015,0.023081
Severe_Appointment93,25,15,23,38,20,77,97,7,0.327951,0.351658,0.000728,0.000217,0.011842
blade740,19,9,5,14,27,19,46,7,0.256848,0.268792,0.000035,0.000245,0.005931
poop_drunk,10,14,6,20,21,10,31,8,0.259423,0.272325,0.000092,0.000152,0.010852
stewshi,26,16,8,24,37,13,50,7,0.29478,0.312158,0.000372,0.000164,0.020308
xfvh,23,16,9,25,37,22,59,7,0.269359,0.283552,0.00017,0.000242,0.009893
Blackbird01661,11,4,13,17,4,17,21,8,0.212499,0.220976,0.000133,0.000103,0.000004
Alternative-Redditer,23,13,10,23,25,16,41,8,0.219396,0.227727,0.001323,0.000337,0.000223
Fun-Bread-8560,12,10,2,12,13,4,17,9,0.209385,0.215114,0.000064,0.000112,0.00016
Impossible_Rain_4727,10,5,2,7,7,3,10,9,0.184143,0.189161,0.000021,0.000117,0.000012
KathrynTheGreat,17,4,5,9,26,14,40,8,0.224452,0.232744,0.000323,0.00017,0.000096
Living-Assumption272,16,12,0,12,13,0,13,0,0,0,0,0.000152,0.000178
Only-Breadfruit-6108,27,18,2,20,20,3,23,9,0.195696,0.200222,0.000074,0.000248,0.000442
West_House_2085,49,19,11,30,38,20,58,8,0.21673,0.227199,0.000616,0.000323,0.00019
oliviamrow,26,10,6,16,16,11,27,8,0.205808,0.213548,0.00026,0.000241,0.000112
Blackelvis2000,11,2,16,18,6,23,29,8,0.260542,0.271348,0.000051,0.000065,0.000104
Nuckin-Futz666,11,7,3,10,11,3,14,8,0.215461,0.222026,0.000033,0.000153,0.000206
Riceowls29,41,10,7,17,53,45,98,7,0.285525,0.300722,0.000408,0.000183,0.007679
StalkMeNowCrazyLady,15,9,6,15,9,6,15,8,0.243927,0.253187,0.000295,0.00012,0.001533
Substandard_eng2468,13,9,4,13,13,7,20,8,0.241973,0.249309,0.000075,0.000101,0.001195
BlazeTheSkeleton,40,2,11,13,5,26,31,8,0.260467,0.271388,0.000117,0.000139,0.000063
Alive_Ice7937,20,19,8,27,32,10,42,7,0.310972,0.32903,0.000673,0.000161,0.018477
AzSumTuk6891,35,24,13,37,47,21,68,7,0.269391,0.281549,0.001443,0.000435,0.002732
ExismykindaParte,25,18,7,25,47,11,58,8,0.252129,0.2627,0.000839,0.000215,0.002533
Unfair_Finger5531,16,7,7,14,24,8,32,7,0.241174,0.250253,0.000271,0.000116,0.001006
notmenotwhenitsyou,14,6,2,8,8,2,10,9,0.200691,0.206184,0.00005,0.000205,0.000099
yvrelna,10,9,4,13,11,5,16,8,0.253442,0.26181,0.000058,0.000118,0.000862
Blonde_Icon,22,8,24,32,22,55,77,7,0.303552,0.320505,0.001301,0.000178,0.003094
DMVlooker,21,14,4,18,32,10,42,8,0.255198,0.265834,0.000065,0.0002,0.01362
Fletcher-wordy,63,26,34,60,47,56,103,7,0.324218,0.348902,0.001207,0.000236,0.023003
ItsFreeRight,24,7,25,32,10,55,65,8,0.262171,0.275755,0.00066,0.000147,0.000422
Over-Tiger-8818,12,12,8,20,17,8,25,7,0.275487,0.286063,0.000771,0.000159,0.003267
Scared_Ad2563,14,6,2,8,10,2,12,9,0.2158,0.222025,0.000208,0.000063,0.000585
Shalrak,12,12,6,18,18,8,26,7,0.298432,0.315126,0.000131,0.000125,0.008685
TheYankunian,24,11,9,20,45,16,61,8,0.250332,0.261085,0.000329,0.000208,0.001391
keIIzzz,13,15,5,20,21,7,28,8,0.25401,0.263944,0.000229,0.000122,0.002763
kickintheball,36,14,8,22,55,9,64,8,0.261384,0.273623,0.000675,0.000224,0.001458
slo1111,26,15,14,29,54,27,81,7,0.315214,0.334771,0.001614,0.000285,0.013711
uktabilizard,12,13,9,22,16,20,36,7,0.2958,0.3125,0.000139,0.0001,0.014145
wildOldcheesecake,28,15,12,27,38,21,59,8,0.237631,0.248277,0.000468,0.000292,0.001275
BlueEyedWalrus84,11,2,8,10,2,37,39,8,0.261429,0.270835,0.000079,0.000063,0.000012
-dag-,13,10,7,17,18,13,31,7,0.273309,0.288444,0.000222,0.000148,0.016034
0WatcherintheWater0,22,18,14,32,43,21,64,7,0.297804,0.317007,0.000714,0.000202,0.020389
AmigoDelDiabla,21,14,12,26,22,17,39,8,0.266553,0.285898,0.000159,0.000173,0.01503
BitterFuture,134,45,51,96,160,136,296,7,0.286991,0.313301,0.001645,0.000936,0.029677
BotElMago,81,27,21,48,163,64,227,7,0.287921,0.309336,0.000544,0.00071,0.020633
BrainDamage2029,27,25,18,43,37,23,60,7,0.274718,0.294484,0.000255,0.000326,0.01827
Brickscratcher,35,22,24,46,69,58,127,7,0.299517,0.32005,0.001062,0.000363,0.019818
Davec433,21,10,2,12,17,5,22,9,0.21232,0.220757,0.000011,0.00016,0.00607
DeadlySpacePotatoes,11,5,5,10,9,11,20,7,0.257578,0.273367,0.000033,0.000111,0.004515
Delanorix,49,27,14,41,83,27,110,7,0.303471,0.324125,0.001597,0.000337,0.027376
Done327,13,11,3,14,13,3,16,8,0.220765,0.230308,0.000019,0.000098,0.020837
FreeStall42,23,14,14,28,26,19,45,8,0.249408,0.263703,0.000165,0.000176,0.021426
FreedomPocket,29,7,8,15,31,31,62,8,0.255126,0.269072,0.000021,0.000196,0.007253
GabuEx,15,20,5,25,26,5,31,7,0.298451,0.314225,0.000875,0.000155,0.022724
Gr8daze,15,4,2,6,18,15,33,8,0.260812,0.275972,0.000006,0.000136,0.01217
GuyInAChair,41,25,15,40,77,43,120,7,0.259512,0.27489,0.000569,0.000468,0.025461
Inevitable-Ad-9570,15,11,9,20,24,16,40,7,0.254381,0.265363,0.000293,0.000163,0.007308
ItsMichaelScott25,14,13,8,21,30,17,47,7,0.261203,0.277887,0.000041,0.000147,0.022357
JDogg126,33,24,15,39,45,19,64,8,0.24989,0.266059,0.00012,0.000315,0.020094
KevinCarbonara,130,49,51,100,162,120,282,8,0.287738,0.309955,0.001881,0.000843,0.038174
Leopold_Darkworth,19,23,13,36,30,14,44,7,0.267182,0.286877,0.000214,0.000208,0.022795
Mjolnir2000,10,14,7,21,18,7,25,7,0.260737,0.274761,0.000091,0.000135,0.016575
NoAttitude1000,43,16,12,28,80,56,136,7,0.27193,0.290957,0.000168,0.000261,0.020699
PoliticalJunkDrawer,12,9,5,14,15,5,20,7,0.255861,0.271962,0.000016,0.000115,0.0061
Positronic_Matrix,14,7,5,12,13,8,21,8,0.229898,0.241337,0.000008,0.000091,0.008432
Savethecannolis,11,10,14,24,14,15,29,8,0.260887,0.278971,0.000048,0.000093,0.01641
SchuminWeb,16,13,15,28,20,18,38,7,0.261263,0.27885,0.000084,0.000098,0.022547
SlowMotionSprint,18,23,15,38,38,21,59,8,0.269359,0.288564,0.000234,0.000236,0.024915
SparksFly55,55,49,44,93,80,49,129,7,0.288123,0.314319,0.001168,0.000431,0.032614
Tadpoleonicwars,27,9,5,14,11,7,18,8,0.267182,0.282623,0.000037,0.000093,0.00991
TheOvy,21,20,4,24,24,4,28,8,0.248328,0.262028,0.000026,0.00012,0.027467
The_Awful-Truth,19,9,46,55,12,83,95,7,0.279292,0.303084,0.000311,0.0001,0.014314
Za_Lords_Guard,14,10,9,19,23,14,37,7,0.269535,0.286544,0.000139,0.000179,0.012465
akcrono,14,5,4,9,17,14,31,8,0.225806,0.236281,0.000019,0.000171,0.00541
alexmikli,13,13,13,26,16,13,29,8,0.257505,0.273926,0.000084,0.000126,0.019428
almightywhacko,16,18,3,21,26,5,31,8,0.207031,0.214814,0.000186,0.00013,0.029119
au-smurf,11,7,4,11,14,4,18,8,0.235566,0.246802,0.000004,0.000077,0.009666
ballmermurland,88,50,42,92,109,71,180,7,0.306739,0.333248,0.002113,0.000622,0.046829
burritoace,25,15,13,28,56,28,84,8,0.272651,0.291666,0.000123,0.000255,0.023683
candre23,35,23,13,36,77,28,105,7,0.276935,0.29849,0.000392,0.000307,0.02724
che-che-chester,10,9,8,17,10,8,18,8,0.244996,0.259116,0.000012,0.000095,0.010383
clarkision,15,8,4,12,29,14,43,7,0.25391,0.268886,0.000038,0.000239,0.0081
coskibum002,32,26,19,45,58,28,86,8,0.275252,0.295741,0.000275,0.000319,0.024033
daniel_smith_555,12,17,8,25,28,14,42,8,0.258637,0.271362,0.000343,0.00015,0.025177
dravik,21,20,9,29,26,11,37,8,0.256368,0.271879,0.000065,0.000191,0.019338
foul_ol_ron,10,8,6,14,12,6,18,8,0.233984,0.245327,0.000021,0.000097,0.008679
getawarrantfedboi,10,7,6,13,14,10,24,7,0.286646,0.305466,0.0001,0.000128,0.009348
harrumphstan,17,14,11,25,25,16,41,8,0.271669,0.290021,0.000076,0.00016,0.016585
j_ly,12,6,6,12,9,7,16,8,0.267545,0.283913,0.00007,0.000093,0.007588
jmac31793,11,8,5,13,12,5,17,8,0.239452,0.252315,0.000025,0.000066,0.009323
lionhearted318,23,19,11,30,29,17,46,7,0.259899,0.277179,0.000154,0.000322,0.009373
meelar,10,4,3,7,7,6,13,7,0.258298,0.271112,0.000018,0.000064,0.005018
mosesoperandi,15,8,8,16,14,13,27,7,0.258505,0.275511,0.000038,0.000096,0.009016
novagenesis,47,32,35,67,89,59,148,7,0.323269,0.346521,0.002968,0.000386,0.02785
pgriss,17,14,8,22,29,11,40,7,0.27924,0.298327,0.000199,0.00015,0.019881
rainkloud,13,11,32,43,18,61,79,7,0.276665,0.297165,0.000156,0.00013,0.007523
repeatoffender123456,27,19,10,29,36,16,52,8,0.252551,0.265939,0.00019,0.000214,0.018287
spacegamer2000,10,4,2,6,20,7,27,8,0.228345,0.239227,0.000001,0.000116,0.005947
swagonflyyyy,14,18,8,26,34,11,45,7,0.26864,0.285827,0.000106,0.000161,0.023606
tosser1579,31,22,11,33,54,20,74,8,0.256761,0.270548,0.000168,0.000291,0.017947
unknownpoltroon,13,19,9,28,26,9,35,7,0.263974,0.28021,0.000931,0.000201,0.016656
veryblanduser,27,12,4,16,57,23,80,7,0.258564,0.27381,0.000429,0.000246,0.015332
wip30ut,10,15,7,22,16,7,23,8,0.239782,0.253373,0.000076,0.000108,0.018129
woahwoahwoah28,46,14,10,24,86,32,118,7,0.29259,0.307587,0.000603,0.00032,0.012183
Aaron_Hamm,15,10,7,17,21,11,32,8,0.255803,0.266131,0.000205,0.000125,0.00185
DrEckelschmecker,19,4,3,7,15,8,23,8,0.229945,0.237475,0.000014,0.000166,0.000162
FactorVerborum,18,14,6,20,21,9,30,8,0.253967,0.263134,0.000183,0.000237,0.000948
Fists_full_of_beers,11,8,9,17,12,12,24,7,0.290265,0.304702,0.000284,0.000099,0.000843
LDel3,10,4,1,5,4,1,5,9,0.204691,0.209403,0.000004,0.000066,0.000223
OnlineIsNotAPlace,19,10,6,16,27,18,45,8,0.245275,0.254185,0.000506,0.000253,0.000709
SaIemKing,11,6,2,8,9,4,13,8,0.251025,0.259869,0.00006,0.000057,0.000786
YoIronFistBro,12,6,6,12,36,9,45,9,0.211744,0.218684,0.000031,0.000122,0.000568
ZaneBradleyX,10,4,4,8,21,8,29,8,0.236021,0.244367,0.000062,0.000174,0.000161
pulsatingcrocs,26,8,9,17,19,20,39,7,0.291329,0.306124,0.000937,0.000238,0.003502
Blurjob1992,10,4,10,14,6,16,22,8,0.240151,0.248979,0.000458,0.000147,0.000001
DirectAntique,10,6,6,12,11,9,20,7,0.225267,0.234933,0.000152,0.000092,0.000163
KatzAKat,18,5,0,5,5,0,5,0,0,0,0,0.000076,0.000083
Mysterious_Salt_247,11,7,6,13,9,7,16,8,0.214797,0.222884,0.000461,0.000101,0.000071
harleybidness,18,10,2,12,18,7,25,9,0.20704,0.212669,0.000034,0.000282,0.00027
lihzee,19,15,5,20,17,5,22,8,0.204046,0.211055,0.000904,0.000261,0.000304
Bonaccorso_di_Novara,20,2,4,6,2,8,10,8,0.222533,0.229946,0.00002,0.000058,0.000044
Fauropitotto,46,13,10,23,29,21,50,9,0.227828,0.238791,0.000694,0.000281,0.001125
fwubglubbel,14,8,2,10,11,4,15,8,0.211191,0.217447,0.000081,0.000315,0.000142
Bothersome_Wench00,25,0,5,5,0,10,10,7,0.248274,0.258891,0,0.000033,0
Appropriate-Error239,10,3,1,4,7,1,8,9,0.175597,0.178806,0.000001,0.000095,0.000012
ildadof3,25,7,2,9,10,3,13,8,0.204193,0.208959,0.000305,0.000206,0.000047
lennoco,48,18,25,43,63,46,109,7,0.321411,0.347128,0.000874,0.00029,0.010794
6data,79,30,23,53,158,66,224,7,0.304123,0.323017,0.001342,0.000641,0.030425
Agreeable_Scar_5274,53,23,23,46,114,56,170,7,0.302195,0.321681,0.000579,0.000283,0.02139
Angsty-Panda,19,13,8,21,34,20,54,7,0.276074,0.289832,0.000115,0.000237,0.013532
AnimatorDifficult429,15,18,7,25,24,8,32,7,0.291348,0.304759,0.002785,0.000172,0.005843
BitterGas69,49,18,16,34,80,51,131,7,0.294186,0.311008,0.000713,0.000316,0.015207
Black_Diammond,23,15,8,23,39,15,54,7,0.257081,0.268154,0.000254,0.000193,0.017763
Budget-Attorney,21,12,9,21,50,24,74,7,0.278811,0.294274,0.00046,0.00023,0.011567
Capable-Art-1972,36,22,47,69,36,145,181,7,0.324916,0.3489,0.002619,0.000308,0.009042
CaptainMarvelOP,12,16,4,20,21,4,25,7,0.273193,0.286923,0.000072,0.000061,0.025486
ComfortableSurvey815,12,7,4,11,28,13,41,8,0.26783,0.282899,0.000038,0.000131,0.007059
Daruuk,17,15,7,22,36,13,49,7,0.285273,0.299392,0.000182,0.000192,0.009364
DippyMagee555,17,11,9,20,31,18,49,7,0.26821,0.280236,0.00012,0.000194,0.008886
DrSpaceman575,82,51,72,123,97,186,283,7,0.339785,0.371526,0.004042,0.000739,0.03377
EarlyInside45,10,6,3,9,21,6,27,7,0.268783,0.281526,0.000021,0.000077,0.004154
Electric-Sheepskin,13,13,6,19,20,8,28,8,0.239478,0.248105,0.000245,0.000178,0.007122
Frederf220,19,14,7,21,33,14,47,7,0.279413,0.291336,0.000602,0.0004,0.009786
GrouchNslouch777,15,7,3,10,19,9,28,8,0.219311,0.225901,0.000177,0.00016,0.004811
HauntedReader,37,20,11,31,76,31,107,7,0.29855,0.314435,0.000354,0.000394,0.014731
Hektorlisk,15,8,9,17,28,18,46,7,0.277512,0.291737,0.000068,0.000146,0.004666
HereForTheBoos1013,16,14,11,25,33,21,54,7,0.293291,0.308641,0.000301,0.000183,0.010861
Icerith,43,15,17,32,83,44,127,7,0.286882,0.303152,0.000169,0.0003,0.007075
InTheTreeMusic,41,10,8,18,53,26,79,7,0.271588,0.285536,0.000091,0.000213,0.012196
JakeVanderArkWriter,10,5,4,9,17,8,25,7,0.276834,0.289958,0.000037,0.000091,0.002051
NetEnvironmental6346,17,15,6,21,31,7,38,7,0.277819,0.292567,0.000189,0.000144,0.020955
Ok_Experience_8006,112,35,49,84,146,185,331,7,0.33015,0.355395,0.002795,0.000937,0.015428
RotML_Official,14,6,4,10,21,15,36,8,0.253286,0.263667,0.000015,0.000201,0.006523
Sense_Difficult,53,31,17,48,119,23,142,7,0.294034,0.308685,0.000914,0.000533,0.008983
Simon-Says69,15,7,10,17,50,30,80,7,0.274518,0.287285,0.000063,0.000142,0.006626
Software_Vast,80,20,17,37,193,82,275,7,0.289559,0.30583,0.000377,0.000689,0.008102
T2Drink,16,15,4,19,30,6,36,8,0.254567,0.264972,0.000036,0.000105,0.02266
TheDutchin,11,13,8,21,26,9,35,7,0.277071,0.290734,0.000394,0.00015,0.007991
UntimelyMeditations,10,10,15,25,20,16,36,7,0.286337,0.302642,0.00009,0.000095,0.004442
Utopia_Builder,49,35,137,172,43,322,365,7,0.349946,0.385823,0.005919,0.000394,0.012521
bismark_dindu_nuffin,12,8,5,13,30,13,43,7,0.275102,0.289175,0.00003,0.000135,0.005372
captainburger31,19,11,32,43,14,45,59,7,0.299696,0.315545,0.002256,0.000094,0.015012
ctrldwrdns,10,5,7,12,28,13,41,7,0.275839,0.289637,0.000098,0.000097,0.002715
deadairis,42,9,12,21,98,44,142,7,0.268895,0.280552,0.000121,0.000326,0.002514
fffridayenjoyer,18,10,9,19,42,17,59,7,0.273243,0.287142,0.000044,0.000176,0.003842
johnwcowan,16,10,13,23,26,17,43,7,0.290227,0.305886,0.000506,0.000138,0.009184
mayasux,10,5,3,8,18,6,24,7,0.258033,0.271656,0.000059,0.000115,0.003108
melissa_liv,18,7,6,13,46,21,67,8,0.274302,0.289383,0.000028,0.00018,0.004427
metasekvoia,17,8,5,13,22,10,32,7,0.277597,0.290819,0.00007,0.000137,0.003563
muffinsballhair,24,25,20,45,53,29,82,7,0.307677,0.326808,0.000412,0.000251,0.019421
onetwo3four5,14,17,4,21,22,7,29,7,0.260812,0.272129,0.00008,0.00014,0.016627
pinetree1998,14,3,6,9,39,20,59,7,0.256006,0.267122,0.000008,0.000137,0.001529
throwbackblue,10,9,16,25,10,20,30,7,0.297276,0.312741,0.00055,0.000108,0.003491
Brendan_Frost,10,8,10,18,14,18,32,7,0.285831,0.301085,0.000083,0.000127,0.005951
B1ackHawk12345,10,7,1,8,15,6,21,8,0.198449,0.203528,0.000021,0.000125,0.005374
Delli-paper,48,24,17,41,75,41,116,7,0.291217,0.308681,0.00047,0.000409,0.009975
Insectshelf3,15,16,13,29,35,19,54,7,0.299715,0.31774,0.000226,0.000164,0.013908
BrightColoursPrime,13,4,8,12,6,19,25,8,0.21893,0.226012,0.000336,0.000212,0.000001
ApocalypseCheerBear,10,6,3,9,13,4,17,9,0.202332,0.207693,0.000133,0.000238,0.000069
fIumpf,12,9,4,13,19,7,26,8,0.208316,0.215046,0.000171,0.000224,0.000041
Broad-Hunter-5044,23,7,18,25,17,81,98,7,0.309908,0.329308,0.000116,0.000156,0.00441
Boratssecondwife,11,16,7,23,23,7,30,7,0.282956,0.298664,0.000269,0.000129,0.012307
Ok-Trade-5937,14,12,7,19,37,19,56,7,0.279068,0.292122,0.00005,0.000207,0.011342
Pasadenaian,10,8,2,10,15,8,23,8,0.238193,0.247661,0.000006,0.000106,0.005116
KendrickBlack502,31,5,39,44,6,137,143,7,0.305004,0.322365,0.001432,0.000084,0.000286
WelshBen,12,6,2,8,7,2,9,8,0.225851,0.232987,0.000208,0.000125,0.000187
Bubbly_Ad9068,10,3,14,17,4,18,22,8,0.245116,0.255434,0.000494,0.000079,0.000126
OldSaggytitBiscuits,15,10,1,11,17,1,18,10,0.156648,0.15924,0.000234,0.000163,0.005432
Sorry_I_Guess,37,19,8,27,36,8,44,8,0.207638,0.215972,0.000469,0.000198,0.000492
hopelesscaribou,14,11,5,16,20,7,27,7,0.27594,0.287268,0.000893,0.000109,0.010333
BuckeyeReason,11,2,25,27,8,46,54,7,0.284342,0.305473,0.0001,0.000095,0.000052
HideGPOne,11,7,4,11,13,5,18,8,0.234275,0.246766,0.000085,0.000061,0.008867
Rastiln,25,20,14,34,25,14,39,7,0.262156,0.280047,0.000661,0.000188,0.012637
Which-Worth5641,40,25,28,53,78,40,118,7,0.304922,0.329279,0.000677,0.000265,0.027525
chamrockblarneystone,43,26,29,55,60,39,99,7,0.27013,0.290426,0.000528,0.000281,0.025064
cp5184,22,12,8,20,38,22,60,7,0.281409,0.299991,0.000243,0.000189,0.010043
danappropriate,14,7,4,11,15,14,29,8,0.265273,0.28322,0.000021,0.000146,0.008626
help_abalone,19,20,4,24,36,10,46,7,0.274252,0.29072,0.000149,0.000143,0.025928
mrcsrnne,24,16,8,24,40,15,55,8,0.264143,0.277663,0.000356,0.000206,0.020082
rookieoo,16,21,11,32,40,19,59,8,0.275503,0.294266,0.000173,0.000288,0.017184
BulkyZucchini,11,7,9,16,9,20,29,7,0.304532,0.324392,0.000063,0.000103,0.005828
DiverseUse,12,7,6,13,21,7,28,7,0.277257,0.290665,0.000037,0.000102,0.00417
Business-Stretch2208,49,16,16,32,48,50,98,7,0.311636,0.330673,0.000732,0.000347,0.008384
Amazing_Might_9280,16,6,7,13,29,20,49,7,0.27828,0.293098,0.000068,0.00016,0.004301
Fondacey,34,14,43,57,34,131,165,7,0.304901,0.322077,0.004358,0.000286,0.01139
SANcapITY,76,29,22,51,103,66,169,7,0.313209,0.330932,0.000614,0.00045,0.016648
CJMakesVideos,15,4,10,14,13,50,63,7,0.306386,0.32558,0.000131,0.000159,0.004317
EmbarrassedYak968,35,8,10,18,19,27,46,7,0.312065,0.330769,0.000125,0.000171,0.006578
cbusmatty,11,9,5,14,24,11,35,7,0.251402,0.262309,0.000042,0.000204,0.006808
Call_It_,10,5,7,12,11,14,25,7,0.296925,0.314656,0.000117,0.00012,0.006155
DunEmeraldSphere,13,17,9,26,25,14,39,7,0.278793,0.292482,0.000117,0.000147,0.010219
jimmytaco6,11,11,6,17,22,7,29,7,0.276276,0.291536,0.000072,0.000128,0.006339
o_o_o_f,15,4,4,8,16,11,27,7,0.257169,0.269258,0.000042,0.000141,0.002445
Candle-Jolly,12,11,38,49,13,122,135,7,0.280955,0.304284,0.000172,0.00013,0.010477
GShermit,12,7,7,14,12,11,23,8,0.252734,0.266493,0.000022,0.000125,0.00236
Hartastic,42,30,34,64,63,57,120,7,0.289411,0.313161,0.00052,0.000307,0.0326
Honky_Cat,31,21,14,35,72,34,106,8,0.253782,0.269419,0.00031,0.00038,0.026037
RocketRelm,27,34,21,55,45,22,67,8,0.287191,0.308732,0.000979,0.000265,0.036062
arbitrageME,10,15,7,22,24,8,32,7,0.260138,0.274032,0.000118,0.000116,0.019186
blaqsupaman,13,9,11,20,10,11,21,8,0.261626,0.277459,0.000032,0.000101,0.007046
friedgoldfishsticks,38,21,19,40,58,36,94,8,0.277495,0.297488,0.000206,0.000336,0.018375
gravity_kills,12,14,12,26,23,13,36,7,0.283559,0.300489,0.000184,0.000134,0.011351
indescipherabled,31,16,16,32,41,27,68,8,0.271588,0.291402,0.000131,0.00018,0.018679
littleredpinto,11,12,8,20,19,10,29,8,0.274169,0.292003,0.000058,0.000084,0.021574
Canuck_Voyageur,11,6,2,8,7,2,9,8,0.201146,0.205975,0.000053,0.000079,0.000778
21-characters,22,13,11,24,23,15,38,7,0.250221,0.259603,0.001231,0.000261,0.000486
Pongpianskul,29,11,3,14,21,8,29,8,0.203624,0.209801,0.00017,0.000393,0.000631
Alexandur,11,8,4,12,25,11,36,7,0.262065,0.274616,0.000035,0.000129,0.004089
Fox_Flame,10,3,2,5,10,2,12,8,0.2588,0.2716,0.000004,0.000059,0.002269
GiveMeAHeartOfFlesh,28,13,7,20,50,16,66,7,0.267909,0.282808,0.000227,0.000248,0.008424
Rakkis157,11,14,10,24,25,13,38,7,0.269664,0.284382,0.000253,0.000129,0.005995
Recent_Weather2228,20,11,5,16,29,9,38,7,0.276986,0.29215,0.000151,0.000156,0.009606
Sigmatronic,10,3,2,5,21,11,32,8,0.245634,0.25518,0.000001,0.000136,0.001575
ToranjaNuclear,29,21,10,31,64,23,87,7,0.321708,0.343227,0.000846,0.000272,0.021758
TripleDoubleFart,12,8,4,12,14,7,21,8,0.258978,0.269145,0.000204,0.000146,0.001659
jayeffkay,26,6,6,12,58,27,85,8,0.25481,0.266258,0.000032,0.000321,0.002431
nuggets256,203,39,23,62,292,176,468,7,0.301451,0.320761,0.001667,0.001137,0.01736
qwertyqyle,32,8,6,14,55,16,71,7,0.275789,0.292613,0.000088,0.000195,0.005502
tbdabbholm,12,11,6,17,18,7,25,7,0.283133,0.297139,0.000043,0.000105,0.005796
CardiologistAway9619,243,54,67,121,362,303,665,7,0.346545,0.376251,0.004164,0.001799,0.042585
ARatOnASinkingShip,39,29,16,45,69,34,103,7,0.294972,0.311893,0.000449,0.000313,0.029888
Blairians,13,18,6,24,25,10,35,7,0.29369,0.310558,0.000643,0.000135,0.019611
ILikeToJustReadHere,20,9,6,15,40,18,58,7,0.274651,0.287473,0.000308,0.000214,0.009182
Lorata,21,6,5,11,36,24,60,7,0.269087,0.282925,0.000158,0.000197,0.003922
Proper_Solid_626,30,11,26,37,21,45,66,7,0.311314,0.332447,0.000777,0.000201,0.005537
Soft_Accountant_7062,33,25,12,37,55,31,86,7,0.28943,0.305655,0.0004,0.000337,0.017233
Surge_Lv1,18,12,6,18,17,9,26,7,0.275118,0.289118,0.000131,0.000117,0.00801
Visual-Tangelo1979,48,18,17,35,78,33,111,7,0.295415,0.313597,0.000333,0.000325,0.021627
scarab456,35,18,8,26,27,13,40,7,0.26359,0.276772,0.000104,0.000148,0.017842
username_6916,11,18,7,25,25,9,34,7,0.266961,0.280419,0.000377,0.000151,0.012781
Careful_Fondant5453,22,2,8,10,8,17,25,8,0.211162,0.219174,0.000021,0.000125,0.000016
Ok-Raspberry7884,17,12,12,24,27,18,45,7,0.249903,0.260018,0.001468,0.000304,0.000197
Remote-Passenger7880,17,8,4,12,15,11,26,8,0.21701,0.22517,0.000242,0.000143,0.000112
Spare_Ad5009,10,10,0,10,10,0,10,0,0,0,0,0.000086,0.000233
Careless-Interest-25,50,24,130,154,46,973,1019,6,0.345963,0.379863,0.004911,0.000416,0.006278
1isOneshot1,13,17,8,25,30,9,39,7,0.288398,0.305072,0.000172,0.000176,0.01302
7059043,10,8,5,13,13,10,23,7,0.261852,0.27511,0.000041,0.000123,0.007439
AcceptablePea262,41,15,8,23,70,21,91,7,0.247203,0.258539,0.000365,0.00032,0.020057
Apart_Variation1918,20,9,9,18,39,16,55,7,0.299458,0.318384,0.000143,0.000141,0.006975
Available_Reveal8068,16,12,6,18,26,14,40,7,0.299775,0.317681,0.000246,0.000174,0.010853
Baby_Needles,16,20,18,38,30,19,49,7,0.290265,0.308991,0.000795,0.000144,0.02659
Beastmayonnaise,17,6,5,11,18,17,35,7,0.276597,0.290911,0.000021,0.000174,0.004591
Belisarius9818,14,8,5,13,30,16,46,7,0.298491,0.314428,0.000161,0.000126,0.01527
Boulange1234,12,14,3,17,16,3,19,8,0.243665,0.253897,0.000038,0.000066,0.023379
Buttcrush1,15,11,2,13,29,8,37,8,0.21816,0.225245,0.000042,0.000196,0.011527
Charming-Leader-250,17,9,6,15,30,15,45,7,0.287246,0.304194,0.000161,0.000098,0.007589
DeliciousInterview91,15,13,60,73,18,204,222,6,0.32931,0.355465,0.000989,0.000161,0.009506
DevA248,20,10,11,21,49,23,72,7,0.278434,0.294427,0.000151,0.000177,0.006288
Edens_dark_garden,21,5,3,8,46,19,65,8,0.240393,0.249778,0.000028,0.00026,0.002792
ElEsDi_25,20,8,4,12,42,18,60,7,0.264128,0.277833,0.000044,0.000201,0.006303
Extension_Hand1326,10,7,6,13,26,11,37,8,0.263759,0.276466,0.000043,0.000119,0.009083
Eyesofmalice,21,6,4,10,27,11,38,8,0.236193,0.245227,0.00006,0.00014,0.001963
Fifteen_inches,23,14,7,21,38,14,52,7,0.297667,0.31553,0.000366,0.000128,0.015245
FragrantPiano9334,12,5,6,11,17,9,26,7,0.267592,0.282466,0.000356,0.00007,0.007906
Fulgore101,24,11,9,20,46,22,68,7,0.274751,0.290118,0.000084,0.000211,0.009732
Glitchy_XCI,19,8,7,15,45,20,65,7,0.279671,0.294719,0.00006,0.000197,0.00679
GrungleMonke,19,11,7,18,40,22,62,7,0.276007,0.289759,0.000229,0.000214,0.009898
HiramMcknoxt,14,16,9,25,39,12,51,7,0.295762,0.312673,0.000214,0.000141,0.016305
Imaginary_Exam1068,16,9,9,18,35,18,53,7,0.288729,0.304684,0.000087,0.000226,0.006728
Impossible_Pop620,84,24,22,46,127,60,187,7,0.295415,0.318699,0.000717,0.000467,0.024812
JAMONLEE,25,5,5,10,46,17,63,8,0.259452,0.271035,0.000028,0.000162,0.00433
LisleAdam12,15,9,7,16,24,13,37,8,0.277376,0.292725,0.00009,0.000138,0.010156
Live-Cookie178,38,11,13,24,45,21,66,7,0.27981,0.293761,0.000917,0.000289,0.004501
Locrian6669,22,6,6,12,48,27,75,7,0.276918,0.290764,0.000045,0.000224,0.003535
Lower_Group_1171,10,16,5,21,28,8,36,7,0.281479,0.29461,0.000075,0.000116,0.01952
MarkHaversham,24,17,10,27,49,13,62,7,0.276344,0.291041,0.000173,0.000176,0.017563
MaterialLeague1968,11,14,6,20,26,9,35,7,0.26214,0.273968,0.000108,0.000155,0.018583
OnePunchReality,15,8,3,11,28,10,38,8,0.227828,0.236527,0.000048,0.000164,0.014701
Oppopity,30,10,14,24,65,28,93,7,0.295492,0.314097,0.00029,0.000225,0.010531
Peefersteefers,13,7,4,11,31,13,44,7,0.251891,0.262807,0.00004,0.00014,0.01444
PhillipTopicall,12,5,4,9,20,10,30,7,0.274568,0.285069,0.000213,0.000123,0.003564
PopIntelligent9515,17,10,7,17,29,10,39,8,0.253442,0.265014,0.000069,0.000185,0.007597
Prepared_Noob,12,3,2,5,20,8,28,8,0.240508,0.248865,0.000009,0.000112,0.001863
Purple_Feedback_1683,16,3,3,6,35,18,53,7,0.257696,0.270291,0.000007,0.000176,0.001689
RadiantHC,27,10,10,20,55,25,80,7,0.270178,0.283539,0.000136,0.000198,0.011794
Rokarion14,10,5,5,10,14,13,27,7,0.267671,0.281641,0.000087,0.000166,0.003971
ShakyTheBear,11,9,7,16,24,11,35,7,0.288545,0.305539,0.000133,0.000088,0.009443
Subarctic_Monkey,26,26,12,38,52,16,68,7,0.313209,0.334017,0.001407,0.000272,0.015097
SuggestionHoliday413,19,4,19,23,14,36,50,7,0.300511,0.319781,0.000114,0.000085,0.002274
TheMidnightBear,11,10,6,16,24,10,34,7,0.275085,0.289447,0.000069,0.000128,0.010161
Vedic70,13,12,6,18,38,15,53,8,0.263974,0.278065,0.000154,0.000152,0.012762
WaltEnterprises,16,13,3,16,22,10,32,8,0.243468,0.253238,0.000069,0.000209,0.012326
WeakandSlowaf,19,11,9,20,44,22,66,7,0.2898,0.305141,0.000239,0.00019,0.008799
Winter-Hedgehog8969,15,7,2,9,24,4,28,8,0.226983,0.234667,0.000018,0.000082,0.012357
Wise-Opportunity-294,10,3,2,5,15,9,24,8,0.238657,0.248156,0.000002,0.000118,0.001928
Wooba12,15,11,6,17,31,14,45,7,0.270453,0.283,0.000128,0.000186,0.012634
Zauberer-IMDB,10,11,4,15,21,6,27,7,0.244692,0.253693,0.000021,0.000117,0.00848
abstractengineer2000,17,37,14,51,40,14,54,7,0.302296,0.318726,0.003669,0.00024,0.02905
bfwolf1,40,12,11,23,74,40,114,8,0.265226,0.279924,0.000272,0.000396,0.00549
blandunoffensivename,11,10,3,13,19,5,24,7,0.256659,0.268274,0.000024,0.000094,0.014802
cnsreddit,12,8,3,11,25,10,35,7,0.258387,0.269971,0.00002,0.000129,0.007594
djseaneq,11,5,3,8,15,8,23,8,0.241637,0.250853,0.000021,0.000126,0.002632
emp-sup-bry,13,10,6,16,31,10,41,7,0.253868,0.264577,0.000178,0.000168,0.0081
ghotier,150,35,29,64,295,106,401,7,0.300471,0.320162,0.001686,0.001053,0.01737
haterofslimes,19,8,6,14,39,20,59,7,0.261068,0.274568,0.000145,0.000239,0.005619
mark_ik,23,7,7,14,39,25,64,7,0.255443,0.267806,0.000031,0.000205,0.002579
nerfherder616,10,3,1,4,16,2,18,8,0.240253,0.250141,0.000001,0.000073,0.002439
nighthawk_something,10,6,5,11,18,12,30,8,0.249766,0.258781,0.000062,0.000101,0.006201
regolith-terroire,30,16,10,26,34,15,49,8,0.273705,0.288477,0.000442,0.000218,0.010844
roflchopter11,11,6,9,15,9,11,20,7,0.274501,0.288354,0.000037,0.000053,0.007369
trevor32192,66,22,17,39,142,65,207,7,0.289671,0.305629,0.001274,0.000703,0.019812
Cartire2,21,11,13,24,22,25,47,6,0.328379,0.347579,0.00094,0.000166,0.006965
CaseInformal4066,22,16,39,55,23,80,103,6,0.319709,0.345039,0.001195,0.000223,0.0071
Cunderwood2020,12,9,4,13,19,8,27,7,0.269311,0.282426,0.00015,0.000144,0.009978
Direct_Crew_9949,31,32,12,44,56,27,83,7,0.290358,0.304903,0.001248,0.000422,0.028142
HevalRizgar,10,6,5,11,7,6,13,7,0.250734,0.262023,0.000099,0.000119,0.001175
OldAdvertising5963,13,13,4,17,29,5,34,7,0.255919,0.268233,0.000066,0.000078,0.021867
Standard-Secret-4578,14,16,9,25,28,10,38,7,0.273375,0.287122,0.000152,0.000141,0.009221
TheBouwerie,10,6,3,9,22,7,29,7,0.306448,0.323996,0.000076,0.000089,0.009378
defaultusername-17,12,9,7,16,25,10,35,7,0.292647,0.308122,0.00009,0.000106,0.007491
quietflyr,10,5,3,8,13,11,24,7,0.259155,0.271768,0.000007,0.000101,0.007436
CashMikey,22,13,77,90,15,172,187,7,0.333997,0.361487,0.002213,0.000197,0.004556
Aceturb,19,13,7,20,21,12,33,7,0.28211,0.294765,0.000595,0.000164,0.00643
Adorable_Ad_3478,11,10,5,15,22,6,28,7,0.278075,0.292683,0.000109,0.00012,0.005252
Aware-Enthusiasm-248,22,13,3,16,43,11,54,7,0.259527,0.27022,0.000099,0.000238,0.009622
Eyespop4866,22,28,6,34,37,8,45,7,0.284324,0.298798,0.000846,0.000184,0.022935
ImReverse_Giraffe,16,17,10,27,38,17,55,7,0.284521,0.301294,0.000432,0.000149,0.016268
KrabbyMccrab,18,18,9,27,39,15,54,7,0.309506,0.326954,0.000376,0.000159,0.023608
MantisBuffs,49,30,50,80,78,148,226,6,0.329142,0.350431,0.00282,0.000421,0.014902
NugKnights,22,28,5,33,55,17,72,8,0.251443,0.261224,0.000158,0.000499,0.015127
Omegoon,10,8,5,13,19,6,25,7,0.246543,0.256526,0.000023,0.000091,0.006419
Random_Guy_12345,13,18,6,24,30,9,39,8,0.262642,0.274091,0.000177,0.000207,0.01312
Rationally-Skeptical,18,11,7,18,46,14,60,7,0.284057,0.297868,0.000274,0.000189,0.006367
RoundCollection4196,21,12,6,18,21,6,27,7,0.248164,0.25859,0.000511,0.000122,0.008217
Single_Waltz395,11,17,6,23,33,9,42,8,0.2588,0.267967,0.00061,0.000152,0.016419
Thin-Management-1960,10,6,2,8,8,3,11,7,0.244758,0.253847,0.000009,0.00005,0.003982
ThrowRACoping,28,5,1,6,12,7,19,9,0.208604,0.214767,0.000005,0.000148,0.001312
flex_tape_salesman,17,19,10,29,36,14,50,7,0.284003,0.299099,0.000337,0.000207,0.016695
lainelect,14,4,3,7,31,15,46,8,0.250235,0.260705,0.000004,0.000156,0.003757
shittyopinion1,21,17,12,29,28,35,63,7,0.307176,0.325766,0.000342,0.000235,0.016936
slainascully,25,18,16,34,42,28,70,7,0.30343,0.321624,0.000514,0.000273,0.012426
CatAndBoots,29,8,18,26,20,51,71,7,0.301833,0.321488,0.000203,0.000218,0.003196
CallMeCorona1,29,40,9,49,49,11,60,7,0.281794,0.29792,0.000228,0.000243,0.031114
ImmodestPolitician,12,17,7,24,32,11,43,7,0.277223,0.289815,0.000179,0.000181,0.012485
TehNudel,13,10,4,14,21,5,26,7,0.256339,0.266413,0.000085,0.000101,0.008909
iglidante,39,27,18,45,69,37,106,6,0.301632,0.31883,0.000575,0.000309,0.021672
leekeater,38,18,11,29,81,41,122,7,0.284146,0.299599,0.000133,0.000323,0.014733
Cautious-Macaroon713,10,4,14,18,6,25,31,7,0.271604,0.284057,0.000344,0.000192,0.000148
Acceptable_Fox_5560,34,8,3,11,17,8,25,7,0.231355,0.238168,0.000615,0.000289,0.000457
PandaMime_421,19,23,12,35,42,17,59,7,0.282744,0.296967,0.000916,0.000309,0.01864
Stunning-Artist-5388,17,9,2,11,13,3,16,8,0.256499,0.266303,0.000073,0.000097,0.002049
TromosLykos,16,5,3,8,9,3,12,8,0.256688,0.266927,0.000124,0.000097,0.001023
genus-corvidae,44,27,10,37,37,10,47,8,0.25714,0.267591,0.000754,0.000283,0.002429
undermind84,11,6,2,8,12,4,16,8,0.223699,0.230374,0.000021,0.000108,0.000361
ChallengerDelta,14,1,6,7,1,6,7,8,0.211943,0.219388,0.00002,0.00005,0.000006
Sami_George,48,15,10,25,30,17,47,8,0.235664,0.244539,0.001069,0.000337,0.000238
joe-h2o,20,6,3,9,27,19,46,8,0.212889,0.219117,0.000111,0.000327,0.00015
Cheap-Party-0420,17,4,8,12,13,16,29,8,0.224497,0.233627,0.000119,0.000136,0.00006
Deep90,12,5,3,8,11,4,15,7,0.221847,0.229361,0.000219,0.000072,0.004059
lemon_charlie,20,11,11,22,23,14,37,7,0.257622,0.268492,0.000977,0.000151,0.000418
throwaway1975764,11,9,5,14,17,6,23,7,0.226348,0.233657,0.000161,0.000118,0.000253
Both-Personality7664,39,26,17,43,60,36,96,7,0.290955,0.306981,0.000554,0.000401,0.010484
Desperate-Fan695,17,23,9,32,32,9,41,7,0.291836,0.307715,0.000235,0.000166,0.019149
DevinTheGrand,26,18,12,30,49,23,72,7,0.284342,0.2994,0.00031,0.000279,0.01479
Fluffy_Most_662,18,25,12,37,38,14,52,7,0.297042,0.314482,0.000498,0.000195,0.015273
MaggieMae68,16,15,10,25,37,17,54,7,0.293633,0.309735,0.000258,0.000232,0.00852
Wooden-Ad-3382,26,9,5,14,54,18,72,7,0.280468,0.297866,0.000106,0.000239,0.006879
coiled-serpent,15,4,6,10,21,16,37,8,0.245049,0.25543,0.000016,0.000216,0.001221
wildfirerain,64,17,16,33,132,44,176,7,0.294416,0.311644,0.000341,0.000404,0.005954
ChrisRemember,14,4,8,12,10,18,28,8,0.235016,0.245528,0.00012,0.000146,0.000169
nikhkin,11,6,3,9,13,7,20,8,0.224019,0.231208,0.000034,0.000122,0.000171
velenom,10,6,1,7,13,2,15,8,0.209861,0.214572,0.000005,0.0001,0.001497
Chuck_Schuldiner,19,16,23,39,31,55,86,7,0.320456,0.341974,0.000626,0.000289,0.008876
No-Theme4449,10,12,6,18,18,8,26,7,0.285237,0.300003,0.000044,0.000106,0.009254
Purple_Wizard,28,13,9,22,57,31,88,7,0.289134,0.307026,0.000098,0.000218,0.012251
jiminak,12,9,5,14,21,9,30,7,0.263882,0.277065,0.000033,0.000135,0.006627
Cicity545,10,8,14,22,10,23,33,7,0.289912,0.306955,0.000104,0.000093,0.002834
Szeto802,16,20,83,103,27,255,282,7,0.337456,0.366087,0.002792,0.000253,0.007132
Trambopoline96,13,13,9,22,20,14,34,7,0.279758,0.294233,0.000105,0.000107,0.00976
sumoraiden,31,14,13,27,54,40,94,7,0.288968,0.306453,0.000149,0.000284,0.009488
ClarkStunning,185,23,63,86,65,203,268,7,0.337532,0.365506,0.002301,0.000443,0.007288
AddanDeith,11,6,5,11,7,7,14,8,0.268576,0.280622,0.000121,0.000084,0.005804
Al-Rediph,28,17,6,23,46,9,55,7,0.262429,0.275609,0.000093,0.000177,0.016522
Choreopithecus,12,7,6,13,15,13,28,7,0.279223,0.293578,0.000087,0.000086,0.003251
Curiosity_456,31,17,25,42,29,57,86,6,0.317691,0.338257,0.00114,0.000226,0.008486
Darkcat9000,21,12,7,19,33,18,51,7,0.29225,0.304762,0.000198,0.000177,0.013819
Hatta00,42,32,18,50,87,37,124,7,0.304778,0.321299,0.001426,0.000539,0.021716
HugsForUpvotes,14,17,10,27,28,12,40,7,0.290135,0.307891,0.000204,0.000176,0.016853
K45AR,14,9,6,15,36,18,54,7,0.303837,0.319784,0.000123,0.000132,0.01527
Low-Appearance4875,51,18,102,120,26,448,474,6,0.344778,0.378748,0.002965,0.000261,0.005765
N9s8mping,97,23,62,85,66,156,222,6,0.328736,0.354431,0.003019,0.000425,0.011847
North-Tourist-8234,10,4,3,7,10,10,20,8,0.21995,0.226976,0.000062,0.000111,0.001091
Ok-Pause6148,11,7,3,10,20,6,26,7,0.253555,0.263385,0.000008,0.000115,0.005959
Ok_Climate2983,40,13,8,21,85,35,120,8,0.256325,0.269453,0.000147,0.000367,0.010887
Savings_Art5944,12,14,3,17,18,4,22,8,0.270098,0.284501,0.000179,0.000082,0.012441
Virtual_Technology_9,10,5,3,8,11,8,19,8,0.267308,0.278798,0.000004,0.000074,0.002081
kiwipixi42,14,22,9,31,43,10,53,7,0.270404,0.282646,0.001116,0.000164,0.018753
redsnake25,12,12,6,18,37,15,52,7,0.278262,0.292062,0.00007,0.000188,0.01218
sunburn95,28,7,6,13,19,13,32,7,0.275671,0.28866,0.000149,0.000172,0.004073
unsureNihilist,25,11,8,19,31,11,42,7,0.284843,0.29945,0.000175,0.000168,0.011389
ClimberMachinist,10,4,6,10,4,10,14,8,0.209337,0.216683,0.00004,0.000109,0.000012
aemondstareye,42,9,11,20,37,30,67,8,0.24489,0.255503,0.000657,0.000447,0.000083
felice60,12,5,2,7,8,2,10,9,0.20653,0.212306,0.000241,0.000087,0.000134
CockamouseGoesWee,22,8,16,24,13,32,45,7,0.253527,0.264602,0.000403,0.000185,0.000482
40_degree_rain,11,7,3,10,11,5,16,8,0.216626,0.223326,0.000079,0.000172,0.000223
Buhos_En_Pantelones,18,11,6,17,18,8,26,8,0.24811,0.257496,0.00038,0.000306,0.001664
Civil-Departure-512,29,12,4,16,50,20,70,7,0.275487,0.28798,0.00052,0.00037,0.002965
Confident-Pepper-562,18,7,4,11,15,7,22,7,0.253612,0.262402,0.00013,0.000108,0.000536
Lady_White_Heart,10,4,2,6,14,7,21,8,0.210055,0.215904,0.000005,0.000139,0.000085
PsychologicalLuck343,26,12,8,20,35,10,45,8,0.253186,0.263653,0.00046,0.000174,0.001817
epiDXB,10,5,3,8,9,5,14,8,0.217125,0.22396,0.000057,0.000088,0.000388
zacrl1230,12,8,3,11,15,7,22,8,0.262566,0.273414,0.000254,0.000192,0.000594
Cold_Entry3043,13,9,49,58,16,98,114,7,0.317379,0.339761,0.000329,0.000151,0.002303
IwantRIFbackdummy,13,9,8,17,22,15,37,7,0.268083,0.28079,0.000193,0.000191,0.008482
MediumAids,20,13,9,22,39,19,58,7,0.286573,0.302064,0.000095,0.00019,0.010345
PromptStock5332,22,15,9,24,36,14,50,7,0.283293,0.297081,0.000296,0.000159,0.012036
Zncon,52,37,27,64,107,38,145,7,0.301491,0.320735,0.000881,0.000357,0.02952
nikdahl,23,15,12,27,40,24,64,7,0.287793,0.303305,0.001073,0.00022,0.01029
seanflyon,25,21,17,38,36,27,63,7,0.300332,0.317944,0.000171,0.000141,0.01366
todudeornote,10,15,6,21,20,8,28,7,0.274269,0.2907,0.000213,0.000158,0.010052
woailyx,13,14,8,22,22,12,34,7,0.271181,0.283892,0.00046,0.000111,0.008981
Confused_Firefly,15,12,14,26,18,23,41,7,0.304266,0.324333,0.00069,0.000168,0.00468
Penarol1916,25,14,9,23,22,14,36,7,0.247554,0.255917,0.000714,0.000271,0.001691
Confused_Homo-Sapien,14,4,11,15,4,15,19,7,0.269921,0.28133,0.000406,0.000099,0.000516
Appropriate_Mixer,21,15,10,25,22,11,33,7,0.257403,0.268339,0.00073,0.000157,0.012324
HowAManAimS,14,8,11,19,12,16,28,7,0.279137,0.295682,0.000283,0.000111,0.004725
klimekam,10,7,2,9,11,2,13,8,0.238306,0.245933,0.000055,0.000079,0.000933
stairway2evan,12,6,3,9,24,13,37,7,0.25471,0.264889,0.000068,0.000202,0.00183
ConsistentPressure79,16,14,39,53,20,208,228,6,0.326509,0.350813,0.000652,0.000176,0.007695
Anchuinse,19,8,5,13,23,15,38,7,0.270388,0.283871,0.000074,0.000121,0.005478
BERNthisMuthaDown,10,9,4,13,19,4,23,8,0.248928,0.257925,0.00004,0.000071,0.010244
CarrotcakeSuperSand,22,18,12,30,44,23,67,7,0.292666,0.310257,0.00026,0.000232,0.011741
Evening-Caramel-6093,38,12,6,18,91,42,133,7,0.27211,0.285917,0.00003,0.000411,0.010368
NeuroticKnight,22,15,9,24,45,12,57,7,0.287464,0.302242,0.000221,0.000161,0.01695
Pale-Ad9012,29,13,14,27,30,38,68,7,0.322464,0.345487,0.00031,0.000193,0.013122
Xtergo,17,6,36,42,9,111,120,6,0.322739,0.344947,0.000207,0.000063,0.003005
chewwydraper,11,5,3,8,11,6,17,7,0.262475,0.273506,0.000006,0.000088,0.00704
impoverishedwhtebrd,35,6,3,9,42,3,45,8,0.241148,0.250604,0.000008,0.000071,0.007874
ContextInner9372,43,1,3,4,1,4,5,7,0.223621,0.230432,0.000049,0.000048,0.000035
Cookiedough1206,13,3,23,26,3,30,33,7,0.279275,0.29346,0.000324,0.000077,0.000061
Apprehensive_Yak2598,13,9,4,13,16,5,21,7,0.271441,0.282756,0.000211,0.00014,0.001828
Contemplating_Prison,11,16,5,21,19,5,24,7,0.269423,0.281152,0.000404,0.000121,0.004979
IamJohnnyHotPants,11,6,2,8,26,8,34,7,0.270711,0.28172,0.000146,0.000125,0.001807
MoultingRoach,16,12,6,18,21,6,27,7,0.2509,0.259126,0.000237,0.000098,0.001583
TheHvam,11,7,1,8,13,5,18,9,0.209337,0.214708,0.000014,0.000147,0.000521
madeat1am,14,10,4,14,31,11,42,8,0.236415,0.244855,0.000071,0.000231,0.001136
petrichorax,14,11,11,22,22,14,36,7,0.279275,0.292795,0.000361,0.000162,0.001412
woodwork16,12,11,3,14,15,4,19,8,0.229363,0.236461,0.000046,0.000156,0.00089
DeathMetal007,30,29,15,44,52,30,82,7,0.302014,0.321012,0.000753,0.00032,0.022411
Just_a_nonbeliever,18,13,12,25,37,18,55,7,0.301692,0.319092,0.000194,0.000182,0.011285
LocketheAuthentic,19,6,5,11,34,17,51,7,0.275403,0.28998,0.000023,0.000204,0.004553
Particular-Way-8669,12,18,9,27,39,13,52,7,0.273672,0.288211,0.000142,0.000154,0.01824
Sandaydreamer,14,8,6,14,29,11,40,7,0.276868,0.291189,0.000041,0.00012,0.005469
Serious-Cucumber-54,47,27,56,83,48,156,204,7,0.336129,0.363267,0.002628,0.000487,0.009562
Stock-Film-3609,18,13,6,19,37,11,48,7,0.259899,0.273266,0.000067,0.000117,0.022206
Tessenreacts,101,33,223,256,74,1070,1144,6,0.377921,0.422135,0.011786,0.000523,0.012478
Tinman5278,13,16,4,20,19,5,24,7,0.245914,0.254697,0.00028,0.000166,0.007543
saul_not_goodman,14,7,7,14,29,9,38,7,0.273804,0.285991,0.000046,0.000144,0.002009
bindermichi,16,5,1,6,7,1,8,9,0.211103,0.216674,0.000042,0.000127,0.000254
Busy-Objective5228,12,8,5,13,24,9,33,7,0.284664,0.300347,0.00016,0.000133,0.005989
Helpful_Loss_3739,28,18,15,33,41,39,80,7,0.292269,0.311417,0.000325,0.000279,0.01251
Intelligent-Cow-7122,24,4,3,7,35,8,43,8,0.261747,0.272636,0.00002,0.000196,0.001289
LolaLazuliLapis,26,15,9,24,42,18,60,7,0.266427,0.277947,0.000589,0.000251,0.014991
MarxCosmo,16,8,5,13,14,9,23,7,0.272585,0.285311,0.000146,0.000084,0.004955
National_Ad_682,10,10,6,16,12,7,19,7,0.282956,0.298353,0.000252,0.000132,0.00507
ObsessedKilljoy,14,10,6,16,37,13,50,7,0.261068,0.273021,0.000099,0.000195,0.009909
Roxylius,11,8,4,12,10,9,19,8,0.241122,0.249461,0.000059,0.000153,0.003158
TheTyger,19,10,8,18,24,13,37,7,0.266365,0.280157,0.000045,0.000154,0.003415
TomCormack,22,18,4,22,40,14,54,7,0.272241,0.285028,0.000198,0.000252,0.013623
jawrsh21,23,12,7,19,24,8,32,7,0.262186,0.273978,0.000584,0.00022,0.003096
juliacar,59,35,12,47,110,51,161,7,0.309506,0.328632,0.000825,0.000442,0.018715
oppacklij,19,11,33,44,21,114,135,7,0.301652,0.31999,0.000353,0.000209,0.003889
sir_pirriplin,16,12,11,23,30,20,50,7,0.282903,0.297818,0.000281,0.00024,0.007591
vettewiz,51,25,17,42,83,37,120,7,0.296304,0.31268,0.000414,0.00042,0.012021
yankeeboy1865,22,13,8,21,33,19,52,7,0.299656,0.316831,0.000139,0.000129,0.012845
CreditSuccessful1921,23,1,9,10,1,20,21,7,0.248069,0.257238,0.000449,0.000052,0
Guilty-Bookkeeper837,13,3,1,4,7,1,8,7,0.217312,0.222942,0.000237,0.000071,0.000195
Gullible-Minute-9482,20,3,2,5,10,8,18,8,0.233695,0.241893,0.00002,0.000112,0.000258
Man_under_Bridge420,15,1,0,1,8,0,8,0,0,0,0,0.000051,0.000016
Unusual_Potato9485,11,7,4,11,16,6,22,8,0.246262,0.255939,0.000093,0.000151,0.000326
pyramidalembargo,16,8,5,13,31,16,47,7,0.275453,0.289975,0.000263,0.000179,0.003637
Creedsman03,10,4,17,21,6,23,29,7,0.305786,0.325786,0.000226,0.000111,0.002639
Crowdev1138,56,17,45,62,33,121,154,7,0.288196,0.304676,0.005531,0.000477,0.000378
Electronic-Poet-1328,16,9,8,17,35,16,51,7,0.285669,0.298138,0.001793,0.0002,0.001503
Exotic-Knowledge-243,16,16,9,25,18,10,28,7,0.249738,0.260248,0.001478,0.000234,0.00038
MystifiedByPeople,30,11,10,21,26,13,39,7,0.237993,0.247599,0.000621,0.000201,0.000294
NoSignSaysNo,24,10,8,18,33,15,48,7,0.231461,0.241337,0.000215,0.000184,0.000333
NomadicusRex,12,9,7,16,18,9,27,8,0.230695,0.239655,0.00063,0.000182,0.00029
SecretRecipe,10,6,2,8,14,3,17,7,0.236058,0.243639,0.000192,0.000084,0.005978
SophisticatedScreams,19,12,9,21,32,9,41,7,0.274252,0.285202,0.001464,0.00016,0.002647
StructEngineer91,15,6,2,8,18,4,22,8,0.194603,0.199787,0.00001,0.00011,0.000318
Sweeper1985,11,10,4,14,16,6,22,7,0.256296,0.264787,0.001227,0.000109,0.013022
Tight_Jaguar_3881,11,10,5,15,13,5,18,9,0.202495,0.209637,0.000083,0.00015,0.000186
beckdawg19,16,6,5,11,13,5,18,8,0.216989,0.225373,0.000044,0.000117,0.000141
flowerybutterfly96,14,9,4,13,14,7,21,7,0.24084,0.250194,0.0003,0.000092,0.000242
jindoowner,10,7,2,9,10,2,12,8,0.216564,0.222916,0.000072,0.000123,0.000172
loki2002,34,16,29,45,28,67,95,7,0.306739,0.321203,0.004435,0.000243,0.002681
shelwood46,23,24,7,31,27,7,34,8,0.239364,0.248135,0.000442,0.000135,0.000718
sheramom4,17,7,4,11,12,6,18,7,0.246275,0.254098,0.000501,0.000121,0.000274
swillshop,16,19,0,19,19,0,19,0,0,0,0,0.000093,0.000712
thieh,10,6,4,10,16,11,27,7,0.276024,0.290382,0.000128,0.000121,0.003838
wesmorgan1,33,12,8,20,18,10,28,7,0.253725,0.263063,0.000601,0.000225,0.000365
Cultural-Tutor-2260,20,7,37,44,8,129,137,6,0.309866,0.326562,0.001455,0.000341,0.000297
Agreetedboat123,12,12,15,27,21,18,39,7,0.324102,0.344618,0.00073,0.000104,0.016239
DowntownManThrow,61,13,21,34,60,201,261,7,0.314864,0.335895,0.000505,0.000395,0.006704
Hawk13424,14,10,6,16,16,7,23,8,0.250097,0.260133,0.000124,0.000109,0.001369
Letshavemorefun,78,38,23,61,148,65,213,7,0.299974,0.316384,0.001483,0.000743,0.022443
New_Construction_111,10,4,3,7,12,11,23,8,0.215769,0.22244,0.000017,0.000142,0.000986
YnotBbrave,24,20,9,29,36,10,46,8,0.263667,0.276195,0.000388,0.000167,0.021202
fryerandice,11,6,3,9,20,3,23,8,0.214807,0.220884,0.000066,0.000115,0.000605
xukly,11,5,2,7,8,2,10,7,0.269327,0.280028,0.00008,0.000059,0.005943
Archophob,18,18,12,30,53,21,74,7,0.304881,0.322318,0.000681,0.00023,0.015352
BBQ_game_COCKS,20,7,5,12,34,8,42,8,0.264513,0.273531,0.000123,0.000137,0.003622
Bolognahole_Vers2,31,23,16,39,64,30,94,7,0.283505,0.297537,0.001416,0.000354,0.010022
Business-Adagio6032,11,7,2,9,18,6,24,7,0.273408,0.287306,0.000016,0.000067,0.008664
ButterscotchLow7330,13,12,10,22,20,13,33,7,0.285669,0.30056,0.000827,0.000175,0.009653
Careful_Abroad7511,19,18,6,24,53,9,62,8,0.271344,0.284597,0.000232,0.000328,0.01165
CnC-223,57,28,17,45,118,41,159,7,0.322785,0.34394,0.000726,0.000432,0.028351
DrFabio23,40,17,7,24,75,36,111,7,0.276648,0.290793,0.000117,0.000375,0.014293
DutchDave87,15,6,3,9,27,8,35,7,0.251891,0.262525,0.000042,0.000092,0.007927
EasyAsaparagus,22,19,15,34,31,31,62,7,0.313231,0.333295,0.000624,0.000173,0.014963
Eodbatman,16,11,4,15,35,12,47,7,0.251821,0.262544,0.000027,0.000253,0.010609
FiendishNoodles,28,16,16,32,59,30,89,7,0.279862,0.295275,0.000728,0.000337,0.010141
H4RN4SS,38,18,16,34,62,36,98,7,0.3232,0.344512,0.000607,0.000186,0.023223
Jelly_bean82,10,11,5,16,19,7,26,7,0.256252,0.268352,0.000061,0.000109,0.013075
JeruTz,53,21,12,33,105,33,138,7,0.312625,0.331435,0.000644,0.000359,0.016473
Lagkiller,37,17,10,27,63,18,81,7,0.297902,0.314768,0.000313,0.000212,0.019718
LycheeRoutine3959,70,21,15,36,128,52,180,7,0.290973,0.30809,0.00057,0.000541,0.012446
No-Cauliflower8890,39,17,14,31,68,23,91,7,0.315522,0.337417,0.000317,0.000217,0.018726
NoWhySkillIssueBussy,44,17,12,29,83,32,115,7,0.271116,0.285912,0.000517,0.000292,0.020773
Obi-Brawn-Kenobi,16,12,10,22,30,11,41,7,0.281269,0.295633,0.000262,0.000118,0.011401
PuckSenior,81,31,21,52,189,94,283,7,0.310036,0.329632,0.000691,0.000837,0.018635
PuddleOfHamster,10,4,2,6,19,6,25,8,0.240457,0.248213,0.000271,0.000111,0.00243
QuesoStain2,14,9,6,15,21,13,34,7,0.278811,0.293074,0.000116,0.000152,0.00897
RemoteCompetitive688,77,24,15,39,98,48,146,7,0.291291,0.308717,0.000907,0.000509,0.025625
Riflemate,11,9,4,13,22,8,30,7,0.256383,0.267786,0.000031,0.000161,0.004091
Sharp_Bet_8181,18,7,7,14,46,19,65,7,0.254195,0.266453,0.000037,0.000265,0.006425
Stunning-Drawing8240,12,8,6,14,16,13,29,8,0.27247,0.285061,0.000815,0.000236,0.008001
TotaLibertarian,34,16,16,32,59,29,88,7,0.303491,0.320929,0.000413,0.000231,0.017826
Tullyswimmer,47,23,17,40,75,39,114,6,0.297217,0.311666,0.000805,0.000482,0.015771
UltimaGabe,14,6,4,10,21,7,28,7,0.260842,0.271475,0.000038,0.000177,0.003417
Unique_Statement7811,40,17,15,32,85,37,122,7,0.281095,0.29571,0.00087,0.000391,0.007114
Vegetable-Two-4644,12,8,7,15,27,13,40,7,0.274735,0.288736,0.000149,0.000162,0.006619
courtd93,37,17,13,30,70,33,103,7,0.279068,0.293348,0.000299,0.000348,0.01851
fizzmore,13,11,6,17,26,15,41,7,0.290135,0.306456,0.000212,0.000142,0.006738
happyinheart,15,17,10,27,33,18,51,7,0.293957,0.311111,0.000273,0.000169,0.019053
hatlock,36,14,17,31,77,33,110,7,0.303593,0.321416,0.000306,0.000271,0.011419
kwamzilla,18,20,12,32,51,24,75,7,0.299418,0.318465,0.000664,0.000274,0.020702
laz1b01,12,15,7,22,26,9,35,7,0.308032,0.323262,0.000383,0.000133,0.013725
michaelochurch,12,19,11,30,21,12,33,6,0.309231,0.330441,0.000303,0.00012,0.022056
mikehocalate,10,4,35,39,10,125,135,7,0.30902,0.327814,0.000186,0.000089,0.002435
pastimereading,13,5,15,20,5,38,43,7,0.296129,0.311182,0.000682,0.000117,0.002173
revilocaasi,29,18,11,29,65,26,91,8,0.256339,0.269782,0.00031,0.00036,0.013997
throwawaydanc3rrr,24,30,9,39,49,12,61,7,0.26152,0.273884,0.000225,0.000279,0.02053
turboprancer,16,16,19,35,26,37,63,7,0.306241,0.32565,0.000246,0.000156,0.015472
DahliaB85,24,1,4,5,2,5,7,7,0.244837,0.253741,0.000318,0.00004,0.000543
Square-Dragonfruit76,68,40,64,104,75,308,383,7,0.34591,0.372844,0.003771,0.000592,0.018646
Swimreadmed,29,8,4,12,62,28,90,8,0.252453,0.2629,0.000031,0.000351,0.004355
favorable_vampire,20,17,19,36,63,25,88,7,0.290302,0.308058,0.000432,0.000215,0.016747
Curiousman1911,11,3,56,59,4,132,136,7,0.303065,0.32943,0.000406,0.000116,0.000086
-Foxer,27,18,12,30,38,17,55,7,0.275035,0.29164,0.000211,0.000206,0.017185
Dineology,13,17,6,23,25,9,34,8,0.257417,0.271554,0.000055,0.000161,0.019964
Feisty-Elderberry898,11,12,4,16,20,4,24,8,0.234105,0.245443,0.000095,0.000206,0.00755
Fromage_Frey,12,13,11,24,18,11,29,7,0.248382,0.261473,0.000115,0.000127,0.011052
Hautamaki,10,6,7,13,8,9,17,8,0.253031,0.267643,0.000015,0.000101,0.004903
Idk_Very_Much,16,13,5,18,20,8,28,8,0.247,0.259324,0.000027,0.000154,0.014646
ImDeputyDurland,13,5,2,7,30,13,43,8,0.220432,0.228609,0.000012,0.000203,0.003635
KingKnotts,79,25,27,52,135,65,200,8,0.265833,0.285091,0.000522,0.000592,0.019253
LookAtMeNow247,14,11,8,19,26,11,37,7,0.255934,0.271306,0.000042,0.000158,0.006134
MrMrLavaLava,12,8,5,13,17,9,26,8,0.239187,0.250982,0.000007,0.000082,0.012412
PolicyWonka,16,10,4,14,30,9,39,7,0.25663,0.270492,0.000081,0.000163,0.012119
ThePoppaJ,10,5,4,9,15,7,22,8,0.251779,0.265703,0.000191,0.000107,0.005745
TheSameGamer651,19,14,14,28,27,21,48,7,0.279827,0.299858,0.000068,0.000139,0.018367
The_B_Wolf,75,60,21,81,96,31,127,7,0.285669,0.306084,0.001984,0.000669,0.046867
Tliish,22,24,11,35,34,13,47,7,0.26456,0.280134,0.000111,0.000168,0.034343
bomerr,10,4,2,6,13,3,16,8,0.234432,0.24513,0.000002,0.000061,0.00517
cakeandale,13,17,7,24,22,7,29,8,0.264097,0.276684,0.000097,0.000148,0.016939
illegalmorality,16,9,18,27,10,34,44,7,0.273457,0.293191,0.000103,0.000077,0.016755
kerouacrimbaud,15,7,6,13,13,11,24,8,0.243338,0.255626,0.000022,0.000062,0.010255
mormagils,48,19,11,30,66,26,92,7,0.273606,0.291395,0.000846,0.00035,0.012321
wedgebert,14,10,8,18,22,16,38,7,0.265896,0.280482,0.000126,0.000143,0.01233
Current-Director-875,57,35,28,63,63,89,152,7,0.30921,0.329146,0.001922,0.000452,0.015784
LamdasNo,22,12,19,31,21,46,67,7,0.314623,0.335192,0.000232,0.000182,0.006759
DIXi3N0rMu5,15,10,84,94,15,177,192,7,0.340526,0.366014,0.002828,0.000176,0.002536
CrowsSayCawCaw,17,7,2,9,24,15,39,7,0.254096,0.263622,0.000011,0.000164,0.003559
Electrical-Type-6150,13,4,3,7,26,13,39,8,0.220604,0.227199,0.000051,0.000204,0.000901
Happy_Food9190,27,17,91,108,20,308,328,6,0.346042,0.374174,0.002064,0.000211,0.006228
Hold-Professional,26,29,11,40,42,14,56,8,0.256151,0.268935,0.000677,0.000366,0.003052
IBribeMyBF,16,9,15,24,14,33,47,7,0.306635,0.326806,0.000257,0.000128,0.008299
LaconicGirth,25,15,11,26,25,15,40,8,0.255645,0.267749,0.000543,0.000186,0.00266
MikeUsesNotion,30,19,11,30,34,13,47,7,0.264622,0.275426,0.00081,0.000306,0.002451
Nuthetes,15,8,3,11,9,3,12,9,0.21237,0.217912,0.000038,0.000151,0.000989
PeteMichaud,11,14,6,20,21,7,28,7,0.277699,0.292879,0.000149,0.00012,0.012785
Rag3asy33,12,7,4,11,14,8,22,8,0.231568,0.238144,0.000324,0.000172,0.001335
Raise_A_Thoth,27,18,13,31,41,24,65,7,0.291348,0.307267,0.000388,0.000187,0.010044
Thortok2000,17,9,5,14,53,18,71,7,0.269953,0.283595,0.000074,0.000188,0.010637
Various_Succotash_79,70,10,9,19,148,66,214,7,0.28278,0.297497,0.000126,0.00047,0.005213
Wic-a-ding-dong,40,11,10,21,43,35,78,6,0.285489,0.299904,0.000476,0.000329,0.004502
_Dingaloo,28,11,10,21,27,20,47,8,0.27321,0.287317,0.000173,0.000212,0.00673
_robjamesmusic,16,12,14,26,35,19,54,7,0.292987,0.309172,0.000099,0.000154,0.010441
cs_____question1031,28,6,24,30,7,42,49,7,0.276411,0.289201,0.000593,0.000105,0.001067
doggo816,15,11,8,19,36,18,54,7,0.269728,0.282538,0.000147,0.000233,0.004887
draculabakula,13,9,6,15,21,7,28,7,0.288013,0.303985,0.000046,0.000094,0.013156
go_fly_a_kite,11,7,4,11,23,14,37,7,0.290675,0.306758,0.000061,0.0001,0.008103
insaneHoshi,16,16,15,31,49,27,76,7,0.317224,0.338896,0.000462,0.00016,0.020592
noonefuckslikegaston,15,18,16,34,28,19,47,7,0.305436,0.322494,0.002921,0.000221,0.007425
pipboy_warrior,24,13,10,23,16,13,29,7,0.259111,0.269244,0.000379,0.000216,0.001286
skysinsane,32,22,21,43,74,35,109,7,0.287464,0.304748,0.000731,0.000291,0.014447
yea_i_doubt_that,12,16,6,22,19,8,27,8,0.257359,0.267025,0.000478,0.000182,0.0087
The_Black_Adder_,12,6,6,12,19,16,35,7,0.26864,0.283048,0.000051,0.000129,0.004419
RusticBucket2,12,5,1,6,5,1,6,7,0.217312,0.222942,0.000662,0.00008,0.000132
DaleRod2468,10,3,8,11,9,29,38,8,0.254524,0.266967,0.000019,0.000114,0.000634
Advanced-Ad6210,22,6,5,11,29,20,49,7,0.258904,0.270869,0.000042,0.000116,0.003026
automaks,11,5,3,8,17,12,29,8,0.24989,0.261227,0.000021,0.000124,0.001201
DanaTheCelery,10,4,27,31,8,105,113,7,0.277359,0.298205,0.00009,0.000092,0.000668
214ObstructedReverie,14,16,11,27,19,12,31,8,0.254983,0.269518,0.000042,0.000114,0.016353
FancyyPelosi,26,10,9,19,24,17,41,7,0.27136,0.287782,0.000084,0.000225,0.005093
Gta6MePleaseBrigade,24,17,10,27,48,16,64,8,0.2873,0.30761,0.000097,0.000197,0.021766
LiberalArtsAndCrafts,31,20,8,28,64,25,89,7,0.280139,0.294875,0.000152,0.00031,0.016892
demihope,14,13,7,20,22,12,34,8,0.250845,0.265234,0.000039,0.00017,0.011622
nickcan,10,7,8,15,14,12,26,7,0.247798,0.261384,0.0001,0.000094,0.005083
spam__likely,16,16,13,29,28,17,45,7,0.296517,0.314074,0.000332,0.000146,0.018113
wellwisher-1,29,27,12,39,61,20,81,8,0.266836,0.285588,0.000309,0.000252,0.037097
Daniel_Kendall,60,12,17,29,39,52,91,7,0.305106,0.324761,0.000383,0.000346,0.006013
FaceInJuice,21,3,3,6,20,17,37,8,0.239642,0.249603,0.000001,0.000153,0.001007
Wonderful-Effort-466,10,12,1,13,13,1,14,8,0.23367,0.240614,0.000075,0.0001,0.005048
acesoverking,97,22,18,40,74,109,183,7,0.309972,0.329758,0.000828,0.000553,0.01235
Danny_DeWario,13,2,7,9,3,17,20,7,0.288306,0.303392,0.000012,0.000088,0.000359
InspectionDirection,83,45,32,77,133,85,218,7,0.309231,0.329406,0.002177,0.000727,0.027284
LUL_Level-Up-Life,11,9,10,19,15,14,29,7,0.274368,0.289046,0.000074,0.000077,0.013349
CyclopsRock,10,10,5,15,14,6,20,7,0.269023,0.281516,0.00002,0.000074,0.007159
DrawingOverall4306,18,23,9,32,32,14,46,7,0.285795,0.300687,0.00018,0.000204,0.013588
Ignore-Me_-,17,9,10,19,29,11,40,7,0.296925,0.316044,0.000168,0.000121,0.006973
Darnitol1,12,6,4,10,10,5,15,8,0.254452,0.264091,0.000052,0.000092,0.000589
DeathStrike56,16,8,10,18,17,42,59,7,0.301652,0.321643,0.0004,0.000172,0.00658
Agitated-Quit-6148,14,8,5,13,30,15,45,8,0.252101,0.263805,0.000023,0.000135,0.009707
No-Dinner-5894,31,14,8,22,63,27,90,7,0.278656,0.291512,0.00039,0.000285,0.005784
ObsidianKing,19,4,3,7,34,17,51,8,0.242881,0.251812,0.000006,0.000214,0.002586
welltechnically7,12,8,3,11,15,6,21,8,0.241084,0.251037,0.000006,0.000092,0.003255
Deep-Engine2367,13,3,8,11,8,18,26,7,0.286247,0.302235,0.000055,0.000119,0.001905
Hefty-Reaction-3028,15,18,12,30,32,18,50,8,0.284539,0.298214,0.000417,0.000229,0.012126
PandaDerZwote,17,13,6,19,25,11,36,8,0.262764,0.274114,0.000055,0.000169,0.006846
Paper-Dramatic,38,24,154,178,44,853,897,6,0.355104,0.392055,0.005644,0.000414,0.006636
VforVenndiagram_,18,11,5,16,26,14,40,7,0.279,0.292939,0.000081,0.000144,0.011433
Deep-Two7452,129,31,67,98,111,222,333,6,0.333628,0.361831,0.002622,0.000668,0.012662
Bitter-Assignment464,33,19,10,29,70,27,97,7,0.284039,0.30236,0.000747,0.000333,0.015218
Chowderr92,30,19,14,33,58,32,90,7,0.298569,0.316388,0.000389,0.000261,0.018964
Confident-Staff-8792,13,12,1,13,21,2,23,8,0.24339,0.252338,0.000009,0.000083,0.015558
Free-Database-9917,44,18,19,37,60,91,151,7,0.324171,0.347908,0.000451,0.000393,0.020565
GOT_Wyvern,11,12,7,19,23,10,33,7,0.281147,0.296461,0.000098,0.000125,0.010813
Gertrude_D,18,20,9,29,30,14,44,7,0.287574,0.300413,0.001379,0.000228,0.015198
JustifiedSinner01,17,6,4,10,43,16,59,8,0.261505,0.274936,0.000034,0.000205,0.005057
MajorPayne1911,12,15,28,43,25,64,89,7,0.309866,0.329615,0.000496,0.000189,0.009989
MyNameIsNotKyle,13,14,10,24,32,15,47,7,0.290544,0.30716,0.000154,0.00016,0.008611
Outcast129,11,11,4,15,22,6,28,7,0.268624,0.28247,0.00003,0.000095,0.009362
PIE-314,12,12,9,21,35,16,51,7,0.286754,0.302128,0.000322,0.000143,0.009903
RequirementRoyal8666,59,38,20,58,121,37,158,7,0.302943,0.321792,0.00128,0.000597,0.013904
Veritas_the_absolute,24,4,3,7,35,26,61,7,0.26715,0.280455,0.000004,0.000145,0.00349
Yippykyyyay,15,8,8,16,42,15,57,7,0.261098,0.271696,0.000359,0.000233,0.006223
humanino,11,9,7,16,15,13,28,7,0.269631,0.281966,0.000096,0.00016,0.014085
underboobfunk,10,16,8,24,23,10,33,7,0.288913,0.304591,0.000418,0.000145,0.011025
walkaroundmoney,14,9,3,12,23,10,33,7,0.269664,0.281618,0.000008,0.000111,0.006204
wuzxonrs,13,8,3,11,21,3,24,8,0.250872,0.261624,0.000031,0.00007,0.009888
AcanthocephalaLow502,23,5,5,10,36,13,49,8,0.268194,0.278923,0.000365,0.00021,0.001037
Conscious_Pen_3485,11,17,13,30,33,16,49,7,0.275035,0.289153,0.00024,0.000154,0.020211
Cool-Expression-4727,11,17,9,26,35,10,45,7,0.294722,0.310787,0.000309,0.000219,0.009102
Garganello,13,3,5,8,14,16,30,7,0.301933,0.320909,0.000053,0.000108,0.004193
GnomeChompskie,15,8,7,15,30,14,44,7,0.280642,0.295249,0.000053,0.000108,0.006036
LevelDry5807,26,11,11,22,44,22,66,7,0.299616,0.317657,0.00013,0.000203,0.007844
Realitymatter,13,5,4,9,22,10,32,8,0.228587,0.236705,0.000021,0.000194,0.0036
RebornGod,21,12,6,18,37,16,53,8,0.274618,0.288733,0.000129,0.000218,0.012703
Shadow42184,24,7,16,23,14,72,86,7,0.314514,0.333466,0.000138,0.000106,0.00503
SpotResident6135,23,12,8,20,48,17,65,7,0.285579,0.303413,0.000361,0.000186,0.015938
Taidixiong,11,13,6,19,24,8,32,7,0.283399,0.295898,0.000422,0.000152,0.011455
WillyShankspeare,21,16,10,26,47,20,67,7,0.300671,0.320515,0.000396,0.000202,0.01994
freakydeku,10,7,9,16,14,11,25,7,0.287501,0.303287,0.000051,0.000049,0.014758
illiter-it,10,9,32,41,13,77,90,8,0.309189,0.331692,0.000365,0.00012,0.002606
kittenTakeover,10,25,4,29,31,4,35,8,0.275152,0.287873,0.00009,0.000081,0.035765
Delicious_Delilah,64,2,22,24,5,47,52,7,0.277768,0.292155,0.000059,0.000041,0.000258
Aggravating_Kale8248,10,13,1,14,13,1,14,8,0.219844,0.226405,0.000107,0.000144,0.000999
GovernmentChance4182,13,4,12,16,8,29,37,7,0.28761,0.3015,0.000453,0.000081,0.001173
OceanBlueSeaTurtle,11,7,4,11,20,8,28,7,0.252847,0.262898,0.000018,0.000112,0.006535
Ok-Cardiologist8717,20,9,33,42,11,75,86,7,0.293386,0.310165,0.000958,0.000097,0.000811
cib0hph0bic,14,4,21,25,4,25,29,7,0.293957,0.30939,0.000402,0.000047,0.001632
godammitdonut,18,5,3,8,8,3,11,8,0.23793,0.245948,0.000234,0.000082,0.000448
java_sloth,17,5,7,12,10,11,21,8,0.261007,0.271775,0.000142,0.000087,0.00038
steelthyshovel73,13,4,2,6,16,5,21,9,0.196947,0.201651,0.000005,0.000149,0.000142
Wonderful-Group-8502,10,5,4,9,19,6,25,7,0.277173,0.291077,0.000017,0.000058,0.00302
Wooden_Ad_1019,24,12,29,41,28,50,78,7,0.314317,0.33711,0.000295,0.000235,0.005342
bastiancontrari,28,12,7,19,41,12,53,7,0.283932,0.300833,0.000142,0.000139,0.008736
coleman57,14,12,5,17,24,6,30,7,0.292703,0.307531,0.000666,0.000146,0.007974
ethanb473,15,16,4,20,19,4,23,8,0.259482,0.270057,0.000173,0.000139,0.010173
ghoulthebraineater,16,4,2,6,25,3,28,7,0.240406,0.248029,0.000017,0.000118,0.000805
sirswantepalm,69,24,33,57,81,93,174,7,0.313166,0.337478,0.001565,0.000445,0.016157
Designer-Chance-3590,15,4,20,24,6,29,35,7,0.264143,0.276226,0.00031,0.000131,0.000054
HR_King,11,7,3,10,9,3,12,8,0.225626,0.233713,0.000042,0.000101,0.000786
KrisHughes2,14,9,17,26,26,22,48,7,0.287537,0.302536,0.000767,0.000145,0.000634
LughCrow,20,14,5,19,22,11,33,8,0.239338,0.249174,0.00013,0.000144,0.001239
Particular_Can_7726,13,13,5,18,18,6,24,8,0.265273,0.276294,0.000601,0.00018,0.001931
Desperate_Donkey2212,22,8,24,32,12,34,46,6,0.239326,0.251674,0.000516,0.000215,0.000029
Permit-Extreme-117,25,16,18,34,31,21,52,7,0.244428,0.256522,0.001739,0.00021,0.000167
R4eth,18,21,6,27,26,7,33,7,0.227337,0.236746,0.000638,0.000143,0.000853
darkd360,23,7,6,13,14,11,25,8,0.252833,0.262321,0.000579,0.000148,0.000082
roseofjuly,12,14,5,19,16,5,21,7,0.214563,0.222687,0.000531,0.00023,0.000308
Disastrous-Fact-7782,14,12,21,33,20,38,58,6,0.334663,0.356002,0.000525,0.000162,0.015337
LongRest,10,11,4,15,23,5,28,7,0.268943,0.280929,0.000012,0.000144,0.00605
asr,15,14,8,22,36,18,54,7,0.286519,0.305002,0.000297,0.000257,0.016388
DisastrousClerk216,15,10,34,44,12,64,76,8,0.277359,0.29229,0.002823,0.000192,0.000136
Cakeday_at_Christmas,14,5,7,12,11,8,19,8,0.215759,0.223194,0.00017,0.000138,0.00008
Dizzy_Needleworker_3,43,16,14,30,41,21,62,8,0.253711,0.264056,0.002228,0.000362,0.00029
Intelligent_Arm_9241,13,7,2,9,8,2,10,8,0.209812,0.216052,0.000021,0.000073,0.000237
MACRS_or_Break,12,4,1,5,12,1,13,8,0.234408,0.241402,0.000067,0.000148,0.00008
No-Giraffe49,11,11,1,12,13,1,14,8,0.199612,0.205456,0.000071,0.000149,0.000459
SalaudChaud,13,8,1,9,8,1,9,9,0.180187,0.184148,0.000034,0.00011,0.000086
Smarterthanuthink867,20,8,6,14,10,6,16,8,0.228472,0.237479,0.000143,0.00011,0.000179
Super_Selection1522,10,5,1,6,15,3,18,9,0.214991,0.22086,0.000047,0.000083,0.000272
TheFilthyDIL,10,8,2,10,8,2,10,8,0.21027,0.216625,0.000037,0.000084,0.000232
keesouth,41,17,8,25,29,9,38,8,0.217062,0.225959,0.000341,0.000285,0.00029
Disastrous_Onion_958,14,7,12,19,13,28,41,7,0.289875,0.305777,0.000065,0.000104,0.002784
Frylock304,42,18,16,34,75,28,103,7,0.287428,0.303668,0.000329,0.000295,0.014836
Disastrous_Wave1283,10,5,19,24,8,74,82,7,0.302842,0.32179,0.000235,0.000093,0.004325
TheAzureMage,36,18,14,32,79,36,115,7,0.296342,0.312986,0.000301,0.000351,0.0112
Dismal-Ninja6343,12,3,14,17,3,23,26,8,0.210123,0.220389,0.000224,0.00013,0.000001
Accurate-Signature55,15,8,7,15,12,9,21,8,0.213551,0.222324,0.000118,0.000145,0.000046
EwwDavvidd,13,5,1,6,7,2,9,9,0.172593,0.176553,0.000224,0.000089,0.000058
LogicalHoney4689,10,3,2,5,4,2,6,9,0.181545,0.186354,0.000006,0.000067,0.000006
SaraAB87,11,6,4,10,16,6,22,8,0.203423,0.20964,0.00008,0.000296,0.00005
hamdinger125,13,7,10,17,21,14,35,8,0.215441,0.22487,0.000131,0.000228,0.000015
Dogago19,11,4,4,8,7,9,16,8,0.240469,0.24831,0.000022,0.000087,0.000192
Donkletown,126,45,64,109,244,555,799,7,0.335084,0.363636,0.003439,0.00096,0.019622
AnimateDuckling,13,11,4,15,21,8,29,7,0.257096,0.267774,0.000027,0.000136,0.009327
EH1987,71,13,9,22,109,43,152,7,0.292893,0.309705,0.000305,0.00056,0.013545
FriendofMolly,15,12,47,59,22,99,121,7,0.323916,0.348149,0.000614,0.000165,0.005593
JJ_Redditer,36,27,69,96,61,226,287,6,0.336104,0.360054,0.002912,0.000377,0.010637
Least_Inspector_5478,18,7,14,21,16,34,50,7,0.305168,0.323595,0.000098,0.00015,0.006551
Technical-King-1412,29,23,16,39,68,29,97,7,0.311507,0.332674,0.000719,0.000344,0.020186
Traditional_Still960,36,4,5,9,148,109,257,7,0.27402,0.290298,0.00003,0.000662,0.001624
dickermuffer,37,18,10,28,72,19,91,7,0.275085,0.290796,0.000385,0.000329,0.00944
fuggitdude22,10,15,2,17,23,4,27,8,0.239023,0.24816,0.000055,0.000178,0.015379
kjj34,77,33,17,50,132,76,208,7,0.297452,0.316403,0.00119,0.000801,0.014481
somefunmaths,10,8,7,15,17,9,26,7,0.284932,0.300278,0.000075,0.000113,0.005825
tarkinn,10,4,4,8,15,5,20,7,0.262429,0.275437,0.000023,0.00011,0.001441
Ancient_Confusion237,32,16,10,26,56,26,82,7,0.31029,0.328642,0.000383,0.00026,0.012663
IT_ServiceDesk,36,33,13,46,71,20,91,7,0.30993,0.327542,0.001407,0.000455,0.021897
JaggedMetalOs,27,14,6,20,35,12,47,7,0.28,0.29694,0.00016,0.000158,0.008807
Acrobatic-Hippo-6419,11,10,6,16,19,12,31,7,0.273804,0.286402,0.000161,0.000211,0.003067
Bitter_Detective4719,19,4,4,8,33,11,44,7,0.294378,0.312132,0.00003,0.000109,0.006599
Eldritch_Chemistry,10,7,3,10,26,12,38,8,0.23906,0.248282,0.00002,0.000146,0.014172
JRDZ1993,14,9,3,12,28,7,35,7,0.274236,0.286848,0.000045,0.000139,0.00667
Low_Imagination_1224,30,17,18,35,40,53,93,7,0.313296,0.33434,0.000515,0.000311,0.008938
Mcwedlav,14,9,4,13,33,12,45,7,0.257608,0.268857,0.000031,0.000251,0.005502
Proof-Technician-202,14,14,6,20,36,11,47,7,0.269295,0.283094,0.000244,0.000146,0.022711
Puresuner,26,6,5,11,48,14,62,7,0.268991,0.281015,0.00001,0.000224,0.002966
RareMajority,12,9,5,14,24,8,32,7,0.277359,0.292432,0.000099,0.000102,0.015184
Research_Matters,10,6,5,11,22,7,29,8,0.248573,0.259352,0.000018,0.000083,0.00408
Skwiish,12,5,3,8,20,4,24,8,0.269167,0.281915,0.000012,0.000082,0.010035
TVC_i5,27,9,6,15,46,23,69,8,0.258107,0.271188,0.000071,0.000335,0.008309
Tea-Unlucky,18,6,3,9,32,12,44,8,0.247,0.256483,0.00002,0.000159,0.00781
Timely-Way-4923,118,29,44,73,109,154,263,6,0.34127,0.365471,0.002323,0.000761,0.012426
Wayoutofthewayof,11,7,4,11,18,5,23,8,0.25029,0.25978,0.000039,0.000083,0.008426
Xepherya,25,16,6,22,29,13,42,7,0.269103,0.280054,0.000569,0.000212,0.004762
bigbjarne,17,5,6,11,25,18,43,7,0.251583,0.262822,0.00002,0.000155,0.001767
kinrove1386,44,15,13,28,80,36,116,7,0.286211,0.302001,0.000209,0.000337,0.006891
lastberserker,48,23,19,42,90,34,124,7,0.320388,0.342107,0.000826,0.000298,0.021514
mutantraniE,38,15,12,27,66,23,89,7,0.284253,0.298998,0.000249,0.00022,0.010447
rpolkcz,27,10,8,18,49,24,73,7,0.274535,0.288928,0.000134,0.000216,0.01097
vllaznia35,111,25,88,113,63,344,407,6,0.329694,0.358019,0.00251,0.000483,0.006699
Fun_Squirrel_9539,10,3,3,6,14,12,26,7,0.271344,0.286396,0.000003,0.000075,0.003042
LookWhatlCanDo,29,3,3,6,60,32,92,7,0.265179,0.278717,0.000004,0.000331,0.001344
Barqa,14,12,7,19,35,14,49,7,0.27321,0.287607,0.000083,0.000177,0.011291
DiscordianDreams,16,5,3,8,20,18,38,8,0.255861,0.266092,0.000027,0.000229,0.002822
HiHoJufro,12,13,7,20,23,7,30,7,0.279464,0.295517,0.00008,0.00011,0.011672
LvL98MissingNo,12,8,5,13,26,11,37,7,0.279258,0.292525,0.000038,0.000166,0.004581
Red_Canuck,10,5,3,8,16,9,25,7,0.263176,0.276042,0.000014,0.000092,0.005057
Retr0r0cketVersion2,13,5,4,9,21,16,37,7,0.261444,0.274893,0.000011,0.000176,0.003517
Treon_Lotsky,16,16,7,23,35,13,48,7,0.278828,0.295192,0.000107,0.000215,0.013603
Dramatic_Board891,33,6,11,17,21,34,55,7,0.308873,0.327387,0.000139,0.000192,0.004553
caseybvdc74,38,13,19,32,27,36,63,7,0.305559,0.327388,0.000344,0.000318,0.00593
Dreadsin,24,9,48,57,17,83,100,7,0.305828,0.325234,0.002128,0.000246,0.000415
Asher-D,15,7,8,15,28,10,38,8,0.268226,0.27952,0.000262,0.00014,0.000919
IDontKnowMyUsernameq,12,7,3,10,8,5,13,8,0.226631,0.233764,0.000314,0.000337,0.000393
Jordangander,20,14,4,18,26,8,34,8,0.231828,0.239386,0.000322,0.000189,0.001612
Kittymeow123,14,11,5,16,22,12,34,7,0.286555,0.299452,0.000521,0.000092,0.004104
Kobe_stan_,11,8,2,10,24,9,33,8,0.248997,0.259934,0.000053,0.000103,0.007007
Mike__O,22,12,5,17,25,8,33,7,0.267513,0.278283,0.000443,0.000206,0.002629
Some_nerd_______,11,4,3,7,5,3,8,8,0.236279,0.244643,0.000072,0.000078,0.000324
TheSkyIsBeautiful,16,7,3,10,29,4,33,8,0.239376,0.246866,0.000068,0.000148,0.000612
burnfaith,17,7,6,13,11,10,21,7,0.259646,0.271651,0.000119,0.000137,0.001113
cerialthriller,16,8,4,12,17,12,29,7,0.247189,0.255062,0.000103,0.000177,0.000753
dankp3ngu1n69,15,12,3,15,23,3,26,7,0.252678,0.26158,0.000591,0.000271,0.001069
davidm2232,31,14,10,24,39,16,55,7,0.286138,0.300398,0.000597,0.000125,0.003034
koosley,20,17,11,28,27,15,42,8,0.263513,0.274295,0.000465,0.000201,0.001974
massinvader,33,11,6,17,54,11,65,8,0.221445,0.229403,0.000091,0.00015,0.000769
Drob10,18,1,14,15,2,40,42,7,0.268322,0.283167,0.000067,0.000052,0.000106
Anomander,65,19,7,26,36,13,49,8,0.238645,0.247411,0.000819,0.000296,0.001495
ProofJournalist,19,5,1,6,6,2,8,9,0.200638,0.205176,0.000006,0.000106,0.00038
Sad-Paramedic-8523,20,11,8,19,33,13,46,7,0.265771,0.27735,0.001541,0.000156,0.006242
Droopynator,10,4,25,29,4,40,44,7,0.292156,0.309285,0.000502,0.000103,0.00006
PathlessMammal,13,8,4,12,18,7,25,8,0.225649,0.232753,0.000092,0.000149,0.000621
Planterizer,12,6,4,10,26,8,34,7,0.285148,0.29957,0.000094,0.000088,0.010087
benji_billingsworth,36,6,6,12,13,11,24,8,0.241688,0.250828,0.000109,0.000156,0.000268
emilia12197144,37,16,8,24,27,11,38,8,0.247906,0.257867,0.000403,0.000258,0.001776
youchasechickens,21,9,5,14,16,12,28,8,0.241688,0.250275,0.000206,0.000204,0.000539
Drphatkat,43,1,19,20,1,153,154,8,0.269039,0.282473,0.000029,0.000044,0.000063
CombinationRough8699,21,9,10,19,48,18,66,8,0.269792,0.283293,0.000627,0.000225,0.001245
DazzlingFruit7495,28,4,3,7,70,34,104,8,0.216171,0.224097,0.000048,0.000376,0.000253
Knight_Machiavelli,43,13,12,25,42,15,57,7,0.264405,0.280172,0.000713,0.00016,0.007764
Magic_Man_Boobs,25,10,6,16,29,14,43,8,0.254153,0.263744,0.000527,0.000196,0.004928
ReactionAble7945,45,19,6,25,40,15,55,7,0.266961,0.279738,0.001171,0.000394,0.009885
Sniper_96_,17,6,4,10,32,10,42,7,0.254167,0.265427,0.000018,0.000127,0.00549
SpaceCowboy1929,11,4,2,6,23,3,26,9,0.212949,0.219429,0.000017,0.000072,0.000207
Spirited-Feed-9927,12,15,4,19,30,7,37,8,0.243416,0.252598,0.000223,0.000143,0.008439
TheMuffler42069,31,5,3,8,71,37,108,9,0.206756,0.212221,0.000152,0.000371,0.005453
volvavirago,13,10,2,12,24,5,29,8,0.238481,0.246834,0.000027,0.000083,0.016205
DryCaterpillar5351,19,11,28,39,19,48,67,6,0.328569,0.350854,0.000554,0.000143,0.007156
DT-Sodium,12,8,5,13,17,9,26,7,0.296672,0.312759,0.000052,0.000088,0.010012
DinkandDrunk,13,12,6,18,22,9,31,7,0.265568,0.278522,0.000083,0.000139,0.0126
KFrancesC,22,6,5,11,48,20,68,7,0.265242,0.276542,0.000011,0.000264,0.001446
Vertigobee,24,10,9,19,51,17,68,7,0.287483,0.301471,0.000121,0.000196,0.00544
Due_Air_7255,13,2,3,5,3,5,8,7,0.22382,0.231093,0.000364,0.000169,0.000128
Ok-Recipe5434,10,6,3,9,22,8,30,8,0.231532,0.240026,0.000006,0.000132,0.006006
VorpalSplade,12,6,5,11,22,13,35,7,0.290637,0.308003,0.000108,0.000127,0.003684
Duke_Nicetius,13,2,4,6,6,5,11,8,0.227382,0.234399,0.000022,0.000103,0.000171
00rb,16,6,6,12,9,7,16,8,0.248505,0.258707,0.000271,0.0001,0.001267
DumbMudDrumbBuddy,13,5,22,27,8,40,48,7,0.294206,0.309042,0.00051,0.00012,0.000107
3WayIntersection,54,12,12,24,90,42,132,7,0.280035,0.294562,0.000894,0.00041,0.001927
Emmyisme,13,8,2,10,9,2,11,9,0.190952,0.19482,0.000026,0.000111,0.000735
Rfg711,10,5,2,7,16,4,20,7,0.275873,0.286797,0.000162,0.000106,0.001347
Visual_Disaster,11,6,3,9,24,9,33,8,0.242998,0.251207,0.000116,0.000145,0.000711
Early-Possibility367,15,7,19,26,9,27,36,7,0.315478,0.334353,0.000234,0.000149,0.003368
QuercusSambucus,10,8,7,15,24,8,32,7,0.273325,0.28661,0.00004,0.000175,0.003204
Brainsonastick,19,15,6,21,32,14,46,7,0.246329,0.256729,0.000414,0.000277,0.006413
Economy-Trip728,12,4,6,10,4,16,20,8,0.244705,0.254022,0.000577,0.000258,0.000313
InfernalOrgasm,70,10,9,19,21,15,36,9,0.219492,0.227807,0.000508,0.000287,0.000918
PrivilegeCheckmate,17,4,2,6,13,7,20,8,0.233791,0.242456,0.000026,0.000159,0.000841
Treethorn_Yelm,14,4,1,5,12,1,13,9,0.196605,0.201271,0.000135,0.00022,0.000074
EdHistory101,71,16,20,36,67,83,150,7,0.297003,0.313895,0.000394,0.000611,0.003984
AureliasTenant,19,12,7,19,32,16,48,7,0.271409,0.286372,0.000143,0.000167,0.009067
LtMM_,26,11,7,18,57,26,83,7,0.280052,0.294866,0.000095,0.00024,0.005841
EdgarKafka,22,13,86,99,20,494,514,7,0.340424,0.370857,0.001556,0.000214,0.004667
BlasphemousRykard,32,15,8,23,48,8,56,7,0.279844,0.295642,0.000369,0.000199,0.013
CriskCross,17,6,4,10,25,20,45,8,0.250138,0.260097,0.000145,0.000195,0.007389
DaRandomRhino,12,6,5,11,12,9,21,8,0.25451,0.264921,0.000037,0.000076,0.004905
ExpressLaneCharlie,16,6,4,10,25,6,31,8,0.2588,0.269887,0.000011,0.000102,0.004996
Funkywurm,15,12,10,22,38,16,54,7,0.296342,0.313337,0.000199,0.000188,0.011307
Iconic_Mithrandir,11,14,11,25,23,15,38,7,0.282974,0.299513,0.000172,0.0001,0.011704
Imaginary-Fact-3486,10,7,3,10,13,6,19,7,0.303858,0.320918,0.000009,0.000072,0.00804
LessBalance6122,11,8,4,12,15,10,25,7,0.283116,0.296781,0.000098,0.000136,0.007827
Low-Staff7002,11,4,7,11,29,11,40,7,0.273722,0.287367,0.000028,0.000093,0.002402
Manaliv3,17,7,5,12,23,12,35,8,0.230004,0.238031,0.000314,0.000212,0.004747
Personal-Advance-494,28,24,11,35,62,21,83,7,0.309379,0.327701,0.000769,0.000293,0.014212
PriceofObedience,13,13,7,20,19,9,28,7,0.29161,0.310646,0.000203,0.000139,0.014221
Square-Bite1355,10,6,5,11,25,11,36,7,0.274501,0.287759,0.000026,0.000147,0.007633
TheGreatBenjie,16,5,2,7,39,17,56,8,0.239617,0.248904,0.000003,0.000232,0.002131
TheOneFreeEngineer,26,15,15,30,45,30,75,7,0.2971,0.312365,0.000208,0.000215,0.015735
Warny55,85,34,114,148,87,583,670,6,0.362901,0.397303,0.006339,0.000669,0.014523
djjmar92,10,6,7,13,25,10,35,7,0.283968,0.298956,0.000172,0.000103,0.007232
madmaxwashere,19,12,7,19,47,22,69,7,0.265724,0.280115,0.000076,0.000238,0.011831
oingerboinger,15,19,10,29,32,14,46,7,0.281724,0.297378,0.000319,0.000219,0.009538
pine905,39,13,32,45,41,90,131,7,0.316028,0.338554,0.00085,0.000321,0.01055
sahuxley2,10,6,8,14,14,14,28,7,0.298865,0.316453,0.000071,0.00006,0.00927
tres_ecstuffuan,12,4,4,8,28,15,43,8,0.255256,0.266128,0.000009,0.000128,0.001868
wildcatwoody,13,13,11,24,28,13,41,7,0.289949,0.30613,0.00019,0.00012,0.009388
EducationalWin5908,11,3,6,9,3,11,14,8,0.205967,0.212846,0.000027,0.000075,0.000014
EfficiencyHonest9381,15,7,19,26,11,30,41,7,0.304881,0.326008,0.000326,0.000131,0.003773
Frix,15,8,4,12,14,9,23,7,0.253498,0.264442,0.000117,0.000102,0.006736
Thinslayer,52,8,4,12,106,56,162,8,0.243377,0.252943,0.000019,0.000579,0.003447
Efficient_Tip_9991,25,2,5,7,2,6,8,8,0.231378,0.23984,0.000022,0.000072,0.000043
shitposts_over_9000,19,4,3,7,6,3,9,8,0.235175,0.243531,0.000049,0.000076,0.000252
Either-Log-1570,30,3,6,9,3,12,15,8,0.241007,0.248249,0.000155,0.000078,0.000055
brutishbloodgod,12,2,2,4,9,6,15,9,0.212121,0.217608,0.000004,0.000129,0.00005
firematt422,14,6,5,11,9,5,14,8,0.235726,0.245556,0.000235,0.000083,0.001318
Embarrassed-Dress211,20,13,32,45,22,57,79,7,0.319011,0.342716,0.000469,0.000209,0.006805
Ace0spades808,19,12,7,19,37,13,50,7,0.287027,0.303346,0.000145,0.000143,0.006745
FishyWishySwishy,20,9,2,11,47,16,63,8,0.224352,0.230616,0.000016,0.000202,0.007019
The-_Captain,53,23,61,84,35,181,216,7,0.328212,0.354392,0.001312,0.000335,0.006066
EmbarrassedFront3705,22,6,26,32,10,87,97,7,0.285219,0.298961,0.001645,0.000221,0.000042
Acrobatic_Hippo_9593,12,10,3,13,13,5,18,8,0.20535,0.210978,0.000251,0.000163,0.000196
Elegant-Bee7654,19,8,8,16,42,9,51,7,0.24845,0.258463,0.00054,0.000115,0.000414
EnterprisingAss,31,15,44,59,27,206,233,6,0.334367,0.359112,0.001962,0.000205,0.00654
ImpossibleReason2204,44,16,11,27,47,21,68,7,0.304062,0.320172,0.007228,0.000429,0.00561
Particular-Wind5918,14,3,3,6,17,3,20,7,0.229502,0.237594,0.00002,0.000084,0.000109
RefrigeratorFun4676,12,7,4,11,9,4,13,8,0.215206,0.223146,0.000055,0.000109,0.000146
SoccerProblem3547,42,15,12,27,28,18,46,8,0.232543,0.242799,0.000462,0.000401,0.000141
epichuntarz,22,11,9,20,20,13,33,8,0.239212,0.248598,0.000561,0.000304,0.000126
homtulce,15,2,4,6,9,5,14,8,0.236959,0.244732,0.000046,0.000076,0.000062
owls_and_cardinals,25,15,6,21,23,7,30,8,0.226009,0.233988,0.000717,0.000266,0.000191
reredd1tt1n,43,15,12,27,28,22,50,7,0.30396,0.320244,0.004275,0.000344,0.0058
shortasalways,12,6,3,9,10,5,15,8,0.234931,0.242793,0.000074,0.000108,0.000179
wrenwynn,11,12,6,18,18,6,24,8,0.242348,0.251666,0.001014,0.000122,0.002751
Embarrassed_Field_84,22,8,20,28,14,50,64,8,0.260587,0.273493,0.000519,0.000179,0.000311
MrCockingFinally,11,7,2,9,11,2,13,8,0.223246,0.229748,0.000035,0.000067,0.000877
Waberweeber,22,8,16,24,20,30,50,7,0.270307,0.282944,0.000637,0.000201,0.000398
aj_future,10,4,3,7,8,9,17,8,0.201827,0.206743,0.000013,0.000218,0.000099
guyincognito121,13,5,4,9,12,5,17,8,0.24657,0.256031,0.000107,0.00007,0.000684
hellonameismyname,12,5,4,9,19,10,29,8,0.229561,0.237233,0.000021,0.000164,0.000156
icecubtrays,12,3,2,5,12,2,14,8,0.243311,0.252178,0.000009,0.000062,0.000865
shadracko,10,5,3,8,9,4,13,8,0.242686,0.250988,0.0001,0.000078,0.000995
vrnvorona,16,14,11,25,34,14,48,8,0.249449,0.258924,0.000687,0.000233,0.001489
Bandro,15,10,7,17,13,10,23,8,0.237183,0.246329,0.000194,0.000173,0.000595
Severe-Bicycle-9469,20,15,12,27,32,19,51,7,0.274269,0.287468,0.001078,0.000221,0.012608
amstrumpet,15,9,6,15,10,6,16,7,0.240214,0.248521,0.000197,0.000174,0.000303
EnbySheriff,14,4,15,19,4,28,32,8,0.256586,0.267161,0.00031,0.000132,0.000152
Loose_Biscotti9075,11,7,2,9,11,2,13,8,0.20686,0.212274,0.000082,0.000109,0.001594
tolgren,13,14,2,16,23,2,25,8,0.234142,0.241995,0.000034,0.000093,0.017158
EnderSlayer9977,25,9,22,31,15,34,49,7,0.317579,0.340169,0.000319,0.000153,0.005658
DadTheMaskedTerror,14,8,4,12,19,8,27,7,0.275503,0.289085,0.000015,0.000097,0.007634
DominionSeraph,12,9,6,15,16,9,25,7,0.266052,0.279405,0.00004,0.000107,0.005741
MercurianAspirations,16,21,6,27,30,9,39,7,0.284235,0.299843,0.000248,0.000199,0.012237
blitzkrieg_bop,13,10,11,21,16,23,39,7,0.306158,0.325365,0.000072,0.000133,0.007312
Maximum-Lack8642,12,15,6,21,28,7,35,7,0.271295,0.284715,0.000069,0.000128,0.009513
RandomizedNameSystem,12,8,3,11,10,3,13,8,0.247716,0.256725,0.000141,0.000082,0.003929
Realistic_Yogurt1902,17,7,3,10,19,12,31,7,0.258195,0.270035,0.00006,0.000145,0.007175
mavrik36,10,6,4,10,25,12,37,7,0.273523,0.285815,0.00004,0.000161,0.003562
EnvironmentalCow6217,38,5,6,11,17,24,41,9,0.197972,0.205687,0.000122,0.000645,0.000008
CoverCharacter8179,10,8,2,10,8,2,10,9,0.207334,0.213149,0.000067,0.000136,0.00006
Equivalent_Day_4078,15,6,16,22,18,86,104,7,0.309993,0.32986,0.000138,0.00016,0.003768
IceNeun,14,8,5,13,23,12,35,7,0.274618,0.287643,0.00002,0.000082,0.004542
PlainSodaWater,17,6,4,10,26,12,38,7,0.262642,0.27359,0.000056,0.000126,0.003405
EstablishmentKooky50,65,12,15,27,77,88,165,6,0.324659,0.347074,0.000542,0.000438,0.010191
Ok_Bag6451,40,15,10,25,60,38,98,7,0.282974,0.297765,0.000241,0.000316,0.007392
Saargb,18,8,7,15,34,7,41,7,0.278109,0.293431,0.000065,0.000125,0.00405
atav1k,11,5,3,8,16,10,26,7,0.273029,0.285766,0.000021,0.000111,0.004274
Even-Ad-9930,11,9,19,28,12,48,60,7,0.303756,0.321751,0.000194,0.000101,0.003931
Gremlin95x,10,16,6,22,27,9,36,8,0.258269,0.271544,0.00006,0.000138,0.007746
Every_Ease1297,44,14,23,37,21,48,69,7,0.243129,0.254912,0.002049,0.000467,0.000169
1RainbowUnicorn,15,13,5,18,21,8,29,8,0.209899,0.217091,0.000072,0.000265,0.000169
Alternative_End_7174,13,5,3,8,30,3,33,8,0.200638,0.207394,0.000033,0.000089,0.000129
Grrrrr_Arrrrrgh,14,6,5,11,9,5,14,7,0.246248,0.25558,0.000405,0.000143,0.000196
Sea_Owl6146,22,6,5,11,11,5,16,8,0.22249,0.23031,0.000066,0.000188,0.000037
Shadow4summer,19,5,7,12,6,7,13,8,0.249587,0.258737,0.000233,0.000053,0.000248
ShagFit,22,10,12,22,56,27,83,7,0.288821,0.301989,0.001587,0.000327,0.005857
throwAWweddingwoe,16,7,2,9,14,4,18,8,0.200736,0.206761,0.000033,0.000168,0.000055
Everyones-Bro,39,18,31,49,38,62,100,6,0.332843,0.357555,0.001768,0.000325,0.011122
No-Ear7988,19,18,25,43,37,34,71,7,0.286791,0.303909,0.00671,0.000163,0.024057
figuring_ItOut12,30,21,12,33,59,25,84,7,0.26549,0.282137,0.00013,0.000296,0.025104
Borigh,22,6,5,11,36,15,51,7,0.262429,0.275176,0.000026,0.00018,0.002748
Excellent_Chest_5896,38,13,113,126,16,337,353,7,0.33801,0.370783,0.003166,0.000225,0.00476
According-Werewolf10,11,4,3,7,15,5,20,8,0.250512,0.260214,0.000016,0.000076,0.005696
AndlenaRaines,13,16,8,24,23,11,34,8,0.255934,0.268619,0.000138,0.000152,0.012419
Beljuril-home,12,3,1,4,14,9,23,8,0.224988,0.232249,0.000002,0.000118,0.003827
CaptainFingerling,10,12,9,21,22,11,33,7,0.295549,0.315549,0.000263,0.00011,0.011468
Caracalla81,53,20,16,36,87,50,137,7,0.308452,0.328149,0.000782,0.000507,0.016067
Carlpanzram1916,19,22,8,30,34,11,45,7,0.27229,0.28754,0.000483,0.000273,0.012493
ContextEffects01,15,7,4,11,39,20,59,7,0.260018,0.272684,0.000028,0.000213,0.013751
Either_Operation7586,10,10,8,18,13,8,21,8,0.246008,0.2577,0.000279,0.000081,0.013768
Every3Years,13,9,11,20,36,14,50,7,0.279447,0.293387,0.00018,0.000121,0.005283
Harbinger2001,10,10,3,13,21,8,29,8,0.23361,0.241246,0.000023,0.000113,0.008263
King-JelIy,15,7,12,19,9,31,40,8,0.288398,0.303746,0.000056,0.000108,0.002473
Nodaker1,10,9,6,15,25,9,34,7,0.268497,0.283474,0.000105,0.000139,0.011246
Passive_Menis79,14,13,2,15,36,5,41,7,0.275152,0.28891,0.000025,0.000123,0.022669
Savings-Willow4709,10,8,5,13,15,8,23,7,0.25749,0.268934,0.000083,0.000072,0.007714
Shadeylark,23,13,8,21,42,21,63,7,0.28761,0.304898,0.000068,0.000178,0.02238
Sspifffyman,11,10,9,19,12,10,22,7,0.287136,0.30501,0.00015,0.000089,0.013683
Yntol,12,7,3,10,24,8,32,8,0.241701,0.251803,0.000059,0.000117,0.007356
ZeerVreemd,38,11,12,23,77,32,109,7,0.292647,0.309205,0.000162,0.000242,0.011813
fox-mcleod,58,25,21,46,86,50,136,7,0.306718,0.325834,0.001053,0.000499,0.017215
h0sti1e17,12,14,7,21,26,8,34,7,0.278862,0.292595,0.000057,0.000086,0.017467
qstomizecom,12,4,3,7,22,10,32,7,0.261777,0.274145,0.000011,0.000109,0.008443
rbminer456,44,21,40,61,31,110,141,7,0.329502,0.355305,0.001429,0.000316,0.013997
sal696969,10,18,5,23,31,6,37,7,0.260153,0.270846,0.000165,0.0002,0.015277
sumit24021990,20,12,11,23,45,22,67,7,0.293272,0.309169,0.000176,0.000201,0.009504
thoughtsome,15,7,5,12,24,9,33,7,0.281077,0.295555,0.000043,0.000117,0.00677
Exciting_Sky1634,11,2,2,4,5,7,12,8,0.21337,0.220293,0.000008,0.000112,0.00004
ExoG198765432,33,6,10,16,14,18,32,7,0.291573,0.304904,0.000485,0.000254,0.00019
ChronaMewX,10,9,5,14,15,10,25,7,0.248669,0.258791,0.00046,0.000185,0.002185
Expensive_Choice2742,15,0,3,3,0,7,7,7,0.221668,0.22812,0,0.000033,0
IWannaHideThrowaway,20,4,16,20,6,38,44,6,0.277631,0.290193,0.001561,0.000252,0.000001
ExternalSeat,31,16,39,55,29,107,136,7,0.307238,0.3274,0.000681,0.000267,0.003615
Accomplished_Mind792,22,7,4,11,36,9,45,8,0.239313,0.24745,0.000045,0.000146,0.004214
ZappSmithBrannigan,41,29,18,47,65,30,95,7,0.299141,0.316314,0.001467,0.000346,0.014052
redhillbones,25,17,15,32,47,22,69,7,0.273738,0.288466,0.000248,0.00019,0.010721
redroserequiems,19,3,2,5,5,5,10,7,0.265413,0.277319,0.000003,0.000076,0.003498
unbelizeable1,22,10,8,18,37,13,50,7,0.278485,0.292365,0.000058,0.000151,0.00879
Fabulous-Earth-4871,15,5,10,15,11,30,41,7,0.305766,0.324073,0.000084,0.000092,0.003796
dragonfirestorm948,26,6,12,18,21,26,47,7,0.31061,0.329364,0.000166,0.00015,0.003381
Adventurous_Class_90,14,8,4,12,35,15,50,8,0.24493,0.255035,0.000037,0.000379,0.007894
CEO-Soul-Collector,11,7,3,10,13,6,19,8,0.25796,0.268297,0.00009,0.000104,0.007311
ChickerWings,22,14,5,19,41,13,54,7,0.267814,0.281061,0.000362,0.000207,0.009258
Chocotacoturtle,27,17,10,27,43,16,59,7,0.272143,0.287115,0.000267,0.000214,0.014747
Former_Star1081,12,8,2,10,23,6,29,7,0.271865,0.285545,0.000033,0.000086,0.008745
Guldur,11,7,4,11,18,6,24,7,0.272323,0.285368,0.000032,0.000066,0.006305
HImainland,22,11,6,17,43,11,54,7,0.273755,0.287158,0.000135,0.000181,0.005143
Obvious_Chapter2082,41,28,16,44,65,24,89,8,0.287136,0.303548,0.00118,0.000384,0.015026
Scrappy_101,19,13,10,23,43,24,67,7,0.28308,0.298273,0.000288,0.000215,0.010538
ThatOtherGuyTPM,22,13,11,24,33,20,53,7,0.293253,0.31521,0.000465,0.000199,0.015009
Writing_is_Bleeding,17,16,8,24,33,14,47,7,0.27402,0.286944,0.000274,0.000198,0.009174
YouLearnedNothing,19,15,8,23,43,12,55,7,0.269231,0.282239,0.000211,0.000165,0.01583
alaskanperson,26,11,3,14,23,6,29,8,0.237245,0.246657,0.000039,0.000163,0.009753
azuredota,14,7,5,12,33,13,46,7,0.252017,0.262913,0.000039,0.000153,0.004026
cant_pass_CAPTCHA,14,15,8,23,23,10,33,7,0.278075,0.292485,0.000191,0.000126,0.011779
captainhukk,16,5,2,7,23,15,38,7,0.253314,0.26416,0.000006,0.000095,0.005548
cutegolpnik,10,6,4,10,25,12,37,7,0.249463,0.260344,0.000035,0.000158,0.008201
kkdawg22,24,20,15,35,50,20,70,7,0.296226,0.313982,0.000359,0.000156,0.026018
ranchojasper,29,18,18,36,47,21,68,8,0.301551,0.315792,0.003439,0.000311,0.010883
Fando1234,17,14,27,41,21,56,77,7,0.312604,0.334758,0.000459,0.000191,0.008307
Mestoph,13,6,3,9,26,15,41,7,0.296653,0.312192,0.000044,0.000092,0.007617
Zerguu,15,9,2,11,16,3,19,8,0.246235,0.255269,0.000026,0.000139,0.006414
ZeusThunder369,31,22,43,65,39,144,183,6,0.330126,0.354512,0.002035,0.000304,0.010576
kyngston,12,10,6,16,17,7,24,7,0.273292,0.287608,0.000281,0.000122,0.003905
WaterNerd518,10,10,6,16,25,11,36,8,0.264236,0.280311,0.000092,0.000157,0.005959
generallydisagree,31,36,17,53,87,28,115,7,0.284968,0.300654,0.00128,0.000494,0.020379
Far-Oven-6023,12,5,33,38,5,41,46,7,0.265413,0.279755,0.001338,0.000124,0.000037
Unrelated_gringo,31,7,6,13,50,32,82,8,0.220143,0.227307,0.000261,0.00041,0.000099
jmgolden33,10,5,2,7,9,4,13,8,0.200923,0.207293,0.00002,0.000137,0.000075
silfy_star,14,8,2,10,13,5,18,8,0.229351,0.236684,0.000189,0.000202,0.000186
treehuggerfroglover,19,13,6,19,27,13,40,8,0.265195,0.274963,0.002829,0.000276,0.002637
uber_neutrino,37,20,12,32,63,27,90,7,0.282603,0.299273,0.000836,0.000285,0.017647
use_your_smarts,11,10,7,17,18,7,25,8,0.255097,0.265499,0.000915,0.000072,0.000576
Far_Reindeer3003,53,19,34,53,47,95,142,7,0.321548,0.341398,0.001531,0.000503,0.004977
Monte_Cristos_Count,11,9,2,11,14,4,18,8,0.247838,0.256682,0.000094,0.000125,0.001534
Saranoya,47,15,31,46,50,91,141,7,0.313708,0.336421,0.000735,0.000436,0.005149
panna__cotta,10,6,4,10,21,10,31,7,0.266522,0.278273,0.000021,0.000135,0.004625
physioworld,24,17,50,67,22,272,294,6,0.326626,0.350946,0.002536,0.00018,0.008892
tanglekelp,10,10,6,16,19,9,28,7,0.301672,0.318573,0.000075,0.000087,0.01049
FeedingCactus,10,1,7,8,1,12,13,8,0.227439,0.236263,0.000054,0.00006,0.000059
Cynykl,14,11,4,15,13,4,17,8,0.227932,0.235519,0.000463,0.000116,0.001936
StrategericAmbiguity,11,5,3,8,8,4,12,8,0.211655,0.21822,0.000055,0.000116,0.000106
alvysinger0412,13,7,2,9,9,2,11,9,0.206983,0.212283,0.00002,0.000062,0.000904
theGRAYblanket,17,6,3,9,9,3,12,8,0.238972,0.24632,0.000053,0.000113,0.000394
Feisty-Giraffe-8650,23,8,12,20,19,29,48,7,0.293462,0.311154,0.000062,0.0002,0.003772
charlesth1ckens,26,31,15,46,78,31,109,7,0.287391,0.305245,0.000674,0.000516,0.01202
Felix_Fickelgruber,10,2,19,21,4,49,53,7,0.289208,0.302026,0.000384,0.000104,0.000054
Anon-Sham,15,6,4,10,11,6,17,9,0.216429,0.223031,0.000075,0.000129,0.000268
fishbikerun,16,4,20,24,4,26,30,8,0.256804,0.2689,0.001246,0.000075,0.00024
quick_justice,10,9,1,10,12,2,14,8,0.186571,0.191256,0.000005,0.000111,0.000343
Aneurhythms,13,10,5,15,23,11,34,8,0.253342,0.265889,0.00003,0.000116,0.011081
BothDiscussion9832,22,22,15,37,33,17,50,8,0.261053,0.276438,0.000181,0.000197,0.024466
DMayleeRevengeReveng,19,15,7,22,47,16,63,8,0.266318,0.283532,0.000124,0.000181,0.011193
Marchtmdsmiling,19,14,15,29,32,25,57,7,0.274385,0.295995,0.000069,0.000173,0.007789
NepheliLouxWarrior,16,20,6,26,21,7,28,8,0.261837,0.276624,0.000149,0.000178,0.016175
PropofolMargarita,11,6,9,15,26,11,37,8,0.271295,0.289232,0.00004,0.000082,0.009527
Serious_Senator,13,9,9,18,27,14,41,8,0.262794,0.275935,0.000112,0.000115,0.014857
SkeptioningQuestic,10,8,4,12,9,5,14,8,0.240508,0.251071,0.000078,0.000098,0.004923
SkiingAway,12,10,5,15,16,8,24,7,0.251402,0.263163,0.000058,0.000116,0.014213
TJ11240,10,7,4,11,19,8,27,8,0.244428,0.257341,0.000022,0.000118,0.004227
Time_Minute_6036,24,10,252,262,18,891,909,7,0.340706,0.38448,0.002104,0.00017,0.010268
Unfounded_archeology,10,3,4,7,6,5,11,8,0.239149,0.25187,0.000004,0.000053,0.001595
bionicfeetgrl,16,11,7,18,20,13,33,7,0.259037,0.271329,0.002228,0.000194,0.007094
wha-haa,36,26,26,52,48,33,81,7,0.282093,0.301389,0.00054,0.000236,0.027812
Few_Republic1136,13,4,20,24,6,61,67,7,0.285399,0.298479,0.000281,0.000102,0.000604
Privacy-Boggle,17,9,4,13,12,5,17,8,0.234021,0.241853,0.00031,0.000165,0.000484
moist-astronaut,17,6,4,10,34,18,52,8,0.25313,0.262556,0.000048,0.00018,0.000886
rescuers_downunder,60,16,19,35,59,39,98,7,0.274435,0.287386,0.00072,0.000394,0.001511
sovereignlogik,19,9,5,14,13,7,20,7,0.261565,0.271927,0.000131,0.000141,0.000756
whenishit-itsbigturd,17,9,5,14,12,5,17,8,0.234045,0.242435,0.000207,0.000119,0.003377
Fickle-Syllabub6730,14,2,8,10,3,12,15,9,0.229514,0.241145,0.000069,0.000083,0.000022
FinTecTec,10,3,8,11,3,13,16,7,0.305786,0.325558,0.000013,0.000042,0.005336
Financial_Pound_9448,12,1,2,3,6,15,21,8,0.20303,0.208795,0,0.000095,0.000001
FindingWise7677,14,15,15,30,20,23,43,8,0.272897,0.28553,0.001012,0.000228,0.000862
Affectionate-Key-265,18,8,4,12,12,5,17,8,0.239237,0.247358,0.000048,0.000105,0.000551
amf_devils_best,12,8,6,14,29,13,42,7,0.263161,0.274009,0.000115,0.000209,0.006056
sparklybeast,15,10,6,16,16,7,23,8,0.225897,0.233774,0.000271,0.000215,0.000981
FireflyRebellion,12,6,9,15,11,20,31,7,0.265226,0.278022,0.000078,0.000138,0.001377
ComfortRelative1884,15,4,4,8,17,14,31,7,0.259512,0.270387,0.00003,0.000127,0.002052
Due_Visual_4613,10,8,4,12,22,7,29,7,0.25241,0.263241,0.000051,0.000136,0.00357
FishFollower74,10,3,3,6,5,14,19,9,0.218613,0.228466,0.000061,0.000106,0.000325
Impressive-Floor-700,20,3,3,6,8,5,13,8,0.214624,0.222916,0.000028,0.00009,0.000077
checker280,54,30,25,55,76,31,107,8,0.272159,0.293049,0.001374,0.000365,0.018528
Fisics_,21,13,181,194,27,1299,1326,6,0.361828,0.400523,0.003929,0.000239,0.005076
81forest,10,8,8,16,22,12,34,7,0.297882,0.316718,0.000105,0.000096,0.006316
Acceptable_Wonder614,33,5,3,8,65,29,94,8,0.217291,0.224785,0.000007,0.000309,0.003267
Alternative_Buy_4000,28,21,10,31,55,21,76,7,0.301893,0.318853,0.000763,0.000316,0.025622
Anti-genocide-club,29,7,8,15,69,33,102,7,0.276513,0.290039,0.000045,0.00026,0.003983
Boring_Investment241,13,3,2,5,15,2,17,8,0.246678,0.256402,0.000004,0.000039,0.00511
Call_Me_Clark,12,4,3,7,19,8,27,7,0.268927,0.283132,0.000021,0.000122,0.004045
CarsTrutherGuy,12,9,4,13,22,8,30,8,0.250734,0.261783,0.000029,0.000139,0.005537
Conscious_Spray_5331,13,5,4,9,27,10,37,7,0.275453,0.288779,0.000005,0.000118,0.004205
CreativeContract2170,18,3,3,6,31,8,39,7,0.280799,0.296313,0.000014,0.000086,0.003877
Effective_Jury4363,20,14,9,23,44,16,60,7,0.289522,0.306426,0.000288,0.000176,0.015971
Fit_Employment_2944,11,6,4,10,19,14,33,7,0.242556,0.252499,0.000024,0.000185,0.007612
Hungry-Struggle-1448,73,30,36,66,137,105,242,7,0.322142,0.346215,0.001539,0.000456,0.023987
Hyubris11,15,4,3,7,22,4,26,8,0.254567,0.266621,0.000051,0.000066,0.003013
InterestingTheory9,44,14,12,26,96,50,146,7,0.295376,0.313246,0.000901,0.00045,0.009941
K-CN,17,5,5,10,35,18,53,8,0.253286,0.264407,0.000031,0.000222,0.00276
KathrynBooks,35,12,10,22,69,29,98,7,0.280052,0.29394,0.000162,0.00034,0.004928
Kuriyamikitty,11,8,5,13,16,5,21,7,0.273705,0.287748,0.000025,0.000071,0.013895
LanceBarney,12,10,2,12,23,2,25,8,0.247081,0.25736,0.000024,0.00011,0.012633
Lopsided_Thing_9474,24,7,5,12,42,20,62,7,0.279896,0.295301,0.000045,0.00013,0.006154
Meowmixalotlol,10,6,5,11,11,10,21,8,0.274551,0.289671,0.000147,0.000114,0.004905
Normal-Advisor5269,10,16,9,25,29,11,40,7,0.289652,0.305495,0.000099,0.000114,0.019245
OldTiredGamer86,10,5,19,24,10,68,78,7,0.314317,0.335858,0.000123,0.000056,0.005213
OneNoteToRead,20,6,4,10,37,16,53,7,0.279,0.293852,0.000063,0.000179,0.008638
OptimisticRealist__,11,8,3,11,15,6,21,7,0.297569,0.313664,0.000158,0.000091,0.010734
PanzerOfTheLake115,13,6,6,12,25,9,34,7,0.272372,0.286226,0.000045,0.000074,0.008149
PermissionHuman1901,10,4,1,5,17,2,19,8,0.219078,0.22574,0,0.000063,0.004816
Ponce2170,16,8,8,16,37,18,55,7,0.265071,0.278415,0.000101,0.000153,0.009198
ProjectConfident8584,31,8,5,13,68,26,94,8,0.241882,0.25065,0.000067,0.000369,0.005565
Se4_h0rse,24,9,8,17,62,21,83,8,0.258239,0.270304,0.00005,0.000202,0.004184
SnooStrawberries620,11,7,3,10,19,4,23,7,0.25391,0.265498,0.000033,0.000052,0.012339
Steamed_Memes24,57,15,45,60,59,102,161,7,0.322532,0.345413,0.001369,0.000279,0.01002
Szygani,12,7,5,12,20,5,25,7,0.276631,0.291026,0.000021,0.000079,0.00673
TSllama,42,19,13,32,80,31,111,7,0.291086,0.307096,0.000727,0.000354,0.014862
TheMCMC,16,10,4,14,19,7,26,8,0.27321,0.288372,0.00006,0.000106,0.013022
Volume2KVorochilov,12,5,5,10,29,14,43,7,0.263743,0.274114,0.000086,0.000128,0.003161
_Hamburger_Helper_,18,8,4,12,34,8,42,8,0.238356,0.248016,0.000022,0.000165,0.003008
anaconda4290,50,13,15,28,119,42,161,7,0.282445,0.299506,0.000437,0.000449,0.007134
arrogant_ambassador,15,10,6,16,34,10,44,8,0.238331,0.247879,0.000049,0.000184,0.003977
awelles,22,6,6,12,40,15,55,7,0.269889,0.282831,0.000081,0.000142,0.004889
banhs5,16,7,3,10,37,17,54,8,0.228345,0.236284,0.000021,0.000217,0.011269
baptiser2,26,11,21,32,31,53,84,6,0.319213,0.340502,0.000622,0.000174,0.006554
bfhurricane,24,18,11,29,38,21,59,7,0.272766,0.287265,0.000315,0.00024,0.012329
eteran,37,6,4,10,64,21,85,7,0.269503,0.283465,0.000157,0.000358,0.003833
fixie-pilled420,14,6,4,10,21,11,32,7,0.276378,0.290875,0.00004,0.000072,0.00798
jpotion88,10,5,7,12,10,10,20,8,0.247676,0.258752,0.000022,0.00009,0.003618
km3r,13,14,5,19,33,11,44,7,0.256499,0.268441,0.000107,0.000201,0.009113
lightmaker918,12,6,3,9,26,8,34,8,0.245807,0.254426,0.000049,0.000134,0.004018
pragmojo,22,9,9,18,32,11,43,7,0.270001,0.282626,0.000229,0.000095,0.013989
properchewns,11,9,7,16,22,12,34,7,0.30676,0.323806,0.000108,0.000107,0.01644
redosipod,22,7,7,14,38,13,51,8,0.260108,0.270799,0.000133,0.000099,0.004009
sabesundae,25,5,3,8,42,10,52,7,0.26715,0.281374,0.000008,0.000108,0.005305
thebolts,13,7,6,13,33,16,49,8,0.261037,0.275135,0.000123,0.000151,0.00696
udcvr,11,5,6,11,21,10,31,7,0.265708,0.278512,0.000015,0.00008,0.006056
walletinsurance,20,4,9,13,7,11,18,7,0.271767,0.28503,0.000286,0.000074,0.003878
AdFun5641,12,13,3,16,22,5,27,8,0.250567,0.26113,0.00003,0.000091,0.01834
Bourbon-Decay,11,8,7,15,25,10,35,7,0.26693,0.283215,0.000128,0.000146,0.009873
Darkagent1,12,12,9,21,28,14,42,7,0.289578,0.302886,0.000135,0.000173,0.010005
Few_Mistake4144,20,8,8,16,46,19,65,7,0.272143,0.284593,0.000104,0.000181,0.005802
Gnarly-Beard,14,8,7,15,27,13,40,7,0.286337,0.301664,0.000096,0.000154,0.006272
Honeycrispcombe,23,10,8,18,32,22,54,8,0.261354,0.271793,0.000831,0.000181,0.004011
Hopeful_Ad_7719,10,3,1,4,4,1,5,8,0.255818,0.265937,0.000022,0.000054,0.001377
Logical_Strike_1520,17,3,3,6,15,12,27,7,0.266239,0.278119,0.000079,0.000096,0.001728
NTXGBR,25,8,12,20,50,29,79,7,0.296129,0.312884,0.000099,0.000253,0.005298
Rehcamretsnef,14,15,4,19,28,10,38,7,0.282093,0.298141,0.00011,0.000114,0.02516
Wizbran,11,5,3,8,26,12,38,8,0.244269,0.253129,0.000017,0.000195,0.002905
haikuandhoney,17,12,8,20,29,11,40,7,0.282921,0.298137,0.000392,0.000179,0.009943
seedoilbaths,66,25,85,110,87,599,686,6,0.339251,0.369603,0.00401,0.00056,0.02077
Flat-Butterscotch325,11,5,20,25,8,46,54,8,0.252664,0.264236,0.000749,0.000189,0.000002
Donutsmell,21,11,2,13,15,3,18,8,0.226507,0.23315,0.000417,0.000135,0.000252
Embarrassed-Kale-744,10,7,5,12,18,8,26,8,0.218065,0.226691,0.000733,0.000098,0.002719
Wise_Session_5370,13,10,3,13,22,6,28,9,0.203761,0.209993,0.000082,0.000173,0.000158
Flinn2,30,9,11,20,27,41,68,7,0.307072,0.327573,0.000266,0.00014,0.005934
Ferengsten,20,9,7,16,41,18,59,7,0.270275,0.281848,0.000079,0.000249,0.009846
pensivewombat,12,7,9,16,8,10,18,7,0.279034,0.293164,0.000239,0.000071,0.003197
tdifen,16,6,4,10,35,14,49,8,0.249312,0.260168,0.000042,0.000263,0.003508
FluidManufacturer952,113,32,108,140,97,339,436,6,0.354965,0.387816,0.004486,0.00064,0.012465
Punctual-Dragon,18,10,7,17,27,19,46,7,0.268385,0.282632,0.000154,0.00024,0.004932
SkyeWulver,14,10,5,15,26,9,35,7,0.287574,0.304597,0.00008,0.000097,0.01683
StathMIA,11,3,3,6,14,13,27,7,0.267009,0.279735,0.000006,0.000055,0.005256
dsteffee,91,23,64,87,90,218,308,7,0.339251,0.369926,0.003341,0.000653,0.013134
elmekia_lance,20,17,16,33,34,19,53,7,0.274186,0.29072,0.000378,0.000213,0.015271
enigmatic_erudition,18,8,4,12,29,13,42,7,0.284003,0.300015,0.000054,0.00013,0.010702
itswhatisaid,23,21,29,50,36,91,127,7,0.309126,0.329897,0.00072,0.00025,0.015068
ru_empty,11,4,3,7,21,9,30,8,0.232638,0.241043,0.000022,0.000104,0.004534
Fluid_Sky_4246,18,0,5,5,0,5,5,7,0.213367,0.219443,0,0.000033,0
CorpseDefiled,16,4,1,5,5,1,6,8,0.192257,0.196685,0.000227,0.000134,0.000038
Agitated-Country-969,18,10,5,15,33,9,42,8,0.231722,0.238696,0.000361,0.000227,0.000923
Altruistic_Key_1266,10,6,1,7,9,4,13,7,0.229038,0.235382,0.000052,0.000087,0.0004
Few-Scene-3183,12,6,5,11,10,5,15,8,0.248737,0.258155,0.000066,0.000074,0.000645
Mister-ellaneous,11,5,4,9,11,4,15,7,0.24174,0.249708,0.00008,0.00006,0.000597
Negativefalsehoods,22,11,12,23,37,21,58,7,0.273408,0.284169,0.00073,0.000219,0.001011
WickdWitchoftheBitch,10,8,2,10,10,4,14,9,0.217625,0.224407,0.000075,0.000139,0.000541
big-cheese49,26,8,18,26,21,55,76,7,0.277173,0.291257,0.000644,0.000239,0.000416
notapoliticalalt,25,20,15,35,39,22,61,7,0.29528,0.313701,0.000896,0.000229,0.021349
Goddamitdonut,16,6,4,10,11,6,17,7,0.252734,0.261566,0.000127,0.000115,0.00082
HyderintheHouse,14,4,4,8,19,6,25,8,0.263436,0.274435,0.000085,0.00008,0.001059
Intelligent_Break_12,19,6,8,14,39,12,51,8,0.242764,0.251772,0.000093,0.000153,0.000969
Proper-Bug-3843,12,4,5,9,12,10,22,8,0.242608,0.24966,0.000368,0.0002,0.000353
Stoic_Fervor,11,10,3,13,17,7,24,8,0.24845,0.257692,0.000189,0.000123,0.003818
armrha,16,16,4,20,24,7,31,8,0.216099,0.222552,0.000119,0.000277,0.002234
justcougit,15,7,2,9,21,2,23,8,0.210084,0.216714,0.000177,0.00023,0.000547
slowsundaycoffeeclub,14,11,5,16,24,11,35,8,0.233791,0.242082,0.000146,0.000239,0.000867
wibbly-water,21,15,6,21,36,12,48,7,0.275403,0.289421,0.000125,0.00021,0.014441
ForgetfullRelms,23,7,18,25,18,34,52,7,0.311357,0.332164,0.000253,0.000203,0.004194
Forgotten_Dog1954,10,2,9,11,2,11,13,8,0.242439,0.252165,0.000057,0.000061,0.000055
Mysterious_Dark_2298,10,8,3,11,19,4,23,9,0.211853,0.218364,0.000054,0.000241,0.000422
oakfield01,22,8,6,14,15,11,26,8,0.249614,0.258923,0.000174,0.000151,0.000403
Xiibe,41,20,11,31,61,22,83,7,0.280052,0.295576,0.000471,0.000353,0.014997
ButtholeSurfur,11,7,5,12,18,9,27,8,0.245647,0.255741,0.000138,0.000186,0.000645
DilbertHigh,19,12,8,20,29,17,46,7,0.283772,0.297299,0.00055,0.000223,0.00675
Kiowascout,25,13,8,21,43,20,63,7,0.271555,0.283315,0.000947,0.000526,0.001606
Orion_69_420,14,4,2,6,11,3,14,8,0.216771,0.22287,0.000022,0.000109,0.000078
Racer13l,12,4,3,7,24,12,36,8,0.230191,0.237146,0.000027,0.000153,0.00369
cwcam86,21,7,3,10,47,20,67,9,0.202676,0.208337,0.000025,0.000275,0.001013
katsock,14,10,1,11,12,1,13,9,0.185076,0.188626,0.000003,0.000164,0.000554
wpotman,17,11,3,14,17,6,23,8,0.232913,0.24036,0.000101,0.000209,0.000604
CandidateNew3518,13,7,7,14,27,14,41,8,0.268481,0.280575,0.000047,0.000158,0.002635
One-Independent8303,36,11,7,18,43,28,71,7,0.291254,0.309293,0.000338,0.000348,0.009997
FunMammoth6910,16,2,10,12,2,67,69,9,0.223456,0.231928,0.00006,0.000088,0.000001
PoetLocksmith,13,6,4,10,17,7,24,9,0.218191,0.224227,0.000275,0.000222,0.000087
Specialist-Owl2660,24,6,4,10,33,4,37,8,0.217981,0.224624,0.000098,0.000117,0.000095
TheBossOfItAll,10,7,4,11,20,5,25,8,0.24826,0.256454,0.000579,0.000126,0.000726
Unholy_mess169,31,5,4,9,41,5,46,8,0.207867,0.214252,0.000132,0.000163,0.00003
moo-chu,14,13,10,23,17,10,27,8,0.218034,0.227007,0.000285,0.000206,0.000106
GameMythYT,10,6,7,13,10,17,27,7,0.30115,0.320871,0.000027,0.000109,0.004808
GamingCatGuy,11,6,34,40,12,94,106,7,0.333186,0.355496,0.000542,0.000101,0.004707
Adiv_Kedar2,24,13,5,18,49,14,63,7,0.267941,0.282527,0.000083,0.000218,0.010921
Potatussus26,48,21,73,94,42,379,421,7,0.337582,0.364593,0.003892,0.00039,0.009533
WreckinRich,17,7,5,12,40,18,58,7,0.261053,0.272612,0.000034,0.000244,0.004451
alienassasin3,14,9,9,18,13,17,30,7,0.306345,0.32372,0.000137,0.000106,0.00602
GasHistorical5064,10,5,29,34,6,112,118,7,0.292798,0.313829,0.000131,0.000099,0.004003
AVonGauss,14,9,4,13,16,7,23,8,0.242063,0.252716,0.000011,0.000108,0.01243
Complex-Field7054,34,29,24,53,51,32,83,7,0.307384,0.327775,0.001432,0.000264,0.028544
Kman17,42,33,10,43,66,14,80,7,0.293177,0.309568,0.000948,0.000346,0.026409
Konflictcam,10,6,7,13,17,12,29,8,0.270275,0.287345,0.00002,0.00014,0.004562
Wave_File,29,27,14,41,56,20,76,7,0.297706,0.316901,0.000687,0.000336,0.023913
apiaryaviary,18,10,7,17,23,8,31,8,0.251905,0.263951,0.00006,0.000144,0.007818
bearrosaurus,16,9,7,16,28,13,41,8,0.266569,0.28299,0.000233,0.000231,0.005572
GenGanges,10,11,25,36,14,103,117,7,0.30486,0.322051,0.000237,0.00013,0.003946
igna92ts,15,13,8,21,30,15,45,7,0.283932,0.300112,0.000134,0.000173,0.014153
General_Cherry_6285,10,6,18,24,6,30,36,7,0.257945,0.269159,0.000519,0.000135,0.000101
Breakin7,15,7,3,10,8,3,11,8,0.231343,0.238945,0.000177,0.000131,0.002343
CalligrapherDizzy201,42,16,8,24,85,19,104,7,0.280433,0.294133,0.001202,0.000446,0.004722
DingbattheGreat,10,4,1,5,4,1,5,8,0.219057,0.22531,0.000003,0.000055,0.000288
queefymacncheese,13,15,2,17,16,3,19,8,0.205976,0.211265,0.00012,0.00017,0.002675
side_noted,12,9,5,14,15,5,20,7,0.255443,0.265345,0.000356,0.000109,0.001401
Glass-Pain3562,50,15,37,52,59,114,173,7,0.321662,0.34396,0.001109,0.000623,0.00292
Fleeting_Dopamine,17,10,7,17,34,17,51,7,0.276243,0.289613,0.000083,0.000182,0.009055
Mother_Sand_6336,24,11,7,18,36,27,63,7,0.266537,0.280725,0.000122,0.000219,0.010127
Whatswrongbaby9,25,14,6,20,41,14,55,7,0.290507,0.305038,0.000616,0.000202,0.008748
Glittering_Ad_6027,12,5,9,14,7,21,28,7,0.278519,0.292865,0.000041,0.000084,0.001677
Drneroflame,11,7,5,12,22,9,31,7,0.264947,0.277535,0.000033,0.000102,0.005352
Glittering_Desk_8575,10,1,3,4,1,4,5,9,0.185737,0.190255,0.000234,0.000172,0
SmarterThanCornPop,22,11,8,19,30,19,49,7,0.286809,0.301868,0.000098,0.000241,0.005335
terryjuicelawson,16,14,6,20,20,8,28,8,0.251821,0.261722,0.000674,0.000161,0.00205
Rough_Elk_3952,10,7,4,11,15,5,20,8,0.242569,0.251398,0.000198,0.00013,0.000609
GreenParrot785,11,6,11,17,12,38,50,7,0.308179,0.325541,0.000206,0.000127,0.003031
Tradition96,10,4,3,7,17,9,26,7,0.258166,0.26863,0.000004,0.000104,0.001312
Gritty_gutty,38,9,12,21,25,35,60,7,0.287629,0.305479,0.00016,0.000252,0.003293
Guildernstern87,18,6,17,23,9,44,53,7,0.308053,0.324294,0.000176,0.000095,0.003594
HannahKentucky,10,3,7,10,6,15,21,8,0.231142,0.240328,0.000063,0.00011,0.000035
Expert-Examination86,11,7,2,9,16,7,23,8,0.227462,0.234545,0.00016,0.000167,0.002233
randell1985,25,7,6,13,16,14,30,7,0.246275,0.253699,0.000187,0.000138,0.001163
thorpie88,64,21,9,30,46,27,73,8,0.229665,0.238129,0.000638,0.000561,0.001661
Bojack35,20,13,8,21,56,20,76,7,0.275755,0.289272,0.000145,0.000321,0.01089
BreadAndToast99,21,10,5,15,42,13,55,8,0.26704,0.281249,0.000041,0.000199,0.012502
Glad-Way-637,16,7,7,14,25,10,35,7,0.267624,0.277759,0.00009,0.000078,0.010146
LosingTrackByNow,11,6,6,12,8,8,16,7,0.302518,0.321672,0.000079,0.000057,0.010062
MinuteBubbly9249,19,13,6,19,29,10,39,7,0.298766,0.314442,0.001833,0.000151,0.013057
NoShape7689,16,5,3,8,23,5,28,8,0.24419,0.253126,0.000007,0.000077,0.002883
Old-Research3367,31,12,7,19,60,29,89,7,0.279275,0.292711,0.000119,0.000516,0.013736
Particular_Ant_4429,19,12,9,21,42,14,56,7,0.289949,0.30582,0.000172,0.000239,0.010202
The_Itsy_BitsySpider,19,17,8,25,32,12,44,8,0.271881,0.285225,0.000188,0.000145,0.014265
beethebuz,11,11,5,16,28,7,35,7,0.293253,0.309878,0.000171,0.00018,0.007531
cuntpimp,28,9,7,16,54,18,72,7,0.297882,0.314507,0.000271,0.000239,0.008175
dundreggen,12,8,8,16,25,17,42,7,0.290321,0.304655,0.000305,0.000109,0.005644
quantum-fitness,11,7,2,9,14,7,21,8,0.228668,0.23647,0.000011,0.000179,0.003995
Haunting-Ad-7760,18,4,35,39,6,50,56,7,0.321228,0.341571,0.000373,0.000077,0.001063
InternationalClick78,24,9,6,15,49,19,68,8,0.228242,0.236211,0.000207,0.000305,0.000797
Patient-Courage-9764,16,11,6,17,24,11,35,7,0.271311,0.28453,0.000047,0.000105,0.010898
HauntingPayment4761,11,2,3,5,2,4,6,8,0.199357,0.204827,0.000003,0.000052,0.00001
HazzaB0o,14,2,5,7,2,7,9,8,0.211231,0.216687,0.000038,0.000086,0.000001
HeWhoReddits,26,14,69,83,19,356,375,7,0.333972,0.360258,0.001949,0.000199,0.004262
Brave-Silver8736,21,5,6,11,30,22,52,8,0.242076,0.251912,0.000032,0.00021,0.004363
BugRevolution,12,6,4,10,19,6,25,8,0.255026,0.26494,0.000138,0.000087,0.006759
Conscious-Function-2,10,12,3,15,23,6,29,8,0.265428,0.279862,0.000059,0.000127,0.012219
IEATASSETS,20,5,4,9,40,12,52,7,0.259423,0.270972,0.000015,0.000136,0.002462
KRAy_Z_n1nja,11,7,4,11,24,13,37,7,0.271214,0.283612,0.000193,0.000093,0.005544
LeRoyRouge,20,8,5,13,31,22,53,8,0.246772,0.261252,0.000032,0.000199,0.008468
MainPlankton9612,10,7,2,9,20,6,26,8,0.261444,0.276675,0.000034,0.000124,0.005842
Mejari,29,11,12,23,55,39,94,7,0.276783,0.293329,0.00032,0.000313,0.00687
Thencewasit,12,10,4,14,28,9,37,8,0.248015,0.257697,0.000047,0.000139,0.012942
WVUEnchilada,21,4,4,8,47,22,69,7,0.257125,0.268541,0.000026,0.000226,0.001328
anomie89,12,12,5,17,18,8,26,8,0.260722,0.271634,0.000414,0.000172,0.003436
garnet420,12,7,3,10,22,9,31,8,0.268163,0.281327,0.000043,0.000141,0.007335
Healthy-Decision-206,12,13,24,37,16,49,65,8,0.25,0.262081,0.001946,0.000304,0.000108
MattDaveys,10,5,0,5,11,0,11,0,0,0,0,0.000095,0.000081
pierogieman5,26,3,2,5,9,10,19,9,0.208326,0.214248,0.000054,0.000157,0.001575
A_Soporific,16,10,9,19,25,16,41,7,0.290936,0.30619,0.000134,0.000142,0.009494
Glorfendail,46,17,10,27,80,36,116,7,0.277122,0.292954,0.000231,0.000376,0.014715
Neither-Stage-238,20,5,4,9,41,21,62,7,0.30117,0.317698,0.000056,0.00017,0.008233
Nervous-Procedure-63,22,16,10,26,53,24,77,7,0.294934,0.31137,0.000294,0.000299,0.010102
Previous_Impact7129,24,8,8,16,63,32,95,7,0.284521,0.298691,0.000077,0.000318,0.004122
Royal_Negotiation_91,30,21,10,31,48,19,67,7,0.273804,0.286752,0.000309,0.000338,0.014032
Sharkbait_ooohaha,11,6,4,10,22,7,29,7,0.258475,0.271079,0.00002,0.000093,0.004918
TSN09,11,5,2,7,11,3,14,8,0.232961,0.240855,0.000006,0.000104,0.005539
Temporary-Truth2048,11,7,4,11,23,10,33,7,0.271669,0.285217,0.000058,0.000145,0.00374
aguafiestas,10,6,2,8,8,5,13,7,0.260108,0.270305,0.000368,0.000088,0.002476
aspiringimmortal,23,17,18,35,23,29,52,6,0.301772,0.316424,0.001088,0.000184,0.012121
breakbeforedawn,40,15,16,31,76,34,110,7,0.284324,0.301073,0.000272,0.000234,0.014412
iAmBalfrog,12,4,0,4,16,0,16,0,0,0,0,0.000042,0.013208
HelenOlivas,15,4,7,11,8,15,23,7,0.295511,0.314307,0.000062,0.000103,0.000941
NoGoodDrifter99,24,9,6,15,46,24,70,7,0.277733,0.291872,0.00005,0.000254,0.011128
Gladfire,10,2,2,4,11,9,20,8,0.253031,0.264286,0.000002,0.000092,0.001259
custodial_art,49,15,10,25,78,33,111,7,0.286446,0.30209,0.000079,0.000345,0.010405
Hermeslost,25,14,46,60,26,203,229,7,0.331067,0.357605,0.00086,0.000232,0.00556
soldiergeneal,17,6,7,13,33,21,54,7,0.270291,0.283382,0.000033,0.000158,0.003213
HistoricalAd6321,89,36,164,200,103,862,965,6,0.360647,0.399209,0.008569,0.000686,0.009835
4art4,22,28,12,40,69,16,85,7,0.292666,0.309383,0.000697,0.000385,0.00998
AhsokaSolo,31,4,4,8,56,20,76,7,0.268417,0.282797,0.000172,0.000306,0.002526
ArCovino,17,8,7,15,37,8,45,7,0.288471,0.306366,0.000112,0.000093,0.012264
Cold_Breeze3,21,9,9,18,48,21,69,7,0.273573,0.290089,0.00019,0.000262,0.00604
DBFool2019,32,8,7,15,74,27,101,8,0.253541,0.265688,0.000049,0.000249,0.00643
DJFrostyTips,22,5,2,7,33,8,41,8,0.255948,0.26629,0.000015,0.000126,0.006198
EclipseNine,12,8,4,12,28,12,40,7,0.269199,0.28168,0.000016,0.000116,0.011126
FlippinSnip3r,19,3,1,4,25,4,29,8,0.22566,0.233641,0.000004,0.000103,0.003475
GarryofRiverton,27,11,10,21,55,27,82,7,0.294397,0.314226,0.000176,0.000245,0.008346
Grish__,15,4,4,8,26,17,43,7,0.27758,0.293421,0.000022,0.000099,0.006096
ICantCoexistWithFish,16,3,4,7,38,11,49,7,0.273193,0.287581,0.000018,0.000106,0.002535
In-Brightest-Day,10,6,3,9,18,6,24,8,0.235456,0.245249,0.000036,0.00012,0.006027
Jmcduff5,17,9,5,14,33,7,40,7,0.280886,0.296318,0.000088,0.000129,0.008477
Junior_Razzmatazz164,18,5,3,8,34,18,52,8,0.238205,0.247462,0.000014,0.000198,0.004492
MisfireMillennial,46,6,4,10,119,44,163,7,0.270614,0.283783,0.000186,0.000561,0.004918
Monty_Bentley,11,14,8,22,24,13,37,7,0.269953,0.282486,0.000098,0.000115,0.017184
PerspectiveViews,21,5,3,8,31,18,49,7,0.266333,0.278581,0.000013,0.000201,0.004429
Significant_Arm4246,28,21,9,30,69,16,85,8,0.256571,0.271646,0.000279,0.000268,0.022492
Sovereign_Black,11,4,2,6,20,9,29,7,0.25065,0.261614,0.000009,0.000077,0.004486
SuperRocketRumble,14,10,8,18,25,11,36,7,0.273045,0.288936,0.000217,0.000152,0.011632
ary31415,11,12,9,21,29,13,42,7,0.283116,0.299202,0.000349,0.000148,0.014751
bearington,17,14,12,26,56,24,80,7,0.275638,0.28973,0.000167,0.000291,0.005856
frederick_the_duck,22,8,11,19,52,20,72,7,0.296945,0.314018,0.000149,0.000243,0.006248
itsdeeps80,32,22,17,39,47,27,74,7,0.291179,0.309777,0.000453,0.000281,0.020387
jamerson537,22,7,6,13,40,17,57,8,0.257052,0.269777,0.000047,0.000181,0.007059
jspook,11,9,3,12,24,6,30,7,0.268544,0.282994,0.000043,0.000108,0.007516
north_canadian_ice,14,7,7,14,25,8,33,8,0.265646,0.27854,0.000023,0.000102,0.005867
steponmedaddies,26,8,11,19,57,28,85,7,0.29369,0.312037,0.00024,0.000164,0.008849
HistoricalGur6037,10,0,4,4,0,6,6,8,0.21015,0.215887,0,0.000033,0
AakKiinYol,10,3,0,3,3,0,3,0,0,0,0,0.000049,0.000034
Honka_Ponka,13,7,10,17,8,20,28,7,0.269119,0.280077,0.000171,0.000142,0.000839
HopeRelevant6951,18,1,3,4,1,5,6,7,0.238005,0.246577,0.000228,0.000147,0
Hot-Drama-9802,30,8,17,25,19,128,147,7,0.314056,0.332329,0.000935,0.000204,0.003064
ThrowRAboredinAZ77,32,13,4,17,52,11,63,7,0.251975,0.26269,0.000067,0.000215,0.005734
HotAdhesiveness2860,16,2,3,5,4,8,12,7,0.239212,0.247813,0.000481,0.000136,0.000148
Uncommon_Sense93,13,4,5,9,10,8,18,7,0.214289,0.220299,0.000358,0.000279,0.000015
Humble-Math6565,11,5,5,10,11,13,24,7,0.297217,0.31521,0.000067,0.000106,0.003235
BigBoetje,20,21,13,34,36,21,57,7,0.305045,0.322702,0.000434,0.00021,0.01529
TheManInTheShack,14,5,4,9,31,14,45,7,0.275035,0.288827,0.000024,0.000218,0.002347
HuntFlimsy2354,20,3,10,13,11,27,38,8,0.214046,0.223224,0.000115,0.000341,0.000006
HyacinthMacaw13,48,13,23,36,33,147,180,6,0.326085,0.348108,0.000639,0.000236,0.010601
Chronoblivion,21,14,8,22,34,16,50,7,0.275118,0.288031,0.000115,0.000231,0.011753
Imaginary_Day_876,13,8,8,16,19,13,32,7,0.274319,0.28921,0.000028,0.000082,0.004957
ICuriosityCatI,14,7,15,22,16,42,58,7,0.311743,0.33151,0.000112,0.00013,0.004616
Real-Intention-7998,40,29,45,74,60,91,151,6,0.328426,0.353054,0.001608,0.000288,0.017735
Hard-Object2,14,4,3,7,26,12,38,8,0.181421,0.185514,0.000278,0.000247,0.000055
RL203,10,7,3,10,15,4,19,8,0.23712,0.249694,0.000057,0.000114,0.006845
iOawe,11,16,3,19,19,4,23,8,0.228288,0.23525,0.000093,0.000236,0.000729
I_Lick_Emus,46,7,9,16,27,38,65,7,0.30268,0.322426,0.000066,0.000218,0.003999
I_Short_TSLA,16,7,19,26,11,39,50,7,0.309337,0.330208,0.000219,0.000123,0.004177
Iamnotcrazy_youare,17,11,38,49,13,287,300,7,0.299795,0.318524,0.00095,0.000165,0.002712
BeginningMedia4738,10,11,7,18,23,10,33,7,0.294588,0.310897,0.00023,0.000127,0.018182
Dusk_Flame_11th,11,15,5,20,26,8,34,7,0.267245,0.28012,0.000124,0.000126,0.009647
Hapciuuu,11,6,4,10,20,7,27,7,0.265055,0.276586,0.000018,0.000104,0.003638
KarsaOrlong1,10,7,4,11,19,9,28,8,0.246423,0.256489,0.000214,0.000115,0.003203
KingJayKayT,19,5,5,10,43,18,61,7,0.246449,0.255581,0.000097,0.000343,0.001207
TheBrutalVegan,14,4,3,7,29,11,40,8,0.249463,0.259012,0.000011,0.000146,0.00072
Vanaquish231,17,6,5,11,32,13,45,8,0.239338,0.249139,0.000039,0.000135,0.002852
acassiopa,20,7,7,14,38,16,54,7,0.276142,0.290115,0.000253,0.000192,0.002021
strawberry_jaaam,54,17,18,35,66,72,138,7,0.316205,0.337302,0.000631,0.000413,0.009533
vnth93,52,14,21,35,45,70,115,7,0.315258,0.336061,0.000574,0.000355,0.006827
xAnnie3000,18,6,4,10,41,18,59,8,0.238708,0.246105,0.000178,0.000443,0.000565
yonasismad,12,3,3,6,23,9,32,8,0.23925,0.247906,0.00001,0.000097,0.000656
IceWorried5205,29,3,6,9,20,27,47,8,0.205332,0.211793,0.000207,0.000441,0.000002
Ifyouliveinadream,22,5,11,16,21,38,59,7,0.300212,0.319468,0.000091,0.000215,0.003413
IllScience1286,11,14,48,62,15,119,134,6,0.324218,0.349006,0.00114,0.000134,0.008585
AlphaBetaSigmaNerd,34,10,7,17,74,36,110,7,0.294148,0.311458,0.000106,0.000309,0.010869
AppendixN,14,9,4,13,29,6,35,7,0.262551,0.274788,0.000029,0.000117,0.00724
ChazzLamborghini,12,13,4,17,21,6,27,8,0.229712,0.240642,0.000026,0.000171,0.008737
R1R1FyaNeg,26,18,45,63,27,108,135,7,0.322418,0.34718,0.001059,0.000277,0.009852
The_White_Ram,49,17,12,29,94,50,144,7,0.281619,0.298042,0.000163,0.000359,0.007546
TownAfterTown,15,12,9,21,32,10,42,8,0.260767,0.272897,0.000101,0.000173,0.009255
ImA10inPuyallup,12,4,13,17,7,24,31,8,0.260153,0.2713,0.000392,0.000135,0.00023
I-own-a-shovel,18,6,2,8,22,3,25,8,0.244441,0.252727,0.000024,0.000102,0.000562
jittery_raccoon,11,7,7,14,17,8,25,8,0.262231,0.272565,0.000221,0.000106,0.000593
onefellswoop70,25,8,15,23,9,21,30,7,0.273937,0.286644,0.00039,0.000149,0.000443
Imaginary_Skin_3283,12,6,11,17,6,15,21,7,0.303797,0.322901,0.000144,0.000084,0.003776
Suspicious_War5435,12,3,2,5,12,10,22,8,0.233081,0.241929,0.000002,0.000135,0.000684
Immediate-River-874,14,15,77,92,17,219,236,6,0.336154,0.363358,0.003504,0.00018,0.004802
EnvChem89,18,15,7,22,25,9,34,7,0.271246,0.285731,0.000137,0.000131,0.009648
LastDayWork,10,7,12,19,13,56,69,7,0.283825,0.2997,0.000083,0.0001,0.007608
Poeking,18,18,9,27,50,14,64,7,0.295337,0.309714,0.000824,0.000234,0.009277
PoliticsDunnRight,30,12,19,31,30,55,85,7,0.319506,0.341755,0.000402,0.000244,0.007626
Significant_Bid2142,10,9,3,12,17,5,22,8,0.242089,0.250868,0.00005,0.000139,0.007466
Some_Excitement1659,16,9,10,19,14,13,27,7,0.276682,0.291865,0.00011,0.000119,0.004997
Witty-Stock-4913,10,12,5,17,14,6,20,7,0.258756,0.269532,0.00132,0.000179,0.004236
gawddayumboiii,12,4,21,25,11,128,139,7,0.306573,0.324809,0.000074,0.000125,0.002425
midbossstythe,15,10,8,18,33,16,49,7,0.268163,0.281759,0.000064,0.000194,0.00413
ImpossibleSupport215,18,1,26,27,5,39,44,7,0.265724,0.278296,0.000132,0.000081,0.000001
MountainDogMama,13,6,5,11,15,9,24,8,0.210671,0.217847,0.000087,0.000216,0.000095
Original-Common-7010,14,8,4,12,26,10,36,8,0.263989,0.275643,0.000735,0.000159,0.002221
SomeoneYouDontKnow70,17,5,0,5,10,0,10,0,0,0,0,0.000101,0.0001
Spiritual_Address_18,10,7,3,10,16,6,22,9,0.196768,0.201747,0.000049,0.000187,0.000077
janus1981,34,10,10,20,35,30,65,8,0.218718,0.228955,0.000226,0.000396,0.000096
Impossible_Host2420,22,7,10,17,20,30,50,8,0.276378,0.289342,0.000066,0.000234,0.00473
Independent-Long1928,13,3,6,9,5,9,14,8,0.239668,0.248503,0.000204,0.000135,0.000006
CandylandCanada,30,9,5,14,11,5,16,8,0.20054,0.206731,0.000245,0.000136,0.000101
LiveKindly01,64,20,18,38,51,39,90,7,0.306158,0.322881,0.007866,0.000638,0.005673
tosser9212,15,12,5,17,16,5,21,7,0.225537,0.233314,0.000414,0.000186,0.000158
Independent-Waltz157,12,6,11,17,10,27,37,8,0.238406,0.247686,0.000191,0.000228,0.000108
radialomens,11,5,4,9,7,5,12,7,0.258195,0.267251,0.000702,0.000106,0.000867
silentjudge_,14,6,2,8,7,2,9,8,0.201173,0.207058,0.000018,0.000123,0.000053
Inevitable-Walk-9343,17,1,16,17,1,32,33,8,0.249051,0.259786,0.000108,0.000052,0
fishling,11,7,4,11,12,5,17,7,0.268353,0.28265,0.000177,0.000083,0.003371
Infamous-Interest499,11,4,16,20,5,23,28,8,0.221143,0.231968,0.000112,0.000093,0.000011
Classic_Might_5948,10,5,3,8,5,3,8,8,0.22371,0.231113,0.000077,0.000065,0.000081
ThisWillAgeWell,45,14,13,27,52,23,75,7,0.234858,0.246259,0.000793,0.000366,0.000148
Garblin,13,7,3,10,11,4,15,8,0.23644,0.245317,0.000196,0.000147,0.000588
InsideTrack6955,44,17,26,43,76,76,152,7,0.325242,0.346142,0.000996,0.000399,0.010679
Interesting-Sail1414,39,18,28,46,30,66,96,7,0.316802,0.33728,0.00114,0.000369,0.006183
Particular-Flan5721,39,19,47,66,46,155,201,6,0.337985,0.363737,0.001556,0.000225,0.010241
Interesting_Claim414,95,27,70,97,64,427,491,7,0.325242,0.35193,0.003166,0.000511,0.007874
AuspiciouslyAutistic,13,3,3,6,23,12,35,7,0.260123,0.271764,0.000003,0.000119,0.002623
Efficient_Phase1313,10,4,3,7,19,8,27,8,0.228818,0.236695,0.000002,0.000112,0.001038
Eyuplove_,29,4,3,7,40,7,47,7,0.241186,0.249248,0.000013,0.00008,0.002193
HuckleberryEmpty4988,14,6,3,9,24,13,37,8,0.256223,0.267322,0.000008,0.000153,0.003734
Maximus3311,24,13,6,19,65,23,88,8,0.251262,0.262918,0.000073,0.000346,0.005886
Mediocre-Risk3581,11,7,4,11,22,10,32,7,0.263743,0.277496,0.000119,0.000124,0.005088
TheRunningMD,21,11,14,25,22,30,52,7,0.315962,0.335109,0.000263,0.000197,0.007078
TomatoTrebuchet,14,14,10,24,41,21,62,6,0.293748,0.310444,0.000232,0.00015,0.008551
Upset_Gerbil,10,4,3,7,17,4,21,8,0.246248,0.257064,0.000016,0.000083,0.00532
fghhjhffjjhf,23,15,9,24,35,18,53,7,0.272831,0.288005,0.000137,0.000169,0.007031
lithiumcitizen,16,7,5,12,25,10,35,8,0.268863,0.283625,0.000019,0.000119,0.005699
trolletariat69,17,6,2,8,36,15,51,8,0.224508,0.23175,0.000012,0.00027,0.003554
Interesting_Shift885,11,2,40,42,2,100,102,7,0.263805,0.278721,0.001212,0.000067,0.000103
DefiantMemory9,13,9,5,14,23,9,32,7,0.228911,0.235818,0.000348,0.00021,0.000303
HisGirlFriday1983,33,18,9,27,92,17,109,8,0.249257,0.258696,0.002536,0.000735,0.000425
Pkfrompa,10,6,0,6,7,0,7,0,0,0,0,0.00007,0.000119
Uubilicious_The_Wise,55,18,11,29,47,20,67,7,0.247771,0.257801,0.00148,0.000495,0.000298
kestrova,11,3,3,6,18,6,24,9,0.195849,0.202557,0.00001,0.000152,0.000027
seriouslees,22,7,4,11,10,7,17,9,0.203058,0.209332,0.000087,0.000151,0.000096
Internal-Hat9827,13,8,26,34,9,42,51,7,0.28331,0.297964,0.000949,0.000167,0.000542
Chemical_Signal2753,15,18,1,19,20,1,21,9,0.189911,0.193928,0.000029,0.000357,0.001295
MinFootspace,11,8,6,14,13,6,19,8,0.245169,0.254874,0.000213,0.000113,0.000791
YourAdvertisingPal,13,6,7,13,32,17,49,7,0.30111,0.318007,0.000226,0.000135,0.005437
__wasitacatisaw__,19,10,10,20,31,14,45,7,0.258416,0.269449,0.00043,0.000186,0.000792
thelongestusernameee,10,2,2,4,7,2,9,8,0.232566,0.239909,0.000015,0.000064,0.000101
IronHorseTitan,16,1,8,9,3,15,18,7,0.271718,0.283553,0.000019,0.000069,0.000044
Kakashisith,10,6,4,10,11,8,19,7,0.273029,0.284712,0.000276,0.000094,0.001852
Petcai,12,4,3,7,9,8,17,8,0.209831,0.216312,0.00006,0.000146,0.000105
Pompous_Italics,12,9,1,10,10,1,11,8,0.20704,0.211962,0.000014,0.000184,0.000503
TurnoverInfamous3705,10,3,2,5,9,6,15,9,0.212569,0.219249,0.000007,0.000076,0.000159
clothanger,18,12,0,12,12,0,12,0,0,0,0,0.000175,0.001075
Cool_Relative7359,10,6,6,12,13,11,24,7,0.268274,0.280176,0.000094,0.000106,0.008552
Kerlyle,10,5,4,9,19,7,26,7,0.272126,0.284159,0.000006,0.000099,0.002244
health_throwaway195,22,10,7,17,32,21,53,8,0.254553,0.266508,0.000092,0.000275,0.008076
Jackie_Lantern_,26,9,23,32,28,78,106,7,0.312366,0.3337,0.000661,0.000296,0.00244
JagroCrag,27,14,38,52,22,72,94,7,0.322992,0.344239,0.001637,0.000305,0.004584
Furryballs239,13,6,5,11,18,6,24,7,0.271458,0.283204,0.000039,0.000065,0.00586
Marty-the-monkey,12,7,5,12,28,11,39,7,0.256122,0.267499,0.000036,0.000156,0.009181
amberlikesowls,11,7,2,9,15,2,17,7,0.254267,0.262194,0.000496,0.00006,0.00794
thaisweetheart,17,15,14,29,38,20,58,7,0.304103,0.318434,0.000505,0.00016,0.01686
unscanable,19,14,9,23,45,18,63,7,0.30123,0.31764,0.000177,0.000192,0.016924
JaguarSad5115,53,11,91,102,17,396,413,7,0.319935,0.34334,0.004139,0.000267,0.000269
-JustJoel-,37,6,5,11,76,28,104,8,0.249683,0.259356,0.000211,0.000346,0.000444
AdDramatic2351,17,5,3,8,6,7,13,8,0.207829,0.213112,0.000102,0.000135,0.000347
Aetheldrake,19,5,2,7,25,3,28,9,0.210769,0.216697,0.000009,0.000167,0.000585
Beautiful_Bag6707,28,18,10,28,69,24,93,7,0.269921,0.284669,0.000181,0.000355,0.011568
DeliciousBeanWater,11,5,2,7,24,8,32,9,0.189371,0.194837,0.000024,0.000276,0.000754
F_ur_feelingss,18,8,5,13,10,10,20,8,0.229642,0.238288,0.000202,0.000141,0.000719
Legitimate_Ad_7822,10,4,4,8,5,5,10,8,0.229828,0.237226,0.00002,0.000086,0.000714
Lost_Roku_Remote,14,7,108,115,7,225,232,7,0.333358,0.358108,0.002357,0.000112,0.000473
No_Meringue_8736,26,13,11,24,35,22,57,7,0.28059,0.294457,0.000844,0.00037,0.002003
Ok_Marionberry_3118,21,5,1,6,8,3,11,9,0.208134,0.213929,0.000008,0.000084,0.000721
PrpleSparklyUnicrn13,14,8,3,11,19,5,24,8,0.243586,0.251958,0.000125,0.000146,0.000971
Relevant_Program_958,13,4,4,8,26,14,40,8,0.245581,0.254885,0.000064,0.000189,0.000349
Travelmusicman35,12,4,1,5,14,1,15,8,0.208825,0.215411,0.000002,0.000077,0.000752
Troysmith1,13,5,3,8,17,9,26,8,0.219439,0.228933,0.000268,0.000228,0.00214
diescheide,18,3,12,15,6,21,27,8,0.269519,0.28148,0.000314,0.000097,0.000381
dinodare,12,9,4,13,18,5,23,8,0.251989,0.260674,0.000078,0.000079,0.00165
mailslot,21,9,6,15,27,8,35,8,0.219407,0.226882,0.000317,0.000238,0.000502
riri1281,15,11,23,34,17,43,60,7,0.309993,0.330806,0.000636,0.000123,0.004601
Jakko_Lantarn,10,1,5,6,2,8,10,8,0.208585,0.216181,0.000224,0.000109,0
accidentalscientist_,11,5,4,9,8,4,12,8,0.223687,0.230983,0.000165,0.00009,0.000255
Jazlynxoxo,13,2,9,11,4,16,20,8,0.213109,0.22185,0.00007,0.000114,0.000001
KayItaly,20,7,5,12,16,8,24,8,0.214391,0.220978,0.000213,0.000184,0.000044
Jazzper1,11,5,8,13,6,12,18,8,0.211251,0.218705,0.000137,0.000199,0.000006
JustheBean,23,10,7,17,16,8,24,8,0.220636,0.229858,0.000328,0.000254,0.000061
JesusLovesYouMyChild,28,13,26,39,23,109,132,7,0.307447,0.32704,0.000545,0.000233,0.003956
Current_Mistake800,17,6,5,11,30,8,38,7,0.261399,0.271769,0.000295,0.000138,0.001736
Mindless_Humor_3156,20,23,34,57,29,95,124,7,0.319168,0.344225,0.001017,0.000251,0.015243
PrintFearless3249,34,16,10,26,78,34,112,7,0.283879,0.298954,0.000531,0.000334,0.014373
blumieplume,22,11,9,20,28,20,48,7,0.264051,0.274865,0.000681,0.00026,0.001659
therealallpro,11,5,5,10,20,10,30,8,0.27402,0.288485,0.000025,0.000122,0.003837
JetreL,16,3,16,19,3,20,23,7,0.267624,0.281182,0.000212,0.000058,0.001313
Taraxian,10,7,6,13,25,12,37,7,0.275587,0.28975,0.000194,0.000131,0.006815
Jncocontrol,23,9,21,30,19,48,67,7,0.312582,0.33333,0.000324,0.000186,0.004505
FakeVoiceOfReason,13,4,2,6,22,13,35,8,0.248846,0.259086,0.000002,0.000115,0.001576
Johnnyg150,27,8,12,20,26,41,67,7,0.30343,0.323379,0.00008,0.000282,0.004701
Much-Jackfruit2599,13,9,3,12,10,3,13,8,0.222533,0.22943,0.000154,0.000136,0.000327
Qwertyham,26,15,6,21,22,8,30,7,0.266021,0.278026,0.000822,0.000192,0.004012
Sang1188,13,6,1,7,7,1,8,8,0.231639,0.239817,0.00003,0.000056,0.000686
buffy624,13,6,5,11,24,12,36,8,0.235065,0.243834,0.000288,0.000276,0.000291
rogue-iceberg,10,4,1,5,4,1,5,8,0.220895,0.227193,0.000004,0.000057,0.000252
Kangaru82,53,15,69,84,25,210,235,7,0.314929,0.336841,0.004739,0.000405,0.001419
CABILATOR,11,5,0,5,5,0,5,0,0,0,0,0.000053,0.001093
DaveyDumplings,14,7,3,10,10,3,13,8,0.248464,0.257808,0.000104,0.000092,0.000558
Educational_Fox6899,10,3,1,4,16,4,20,8,0.215996,0.221725,0,0.000113,0.000663
Intelligent_Fig_4852,16,5,4,9,10,6,16,8,0.250124,0.259588,0.000145,0.000068,0.000631
LCJonSnow,10,8,2,10,10,3,13,8,0.219428,0.225666,0.000055,0.000086,0.002342
NothingButACasual,13,7,8,15,16,9,25,8,0.2339,0.24292,0.000126,0.000166,0.000522
hmmyeah3030,12,9,4,13,16,9,25,8,0.228368,0.23613,0.000133,0.000251,0.001231
Katarack21,11,5,6,11,13,11,24,7,0.269455,0.287752,0.000014,0.000071,0.007123
174wrestler,19,11,4,15,14,5,19,8,0.256994,0.266962,0.0003,0.000135,0.001232
Immediate_Loquat_246,10,5,4,9,9,9,18,7,0.249284,0.256746,0.000251,0.000141,0.000468
Indigo-Waterfall,15,4,1,5,10,4,14,1,1,1,0.000219,0.000249,0.000557
Ms-Metal,15,3,5,8,41,9,50,7,0.264405,0.275877,0.00002,0.000074,0.001239
Pale_Row1166,44,11,5,16,55,13,68,8,0.216647,0.22347,0.000171,0.000266,0.001193
Rredhead926,12,5,4,9,16,6,22,8,0.218497,0.225303,0.000196,0.000104,0.0002
SaltyLonghorn,10,8,4,12,13,4,17,8,0.230977,0.237583,0.00012,0.000099,0.000888
TestingBrokenGadgets,55,33,28,61,57,34,91,7,0.280052,0.295645,0.002554,0.000572,0.002529
UniqueGuy362,10,1,4,5,1,4,5,7,0.229142,0.235985,0.000071,0.000034,0.00016
Various_Jaguar_5539,13,2,4,6,3,9,12,8,0.207514,0.212696,0.000278,0.000181,0.00016
itmeMEEPMEEP,15,7,3,10,25,6,31,8,0.238972,0.247241,0.000195,0.000211,0.000571
Key_Palpitation_7975,19,5,6,11,14,19,33,7,0.297159,0.315448,0.00002,0.000124,0.003554
Kimzhal,15,7,39,46,13,131,144,7,0.316116,0.339058,0.000503,0.00012,0.003228
Dependent-Fig-2517,14,12,5,17,26,6,32,7,0.287045,0.301741,0.000144,0.000142,0.005889
pi_3141592653589,10,6,6,12,20,13,33,8,0.270372,0.285374,0.000024,0.000118,0.003529
SkinnerBoxBaddie,28,10,6,16,34,12,46,7,0.262657,0.27563,0.00013,0.000168,0.008737
oversoul00,23,13,8,21,35,16,51,7,0.275688,0.290598,0.000103,0.000144,0.011157
King_Lothar_,51,34,108,142,56,562,618,6,0.34462,0.376408,0.005583,0.000563,0.009835
Acrobatic-Stay-9687,17,7,5,12,30,15,45,8,0.238168,0.24551,0.000604,0.000175,0.003816
BelleColibri,14,4,3,7,28,7,35,7,0.271474,0.285959,0.000026,0.000098,0.003173
Fragrant-Swing-1106,22,8,6,14,50,19,69,7,0.276327,0.28911,0.000253,0.000258,0.003498
JJSF2021,14,5,3,8,31,3,34,7,0.270808,0.284022,0.000018,0.00006,0.006275
JadedDruid,76,36,25,61,156,51,207,7,0.303166,0.320999,0.002037,0.00068,0.017285
Lorguis,13,10,7,17,27,13,40,7,0.261943,0.274007,0.000053,0.00018,0.007539
Mediocre-Pudding-815,10,1,5,6,8,7,15,8,0.263697,0.27611,0.000004,0.00004,0.001603
PublikSkoolGradU8,10,16,4,20,16,4,20,7,0.266193,0.279937,0.000207,0.000133,0.018961
TheTrueCampor,17,7,4,11,28,12,40,7,0.273854,0.28743,0.000024,0.000125,0.00659
TrueKing9458,10,5,2,7,12,3,15,7,0.252579,0.263175,0.000004,0.000054,0.007693
WhoopsDroppedTheBaby,19,3,3,6,37,16,53,7,0.259497,0.271579,0.000011,0.000182,0.001848
_segamega_,12,3,2,5,14,11,25,7,0.267703,0.280375,0.000005,0.000117,0.004716
blangenie,12,5,4,9,29,12,41,7,0.276276,0.289994,0.000022,0.000128,0.00566
disisathrowaway,10,12,7,19,24,13,37,7,0.292703,0.31036,0.000218,0.00015,0.014013
drtropo,42,14,12,26,86,51,137,7,0.271035,0.283877,0.000364,0.000424,0.008279
thebottomblocks,42,8,6,14,77,35,112,7,0.258682,0.270988,0.000033,0.00038,0.004145
ThemisChosen,11,8,3,11,20,8,28,7,0.255385,0.266731,0.000031,0.000153,0.001972
Realistic-Weight5078,10,5,3,8,6,4,10,8,0.205751,0.211656,0.000055,0.000112,0.000171
Tired_Redneck,10,4,3,7,14,9,23,8,0.221771,0.228325,0.000038,0.000168,0.000146
ktbear716,20,13,4,17,22,5,27,8,0.24419,0.252376,0.000216,0.000248,0.001228
AmusingMusing7,18,8,5,13,18,9,27,8,0.267624,0.284259,0.000044,0.000148,0.005957
Automatic-Flounder-3,20,18,14,32,40,21,61,7,0.282128,0.298789,0.00026,0.000254,0.018069
CrawlerSiegfriend,11,9,0,9,11,0,11,0,0,0,0,0.000072,0.012616
LateralEntry,24,22,15,37,53,21,74,7,0.295665,0.316388,0.000811,0.000302,0.016571
NOOBFUNK,10,10,4,14,26,6,32,8,0.250221,0.260659,0.000034,0.000213,0.010508
NekoCatSidhe,52,37,19,56,88,36,124,7,0.279482,0.300814,0.000948,0.00053,0.034533
Tw1tcHy,30,16,18,34,48,29,77,8,0.274651,0.292693,0.000248,0.000188,0.019237
equiNine,13,14,8,22,28,15,43,8,0.248983,0.262274,0.000066,0.000162,0.017444
goddamnitwhalen,39,24,19,43,65,37,102,8,0.265086,0.2829,0.000246,0.000351,0.022189
jethomas5,26,12,15,27,61,33,94,8,0.271669,0.290307,0.00033,0.000237,0.01661
neverendingchalupas,22,18,17,35,32,23,55,7,0.266193,0.281999,0.000395,0.000171,0.024434
stinkywrinkly,20,8,9,17,34,28,62,8,0.264159,0.281183,0.000134,0.000288,0.011404
xXxdethl0rdxXx,17,9,3,12,25,7,32,8,0.258623,0.271608,0.000028,0.000134,0.006078
Over-Group8722,10,9,5,14,17,9,26,7,0.286882,0.30172,0.000023,0.000124,0.006949
Late-Reception-2897,12,10,18,28,13,29,42,7,0.319935,0.341336,0.000236,0.000117,0.006203
Late_Gap2089,14,7,12,19,12,22,34,7,0.282269,0.297538,0.000073,0.00009,0.002493
Paradoxe-999,30,8,9,17,66,33,99,7,0.298,0.317144,0.000134,0.000304,0.002114
Vanman04,10,11,2,13,23,7,30,7,0.248628,0.257179,0.00006,0.00018,0.009938
Leading-Ostrich200,13,8,21,29,10,97,107,7,0.293367,0.311237,0.000183,0.00012,0.001432
StockfishLaughed,16,11,5,16,23,5,28,8,0.253413,0.26469,0.000032,0.000105,0.007289
saltedmangos,14,13,6,19,40,14,54,8,0.278879,0.296623,0.000153,0.000162,0.011433
LeagueEfficient5945,60,6,19,25,38,77,115,7,0.295762,0.312196,0.000194,0.0003,0.006682
Much-Performer1190,12,7,6,13,23,12,35,7,0.293139,0.311432,0.000155,0.000102,0.007422
cereal_killer1337,11,7,4,11,17,8,25,8,0.25451,0.265399,0.000032,0.000121,0.002871
LeonidasKing,37,13,91,104,17,219,236,7,0.321799,0.350639,0.001535,0.000204,0.006703
AlChandus,12,6,5,11,18,13,31,8,0.251807,0.26475,0.000009,0.000121,0.007504
Baselines_shift,14,10,9,19,15,13,28,7,0.269071,0.287126,0.000064,0.000103,0.007765
Iustis,29,14,10,24,40,27,67,8,0.257886,0.271887,0.000109,0.00023,0.010729
LukasJackson67,34,18,13,31,42,26,68,7,0.264405,0.282703,0.000165,0.000245,0.018413
NJBarFly,17,7,9,16,8,14,22,7,0.25401,0.264878,0.000633,0.000167,0.003385
RabbaJabba,46,14,8,22,56,34,90,7,0.254968,0.271704,0.000061,0.000293,0.016221
YakCDaddy,19,6,6,12,27,15,42,7,0.274935,0.290643,0.000133,0.000242,0.006508
bjdevar25,23,22,12,34,46,19,65,7,0.287501,0.305568,0.000374,0.000237,0.025495
bones_bones1,10,13,1,14,19,1,20,9,0.211054,0.219674,0.000001,0.000179,0.019736
cpatkyanks24,12,8,2,10,13,2,15,8,0.250221,0.262295,0.000013,0.000121,0.004659
eldomtom2,19,6,4,10,19,16,35,8,0.223268,0.233753,0.000008,0.000176,0.005987
furtive_phrasing_,73,24,70,94,49,262,311,6,0.330898,0.359796,0.00244,0.00038,0.01014
rctid_taco,12,9,10,19,14,11,25,8,0.259914,0.274508,0.000143,0.000112,0.003191
schistkicker,11,14,11,25,25,11,36,8,0.262886,0.277377,0.000044,0.000078,0.02117
servetheKitty,15,5,7,12,14,9,23,8,0.247311,0.258957,0.000013,0.00009,0.002471
tekyy342,11,15,6,21,22,9,31,7,0.254553,0.270336,0.000032,0.000171,0.017558
Flapjack_Ace,10,6,3,9,19,9,28,8,0.272192,0.28628,0.000057,0.000134,0.002619
Fulg3n,20,12,5,17,30,14,44,8,0.250318,0.262219,0.000242,0.000251,0.012221
Gauss-JordanMatrix,10,5,4,9,12,10,22,7,0.274136,0.288176,0.000036,0.000128,0.003701
Legal-Hunt-93,10,6,6,12,20,11,31,7,0.29131,0.309284,0.000073,0.000134,0.006286
ManofTheNightsWatch,20,5,4,9,24,16,40,7,0.275721,0.291293,0.000012,0.000151,0.002993
Revachol_Dawn,21,9,8,17,27,20,47,7,0.278075,0.290486,0.000158,0.000212,0.003012
VirtualMoneyLover,28,13,16,29,74,35,109,7,0.289485,0.3047,0.000195,0.00029,0.005707
seattleseahawks2014,14,3,6,9,9,8,17,8,0.254224,0.265761,0.000146,0.000093,0.000921
unitedshoes,10,9,13,22,23,16,39,7,0.2939,0.312017,0.000221,0.000091,0.006844
Life-Dinner-8516,13,3,19,22,3,25,28,8,0.253868,0.265763,0.000795,0.000067,0.000176
sreno77,21,15,5,20,20,11,31,8,0.214553,0.221743,0.000488,0.000239,0.000806
Lightlicker3000,21,3,27,30,3,79,82,7,0.275772,0.291292,0.000198,0.000061,0.000062
Blecher_onthe_Hudson,10,4,6,10,10,9,19,7,0.251471,0.25883,0.000096,0.000092,0.00033
OrthodoxAnarchoMom,14,11,5,16,16,8,24,8,0.256252,0.266132,0.000168,0.000144,0.003174
Quiet-Joke6518,14,4,3,7,24,5,29,8,0.221901,0.228972,0.000077,0.000157,0.000142
Raptor_197,16,4,2,6,11,4,15,8,0.208441,0.213796,0.000014,0.000091,0.00112
LilWackmutant,19,3,18,21,3,24,27,7,0.284539,0.297073,0.000466,0.000097,0.000045
InvestigatorOk7015,16,8,3,11,10,4,14,8,0.216398,0.22391,0.000055,0.000127,0.00096
Ok-Condition-6932,15,6,4,10,13,9,22,7,0.274485,0.290765,0.000173,0.000181,0.007013
Story_Man_75,12,10,5,15,14,6,20,8,0.250984,0.259988,0.000372,0.000165,0.000934
TFOLLT,11,4,2,6,5,2,7,8,0.229456,0.235712,0.00006,0.000061,0.000337
LiquidAssholeOfDeath,15,8,19,27,13,30,43,7,0.310163,0.330721,0.000151,0.000114,0.004094
Livid-Equal9311,16,1,2,3,1,2,3,8,0.206565,0.211552,0.000219,0.000097,0
VioletteToussaint,11,1,1,2,1,1,2,9,0.171207,0.174008,0,0.000074,0.000001
LocationOld6656,40,5,48,53,6,138,144,7,0.30081,0.319446,0.001416,0.000102,0.000759
CandelaBelen,13,4,3,7,26,3,29,8,0.23867,0.245369,0.00003,0.000098,0.000241
CarrieDurst,28,10,9,19,15,19,34,8,0.219769,0.227544,0.001381,0.000343,0.002361
Reflxing,25,5,51,56,6,417,423,7,0.298589,0.317793,0.002181,0.000091,0.001324
faux-fox-paws,15,6,5,11,21,5,26,7,0.27407,0.286768,0.000089,0.000067,0.002664
weedful_things,13,3,4,7,11,7,18,8,0.223699,0.229747,0.000223,0.000195,0.00019
Logical_Trainer1939,17,3,10,13,3,16,19,8,0.217469,0.226096,0.000096,0.000085,0.00003
Tobias_Kitsune,23,6,4,10,22,12,34,8,0.253853,0.265187,0.000026,0.000154,0.009255
Lonely-Medicine-8832,19,11,17,28,20,27,47,7,0.315434,0.335698,0.000252,0.000125,0.006038
Loopy_Legend,13,3,11,14,6,22,28,7,0.268704,0.28249,0.000105,0.0001,0.00042
I-am-that-b,11,8,6,14,11,7,18,7,0.250678,0.259226,0.000171,0.000063,0.004741
Miss_Honesty_,11,5,2,7,11,7,18,8,0.245581,0.255686,0.000008,0.000126,0.001958
No-Recording-7486,11,5,2,7,22,6,28,7,0.268815,0.279428,0.000248,0.000183,0.001697
Oheligud,10,6,8,14,10,15,25,7,0.2873,0.300413,0.000146,0.000122,0.001775
Open-Gate-7769,17,5,17,22,11,70,81,8,0.266286,0.278603,0.000307,0.000137,0.000483
Own_Reaction9442,18,8,7,15,17,16,33,7,0.257769,0.267104,0.000085,0.000179,0.000885
PjJones91,21,12,7,19,21,8,29,8,0.242063,0.251354,0.000379,0.000139,0.00122
Spirited-Humor-554,16,6,2,8,13,2,15,8,0.21675,0.222624,0.000011,0.000132,0.000632
Talk-O-Boy,10,7,5,12,8,5,13,8,0.244943,0.252401,0.000088,0.000105,0.001014
ThePepperPopper,13,2,2,4,2,2,4,8,0.237943,0.245702,0.000005,0.000042,0.000431
eugeneugene,11,8,4,12,14,5,19,7,0.253385,0.262386,0.000053,0.000097,0.001066
mr-snrub-,27,6,3,9,14,11,25,8,0.236947,0.244431,0.000104,0.000148,0.00064
-Resident-One-,16,8,7,15,29,15,44,7,0.283133,0.298498,0.000076,0.000153,0.005135
2074red2074,10,4,3,7,23,12,35,7,0.266694,0.279617,0.000025,0.000148,0.003809
BeastMasterHung7769,29,11,7,18,61,27,88,8,0.266773,0.27849,0.000259,0.000296,0.011881
Formal-Hat-7533,42,7,6,13,70,29,99,7,0.284753,0.302602,0.000176,0.000306,0.006778
IndependentlyBrewed,15,6,4,10,21,12,33,7,0.269728,0.283934,0.000054,0.000116,0.004186
LongConsideration662,17,6,6,12,41,18,59,8,0.281357,0.299344,0.000065,0.000144,0.004659
MenuZealousideal9058,13,7,21,28,9,40,49,7,0.316271,0.33715,0.000339,0.000098,0.00422
Muadeeb,30,10,7,17,61,24,85,8,0.284968,0.303274,0.000179,0.00031,0.005105
Remarkable-Set5434,22,13,29,42,20,142,162,7,0.321891,0.344887,0.000755,0.000167,0.00932
Rogue_Wisdom,11,5,2,7,24,12,36,7,0.25849,0.269283,0.000006,0.000119,0.003792
Sea_Entrepreneur6204,14,10,4,14,19,8,27,7,0.2631,0.276451,0.000042,0.000114,0.004796
Straight-Simple7705,10,4,3,7,22,9,31,8,0.242699,0.250869,0.000037,0.000161,0.001708
Tall-Attitude5836,13,6,5,11,31,14,45,7,0.266993,0.281444,0.000045,0.000153,0.007649
TipImpossible1343,84,11,15,26,115,73,188,7,0.290283,0.306568,0.000527,0.000598,0.003453
Total-Lecture2888,14,5,3,8,25,13,38,7,0.252861,0.263378,0.000013,0.000166,0.002429
Vegetable-College-17,11,4,3,7,14,5,19,8,0.23813,0.246695,0.000007,0.000093,0.002814
craterIII,10,4,2,6,20,3,23,7,0.269471,0.28131,0.000137,0.000063,0.003538
jbslaw1214,27,10,5,15,65,21,86,8,0.262901,0.275765,0.000106,0.000324,0.007839
lonecylinder,14,7,4,11,22,7,29,7,0.300491,0.320686,0.000123,0.000086,0.010412
okiujh,28,13,48,61,18,251,269,7,0.326532,0.350712,0.00084,0.000176,0.004383
phleshlight,23,7,5,12,24,11,35,7,0.291404,0.309339,0.00092,0.000252,0.001714
snakeoilHero,10,8,4,12,12,6,18,8,0.278828,0.296164,0.000196,0.000092,0.008948
Low-Forever8802,21,4,7,11,14,25,39,7,0.282939,0.297493,0.000031,0.000174,0.000875
ChronicCactus,10,4,2,6,13,6,19,8,0.241714,0.249775,0.000007,0.000106,0.002286
Loves_octopus,11,11,6,17,17,6,23,8,0.257769,0.268675,0.000176,0.000145,0.00513
Low_Tooth230,13,2,5,7,4,27,31,8,0.18541,0.189376,0.000976,0.000129,0
GhostyUnleashed,11,2,1,3,17,4,21,10,0.135267,0.136754,0,0.000261,0
Sensate613,13,2,2,4,12,8,20,9,0.156421,0.158763,0.000219,0.000288,0
GM_Pax,12,6,5,11,34,19,53,8,0.240316,0.248239,0.000076,0.000296,0.000271
IShitMyFuckingPants,13,3,5,8,19,8,27,8,0.252847,0.261252,0.000137,0.000063,0.000439
Slappadabike91,12,6,2,8,14,2,16,8,0.218465,0.224846,0.000033,0.000105,0.001441
Stagnu_Demorte,19,7,6,13,13,11,24,8,0.243207,0.250469,0.000323,0.00014,0.000486
MINGIONOFFICIAL,14,3,6,9,5,10,15,7,0.247811,0.258021,0.000138,0.000082,0.000298
kep_x124,32,2,18,20,7,39,46,7,0.260213,0.272679,0.000172,0.000153,0.000044
Madotsuki2,35,12,23,35,40,71,111,6,0.329526,0.347343,0.001159,0.000293,0.007246
Latin_Stallion7777,25,2,1,3,15,2,17,8,0.230156,0.237682,0.000001,0.000049,0.000908
SeeRecursion,56,16,15,31,72,56,128,7,0.312453,0.33292,0.000537,0.000454,0.011409
MajesticBread9147,26,21,26,47,33,107,140,6,0.319146,0.338191,0.001061,0.000249,0.01404
varnums1666,44,18,16,34,75,42,117,7,0.29259,0.308365,0.000291,0.000379,0.010084
Major_Tap4199,32,22,67,89,32,187,219,6,0.344699,0.37166,0.002127,0.000286,0.008807
FjortoftsAirplane,13,4,4,8,15,8,23,7,0.277529,0.29258,0.000008,0.000068,0.004712
ImNoLawyer,15,16,8,24,22,11,33,8,0.26682,0.281676,0.000237,0.000135,0.01297
Sorry-Joke-4325,18,14,10,24,32,17,49,7,0.287282,0.303627,0.000157,0.000195,0.00911
WatcherOfStarryAbyss,25,11,9,20,65,32,97,7,0.274385,0.289208,0.000198,0.000339,0.007415
cinnamon64329,23,9,8,17,30,22,52,7,0.302842,0.319733,0.001801,0.000304,0.008115
solariam,34,8,4,12,59,21,80,8,0.234688,0.244123,0.000178,0.000288,0.002986
ManHasJam,18,17,111,128,22,661,683,7,0.336704,0.36944,0.00276,0.000223,0.005319
FreeGazaToday,11,9,3,12,18,4,22,8,0.236329,0.245253,0.000028,0.000084,0.010206
Gryffindorcommoner,33,10,9,19,45,29,74,8,0.270954,0.288564,0.000171,0.000235,0.013527
LankyEvening7548,25,6,5,11,56,26,82,7,0.260797,0.27347,0.00005,0.000309,0.002918
NotACommie24,13,16,10,26,21,15,36,7,0.275085,0.290938,0.00027,0.000223,0.00553
Standupaddict,11,4,2,6,18,3,21,8,0.227188,0.236806,0.000004,0.000063,0.006119
StockAdeptness9452,11,3,2,5,22,11,33,8,0.245195,0.255383,0.000004,0.000119,0.002073
TangoJavaTJ,44,18,7,25,90,15,105,7,0.259408,0.271428,0.000263,0.000402,0.005146
TankyRo,11,6,4,10,21,8,29,7,0.269953,0.281851,0.000022,0.000081,0.008894
answer_giver78,11,3,2,5,16,11,27,7,0.24845,0.258697,0.000022,0.000074,0.002186
apophis-pegasus,10,10,4,14,20,7,27,7,0.25047,0.26164,0.000039,0.000111,0.00749
fruitful_discussion,11,7,5,12,16,8,24,7,0.244296,0.253388,0.000024,0.00011,0.003183
hamletswords,12,8,4,12,17,5,22,8,0.263467,0.274526,0.000044,0.000133,0.007833
ilGeno,10,4,2,6,22,11,33,8,0.244204,0.255054,0.000009,0.000126,0.003302
khoawala,16,8,6,14,20,12,32,7,0.271686,0.286975,0.000065,0.000115,0.005273
marxist-teddybear,31,13,10,23,66,25,91,7,0.26281,0.276868,0.000147,0.00024,0.006528
nar_tapio_00,26,10,13,23,24,27,51,7,0.308873,0.327643,0.0002,0.000137,0.008595
nightim3,10,7,2,9,16,3,19,7,0.277088,0.293731,0.000036,0.000065,0.008199
rdsuxiszdix,20,5,5,10,42,22,64,7,0.270906,0.28623,0.000034,0.0002,0.003876
the_other_brand,12,6,4,10,23,6,29,7,0.271947,0.285821,0.000069,0.000122,0.004713
turtleduck,17,5,3,8,42,22,64,8,0.234894,0.242768,0.000002,0.000251,0.001685
garden_dragonfly,28,14,12,26,62,29,91,7,0.3114,0.329253,0.000862,0.00024,0.01695
Massive-Albatross823,13,3,9,12,4,10,14,8,0.25391,0.265531,0.000107,0.000064,0.000073
Feyle,32,5,4,9,22,17,39,8,0.221912,0.229207,0.000074,0.000203,0.000135
PitifulEar3303,24,5,49,54,5,126,131,7,0.324939,0.347279,0.001886,0.00008,0.001408
MathProg999,11,8,17,25,10,32,42,7,0.306117,0.326642,0.000129,0.000099,0.004987
MattCrispMan117,40,5,9,14,18,27,45,8,0.265849,0.278709,0.000589,0.000145,0.00078
ChChChillian,21,3,2,5,9,3,12,9,0.21493,0.221209,0.000006,0.000096,0.000109
man-vs-spider,26,11,21,32,20,95,115,7,0.315456,0.337377,0.000607,0.00018,0.002911
MegaZeroX7,10,0,69,69,0,203,203,6,0.325104,0.34468,0,0.000033,0
Cheeseish,10,9,6,15,13,6,19,8,0.249381,0.258613,0.000288,0.000171,0.000964
Dogeata99,10,5,5,10,17,7,24,8,0.218476,0.225454,0.000025,0.000117,0.000451
StargazerRex,21,11,10,21,17,13,30,7,0.269567,0.281476,0.000294,0.000117,0.0065
WitnessRadiant650,16,9,5,14,17,9,26,8,0.24052,0.249148,0.000137,0.000152,0.000644
chronberries,21,20,10,30,33,15,48,7,0.287738,0.301848,0.000845,0.0002,0.011684
kylebertram,13,4,6,10,16,7,23,8,0.250028,0.259116,0.000083,0.000066,0.000567
PeneshTheTurkey,21,7,6,13,15,16,31,7,0.270227,0.283782,0.000026,0.000163,0.004824
Meme_stonkputbuyer,14,5,10,15,19,101,120,7,0.307572,0.322839,0.000114,0.000183,0.002214
MercyfulFan,19,1,4,5,1,6,7,7,0.234142,0.241481,0.000262,0.000036,0.000112
JPDG,16,6,3,9,20,9,29,7,0.260992,0.272442,0.000082,0.000172,0.00128
Metro29993,11,6,51,57,10,118,128,7,0.331698,0.359092,0.000696,0.000102,0.006744
MickeyKae,11,9,10,19,14,17,31,8,0.271052,0.285233,0.000066,0.000154,0.002366
MichaelStone987,18,4,10,14,8,15,23,7,0.29369,0.309307,0.00003,0.000063,0.001608
MiddleList52,10,4,11,15,9,43,52,7,0.2886,0.304524,0.000039,0.000099,0.001703
Joubachi,16,6,1,7,13,1,14,8,0.251933,0.26146,0.000049,0.000075,0.000382
DeHarigeTuinkabouter,16,10,6,16,25,8,33,8,0.242933,0.251669,0.000325,0.000273,0.000584
Specific_Bass_5869,12,9,7,16,16,8,24,8,0.261671,0.272588,0.000419,0.00019,0.000795
bruhbelacc,12,4,3,7,11,7,18,8,0.214807,0.220894,0.000033,0.000236,0.000234
pistachio-pie,19,4,7,11,14,14,28,8,0.246262,0.255537,0.000071,0.000173,0.000256
stprnn,21,3,5,8,9,15,24,8,0.250014,0.25911,0.000109,0.00016,0.000229
tomerFire,50,10,15,25,41,68,109,7,0.254983,0.266345,0.001776,0.000563,0.000362
MountainHigh31,11,10,3,13,15,5,20,7,0.259556,0.271373,0.000041,0.000155,0.002412
Zweilous123,53,14,27,41,49,84,133,7,0.324613,0.34486,0.00059,0.000327,0.006378
MinnLovesTheSceneryy,11,4,4,8,6,8,14,8,0.201746,0.207615,0.00003,0.000163,0.000017
KaliTheBlaze,17,7,4,11,17,7,24,8,0.202061,0.208554,0.000064,0.000195,0.000038
ptheresadactyl,23,8,6,14,34,8,42,8,0.215615,0.22256,0.000147,0.000249,0.000067
Mirantibus88,12,4,17,21,6,34,40,7,0.278297,0.290722,0.000734,0.000085,0.000951
DeaconSage,13,3,2,5,16,15,31,8,0.217908,0.223534,0.000097,0.00025,0.000218
TheLordofthething,12,6,2,8,7,2,9,8,0.246369,0.253861,0.000041,0.000074,0.001137
TrustSweet,10,6,10,16,20,13,33,8,0.248464,0.261323,0.000602,0.000104,0.000283
MisterMittens64,25,4,7,11,22,58,80,8,0.268847,0.286546,0.000019,0.000191,0.004675
SoggyGrayDuck,10,9,6,15,11,6,17,7,0.253031,0.268341,0.000023,0.000099,0.00816
MobileShirt4924,13,4,15,19,4,29,33,7,0.260677,0.271626,0.000485,0.000106,0.000103
decafade9,11,7,4,11,18,8,26,8,0.242595,0.251032,0.00014,0.000131,0.002037
MockingJ1776,62,8,16,24,15,30,45,8,0.262201,0.273246,0.001694,0.00027,0.000155
EmceeSuzy,38,17,10,27,23,10,33,8,0.247974,0.258114,0.000992,0.000332,0.000168
MrBleuPotato,11,6,22,28,6,32,38,8,0.262216,0.27504,0.001007,0.000167,0.000039
1962Michael,12,4,3,7,8,3,11,8,0.225728,0.232743,0.000397,0.000148,0.000049
Bluebunnywitch,23,8,10,18,13,23,36,8,0.206955,0.214305,0.000215,0.000227,0.000056
Mrkvitko,32,11,17,28,31,43,74,7,0.328808,0.349995,0.000464,0.000262,0.009676
Much-Honey-8607,10,3,12,15,3,19,22,8,0.246503,0.256813,0.000395,0.000085,0.000033
Mundane-Laugh8562,13,4,4,8,7,11,18,7,0.295299,0.312701,0.000024,0.000115,0.002758
Mundane_Topic4165,17,3,11,14,5,23,28,8,0.270695,0.281597,0.000478,0.000084,0.000073
Beruthiel999,16,8,7,15,30,12,42,7,0.30069,0.316369,0.000968,0.000158,0.006397
Niceotropic,24,10,76,86,13,194,207,7,0.333653,0.358878,0.005339,0.000165,0.001497
Ok-Cheetah-9125,10,6,1,7,7,1,8,10,0.16375,0.166397,0.000026,0.000147,0.000133
MycologistThen8716,26,3,10,13,5,13,18,8,0.224775,0.233642,0.00016,0.000117,0.000008
Mysterious-Fact1887,13,4,8,12,7,16,23,7,0.24727,0.256361,0.000452,0.000219,0.000006
grayscale001,11,8,5,13,11,6,17,7,0.291067,0.30599,0.000056,0.000073,0.006682
Jackandahalfass,11,4,1,5,7,1,8,8,0.235297,0.24384,0.000003,0.000083,0.000958
doriangray42,10,4,1,5,4,1,5,9,0.22163,0.228095,0.000005,0.000056,0.000505
Ragnaroknight,16,10,21,31,14,26,40,7,0.327477,0.349513,0.000896,0.00014,0.008065
Neat_Attorney_5414,52,14,31,45,42,82,124,7,0.309126,0.328524,0.000746,0.000361,0.004353
Jealous-Factor7345,18,7,5,12,40,16,56,7,0.265071,0.27758,0.000023,0.000183,0.002749
SocksRocksDocks,30,7,3,10,70,34,104,7,0.273111,0.284525,0.000057,0.000276,0.002924
i_make_orange_rhyme,15,8,8,16,13,17,30,7,0.297706,0.316365,0.000227,0.000138,0.003756
mangongo,19,6,6,12,42,23,65,7,0.262353,0.275137,0.000025,0.000227,0.00185
BuzzBadpants,12,9,5,14,14,7,21,8,0.258416,0.270261,0.000183,0.000065,0.014349
Confident_Counter471,14,7,10,17,13,10,23,8,0.251849,0.263691,0.000168,0.000057,0.001227
Famous-Garlic3838,14,8,5,13,21,10,31,8,0.259497,0.27094,0.000025,0.000136,0.008213
GuestCartographer,15,13,2,15,21,9,30,8,0.250429,0.260006,0.000393,0.000134,0.012046
ItemEven6421,10,5,3,8,18,12,30,9,0.207324,0.212826,0.000199,0.00021,0.000835
cballowe,20,13,5,18,23,13,36,8,0.242985,0.254938,0.00006,0.000221,0.007818
cptngabozzo,17,6,3,9,20,15,35,8,0.252819,0.262492,0.000113,0.000207,0.004641
creativ3ace,35,10,11,21,27,36,63,8,0.260827,0.271818,0.000337,0.000487,0.001128
letsgooncemore,11,4,3,7,11,6,17,8,0.240994,0.248773,0.000035,0.000101,0.000912
Nillavuh,60,38,188,226,70,597,667,6,0.372604,0.412939,0.009423,0.000624,0.012399
Away_Simple_400,42,7,6,13,68,26,94,7,0.291348,0.307684,0.000209,0.000233,0.007779
Beautiful-Loss7663,12,9,6,15,26,11,37,7,0.29295,0.310623,0.000139,0.000096,0.013574
Final_Ebb_9091,11,5,5,10,17,14,31,7,0.287574,0.30508,0.000028,0.000092,0.008574
FlarkingSmoo,19,10,4,14,30,12,42,8,0.242933,0.252376,0.000036,0.000158,0.018559
JoesG527,10,7,5,12,10,5,15,7,0.25047,0.261004,0.000246,0.000095,0.005956
OccamsRabbit,18,11,8,19,38,19,57,7,0.30121,0.320355,0.000332,0.00016,0.02144
Pasta4ever13,14,6,3,9,27,6,33,7,0.267056,0.279734,0.000034,0.000096,0.010074
SatisfactoryLoaf,16,11,5,16,24,11,35,7,0.288288,0.304073,0.00023,0.000156,0.007217
SirWhateversAlot,10,6,5,11,12,10,22,8,0.241032,0.249873,0.000035,0.000089,0.006747
WideAbbreviations6,22,8,7,15,22,20,42,7,0.288049,0.304522,0.000365,0.000178,0.005866
ethancknight,33,12,13,25,30,23,53,7,0.298196,0.314272,0.001466,0.000257,0.004583
nerojt,45,14,13,27,83,36,119,7,0.293652,0.312261,0.000292,0.000332,0.011591
pile_of_bees,18,9,6,15,37,14,51,7,0.290172,0.307421,0.000071,0.000123,0.010394
pppalexjack,10,5,3,8,13,9,22,7,0.279896,0.294251,0.00001,0.000064,0.009155
rlyjustanyname,11,9,5,14,22,8,30,7,0.269295,0.281056,0.000037,0.000098,0.007896
sccamp,11,6,3,9,11,3,14,7,0.273904,0.287995,0.000015,0.000044,0.009411
that_guy_ontheweb,12,15,13,28,20,21,41,7,0.29853,0.314126,0.000463,0.000157,0.008745
No-Chart-9387,20,2,42,44,6,111,117,7,0.305312,0.322693,0.000356,0.000129,0.000014
lebetepuante,13,3,4,7,10,7,17,8,0.246825,0.255114,0.000074,0.000127,0.000159
whatisupwithmyfood,67,12,33,45,39,100,139,7,0.290246,0.306446,0.00192,0.000533,0.000513
Objective_Air8976,19,9,5,14,37,21,58,8,0.225671,0.233361,0.000917,0.000331,0.005631
No-Management4833,11,2,7,9,2,7,9,8,0.203734,0.210357,0.000046,0.000082,0.000011
No-Squirrel3568,11,4,6,10,5,9,14,8,0.205854,0.213658,0.00007,0.000159,0.000004
Counther,10,4,2,6,5,2,7,8,0.185023,0.190317,0.000048,0.000084,0.000021
chessNotcheckers247,12,5,2,7,15,8,23,8,0.23419,0.243449,0.000006,0.000155,0.001241
No_Egg5179,18,3,18,21,8,33,41,8,0.255934,0.268244,0.000298,0.000166,0.000039
X4dow,12,7,2,9,10,5,15,8,0.222928,0.22992,0.000013,0.000181,0.000372
_AskMyMom_,12,6,3,9,10,7,17,8,0.225458,0.233314,0.000162,0.000129,0.000395
No_Gazelle9054,11,5,13,18,7,27,34,7,0.317624,0.338811,0.000198,0.000094,0.004107
No_Trust4114,10,1,13,14,2,20,22,7,0.2666,0.277904,0.000379,0.000051,0.000175
Novel_Pineapple_3576,14,3,48,51,3,67,70,7,0.301632,0.319204,0.000864,0.00007,0.000224
Alt_2Five,10,2,3,5,6,8,14,8,0.219577,0.226634,0.000018,0.00015,0.000122
Angylisis,20,13,8,21,51,20,71,7,0.278691,0.293407,0.000097,0.000179,0.007009
Foxlikebox,10,5,6,11,13,11,24,8,0.236477,0.24597,0.000077,0.000201,0.000217
Spotzie27,13,7,5,12,12,11,23,7,0.252918,0.261912,0.000927,0.000146,0.000975
Nubian_Cavalry,10,2,19,21,5,25,30,7,0.311743,0.329908,0.000181,0.00005,0.002808
soundmixer14,25,4,6,10,5,10,15,7,0.256484,0.266032,0.001248,0.000178,0.001409
NuclearMichy,25,6,32,38,7,171,178,7,0.257125,0.27078,0.001122,0.000202,0.000038
Chance_Job3980,27,6,4,10,50,25,75,7,0.249312,0.256876,0.000305,0.000262,0.000446
Early-Light-864,18,5,6,11,9,11,20,8,0.226802,0.236345,0.000267,0.000101,0.000089
Lunar-Eclipse0204,10,5,1,6,9,1,10,9,0.189561,0.195295,0.000004,0.000063,0.000056
Revnorthwest,12,5,4,9,21,12,33,8,0.215903,0.225107,0.000073,0.000111,0.000055
SlinkyMalinky20,10,7,3,10,14,3,17,9,0.203706,0.20953,0.000048,0.000172,0.000082
SubstanceAway5947,30,3,37,40,4,131,135,8,0.270082,0.284442,0.000638,0.000074,0.000029
andromache97,14,8,6,14,13,9,22,8,0.211113,0.218867,0.000136,0.000176,0.000047
romanaribella,12,2,2,4,19,3,22,9,0.200018,0.204851,0,0.000052,0.000107
Nullborne,36,18,28,46,31,55,86,7,0.314645,0.336131,0.000741,0.000322,0.006237
Numerous-Variety-298,16,8,15,23,16,42,58,8,0.250401,0.261566,0.000771,0.000312,0.000085
Numerous_Toe_1180,12,4,10,14,8,15,23,8,0.216099,0.225597,0.000132,0.000156,0.000003
Tough-Combination-37,13,3,2,5,7,3,10,8,0.222654,0.229602,0.000042,0.00007,0.000095
Nusselt,11,2,38,40,3,71,74,7,0.297081,0.314566,0.000258,0.000083,0.000032
HistoricalTowel1127,11,11,0,11,11,0,11,0,0,0,0,0.000091,0.001879
Rupperrt,12,6,5,11,12,5,17,8,0.252312,0.261933,0.000246,0.000078,0.000611
ObjectiveMall,15,4,43,47,15,105,120,7,0.323085,0.346193,0.000575,0.000115,0.002634
Radicalnotion528,26,14,9,23,38,25,63,7,0.274285,0.288523,0.000137,0.000205,0.008209
12_0z_curls,49,24,21,45,51,49,100,7,0.287355,0.309054,0.000401,0.000389,0.024164
2057Champs__,28,11,8,19,19,10,29,7,0.261701,0.279126,0.000038,0.000138,0.011304
4BasedFrens,13,4,5,9,28,13,41,7,0.255184,0.268087,0.00002,0.000128,0.004944
AM_Bokke,51,25,19,44,74,45,119,7,0.281549,0.301247,0.000473,0.000479,0.021103
AStealthyPerson,21,3,2,5,18,10,28,8,0.244098,0.257365,0.000002,0.000087,0.006503
Ambiwlans,11,5,7,12,9,8,17,8,0.23396,0.246239,0.000011,0.000071,0.007228
AntarcticScaleWorm,54,13,11,24,55,39,94,8,0.267577,0.282415,0.000169,0.000426,0.007488
ArendtAnhaenger,10,8,10,18,11,13,24,8,0.255731,0.270347,0.000056,0.000113,0.006882
Arkmer,30,15,5,20,28,8,36,7,0.256571,0.268397,0.000122,0.0002,0.009594
AshleyMyers44,16,10,10,20,22,17,39,8,0.252312,0.266652,0.000113,0.000241,0.007267
BKGPrints,219,32,28,60,208,188,396,7,0.292779,0.314489,0.000916,0.001236,0.02132
BalboaCZ,14,4,3,7,18,9,27,8,0.238922,0.250412,0.000003,0.000114,0.005517
Black_XistenZ,15,10,13,23,21,14,35,8,0.256252,0.271978,0.000042,0.000092,0.016613
CremePsychological77,12,10,10,20,16,11,27,8,0.255905,0.270855,0.000032,0.000118,0.012078
DickNDiaz,34,9,10,19,56,28,84,7,0.245968,0.257469,0.000078,0.000261,0.009133
FawningDeer37,15,13,13,26,19,18,37,8,0.266021,0.280997,0.000086,0.00012,0.015142
FuguSandwich,10,18,7,25,19,7,26,7,0.255977,0.268922,0.000116,0.000152,0.019527
HiSno,28,10,6,16,34,15,49,8,0.247744,0.260892,0.000052,0.000215,0.009098
Honestly_Nobody,12,9,12,21,18,15,33,7,0.259333,0.277288,0.000034,0.000121,0.011295
Irish_Pineapple,10,9,7,16,25,8,33,8,0.249147,0.261997,0.000024,0.000133,0.006389
Jeffery95,11,3,3,6,13,8,21,8,0.223864,0.233584,0.000006,0.000144,0.004551
Jmoney1088,14,9,6,15,40,15,55,8,0.253059,0.26906,0.000036,0.000189,0.012107
JustAnotherJon,11,5,4,9,8,4,12,8,0.234894,0.245878,0.00004,0.000074,0.009266
KeyYak4008,23,7,9,16,42,23,65,8,0.251555,0.267364,0.000031,0.000102,0.01237
LiberalAspergers,10,6,3,9,9,8,17,8,0.245381,0.256402,0.000078,0.000086,0.011933
MagicWishMonkey,12,9,9,18,24,14,38,8,0.259646,0.276562,0.00017,0.000105,0.011968
Matt2_ASC,17,13,29,42,24,33,57,7,0.280659,0.303827,0.000254,0.00011,0.01857
MonaSherry,12,7,3,10,27,13,40,8,0.234834,0.246139,0.000017,0.000162,0.011696
New2NewJ,19,16,10,26,23,15,38,8,0.251318,0.267309,0.00009,0.000148,0.018641
Ok_Bandicoot_814,48,26,24,50,80,37,117,8,0.262718,0.283566,0.000177,0.000368,0.021628
Ok_Macaroon6155,24,12,8,20,25,19,44,8,0.254096,0.270151,0.000049,0.000186,0.015371
OneReportersOpinion,18,4,4,8,18,10,28,8,0.245794,0.257588,0.000009,0.000101,0.005369
PlantComprehensive77,15,14,9,23,32,14,46,8,0.275537,0.286825,0.000522,0.000234,0.01006
Responsible-Yak9000,15,6,6,12,32,11,43,8,0.244349,0.256229,0.000027,0.00014,0.005982
RonaldTurner88,10,9,5,14,26,8,34,7,0.275721,0.289614,0.000095,0.000119,0.01079
Salty-Snowflake,11,9,5,14,17,11,28,8,0.267482,0.28323,0.000026,0.000135,0.012749
Selethorme,78,15,17,32,163,84,247,7,0.288435,0.307004,0.000633,0.000565,0.017487
Silent-Storms,15,10,6,16,26,11,37,8,0.255616,0.267891,0.000043,0.000135,0.00815
Snatchamo,24,16,15,31,40,28,68,7,0.268163,0.2876,0.0001,0.000229,0.015668
Sptsjunkie,44,38,29,67,84,44,128,7,0.281339,0.305596,0.001201,0.000393,0.038118
The3mbered0ne,39,10,59,69,23,199,222,7,0.295492,0.320759,0.000412,0.000195,0.007275
TorkBombs,12,15,5,20,31,13,44,8,0.233622,0.245801,0.000052,0.000158,0.012161
Vast_Road7888,10,8,9,17,29,12,41,8,0.254696,0.269606,0.000036,0.000094,0.009319
Virtual-Orchid3065,38,17,118,135,23,599,622,7,0.311143,0.345565,0.001048,0.000206,0.019639
Wermys,26,17,14,31,40,22,62,7,0.26856,0.286463,0.000075,0.000152,0.021432
__zagat__,48,25,29,54,61,48,109,8,0.291423,0.315202,0.00067,0.000312,0.027947
datalicearcher,30,6,4,10,33,10,43,8,0.261369,0.276863,0.000057,0.000138,0.014923
dsfox,10,4,4,8,8,8,16,8,0.242296,0.252925,0.000011,0.000093,0.005276
gquax,15,18,7,25,26,9,35,8,0.248874,0.261293,0.000069,0.00021,0.011637
ironyinsideme,20,12,10,22,37,14,51,7,0.246772,0.259618,0.000109,0.000194,0.009151
kevbot918,10,9,6,15,13,11,24,8,0.262718,0.276154,0.000038,0.000137,0.010747
lewkiamurfarther,19,17,20,37,28,24,52,7,0.260542,0.278087,0.00025,0.000193,0.019104
mercfan3,19,21,9,30,41,12,53,7,0.25602,0.270728,0.000201,0.000295,0.020685
mongooser,10,9,3,12,14,5,19,9,0.218286,0.227359,0.000016,0.000145,0.007311
ninfan1977,27,8,5,13,52,28,80,7,0.25136,0.267498,0.000032,0.000218,0.011146
onlyontuesdays77,48,20,15,35,59,43,102,7,0.27702,0.298324,0.000223,0.000361,0.021739
quizbowler_1,10,4,1,5,11,4,15,9,0.223038,0.232156,0,0.000079,0.009477
robby_arctor,35,7,6,13,33,33,66,8,0.231343,0.243522,0.00005,0.000381,0.00527
stripedvitamin,20,13,8,21,34,18,52,7,0.262703,0.279461,0.000039,0.000156,0.015243
t234k,33,16,10,26,46,23,69,7,0.254495,0.268533,0.00009,0.00034,0.013084
teilani_a,28,6,3,9,51,24,75,8,0.250097,0.262319,0.000004,0.000207,0.009466
telefawx,12,5,5,10,5,5,10,8,0.255385,0.268289,0.000022,0.000064,0.00564
the_original_Retro,17,17,54,71,33,101,134,7,0.297452,0.323354,0.001064,0.000198,0.01304
trace349,17,14,12,26,26,15,41,8,0.27063,0.290306,0.000112,0.000145,0.019965
umbren,15,4,5,9,33,17,50,8,0.266851,0.283056,0.000011,0.000154,0.007399
KDY_ISD,23,4,2,6,49,24,73,7,0.244046,0.252542,0.000012,0.00027,0.001756
Obvious-Routine3069,10,1,10,11,1,16,17,8,0.204055,0.213123,0.000013,0.000042,0.000005
Odd_Profession_2902,52,4,8,12,17,25,42,7,0.322923,0.341755,0.000092,0.000142,0.003504
PuzzleheadedShoe5829,170,78,366,444,160,1897,2057,6,0.41391,0.46348,0.055483,0.001409,0.023852
alwaysright0,33,10,6,16,55,36,91,7,0.265708,0.277146,0.000383,0.000335,0.007962
Ok-Buy-4545,56,19,30,49,58,222,280,7,0.319213,0.342736,0.000673,0.000458,0.007802
ArCSelkie37,10,9,7,16,22,7,29,7,0.269872,0.282,0.000149,0.00011,0.009333
GrafZeppelin127,64,3,2,5,125,70,195,8,0.266114,0.279408,0.000001,0.000484,0.001642
Longjumping-Wash-610,10,5,3,8,12,8,20,8,0.229154,0.235492,0.000022,0.000114,0.000772
SoImaRedditUserNow,16,6,5,11,9,7,16,8,0.241895,0.250791,0.000358,0.000117,0.000236
a_dupuis18,14,4,3,7,30,16,46,7,0.269055,0.279906,0.000272,0.000167,0.001353
Ok-Connection6656,11,8,45,53,14,81,95,6,0.3232,0.345967,0.000819,0.000139,0.004542
BigDaddySteve999,18,7,6,13,17,10,27,8,0.245887,0.256756,0.000046,0.000137,0.005484
JC_in_KC,12,6,3,9,24,10,34,7,0.268624,0.280728,0.00003,0.000149,0.004646
QuantumR4ge,13,7,8,15,11,11,22,7,0.271947,0.28693,0.000048,0.000081,0.004126
TheRemanence,12,7,5,12,25,12,37,7,0.245554,0.254117,0.000069,0.00017,0.004047
Ok-Mouse9337,15,9,19,28,17,46,63,7,0.302094,0.320859,0.000159,0.000154,0.003551
Ok-Swimming-8183,44,7,13,20,32,60,92,8,0.231449,0.241144,0.000468,0.000494,0.000033
OkParamedic4664,40,14,19,33,41,63,104,7,0.309041,0.328535,0.000564,0.000409,0.004819
polyvinylchl0rid,14,6,5,11,19,12,31,7,0.280225,0.292484,0.000078,0.000161,0.002983
OkPlankton2490,13,5,19,24,5,33,38,7,0.255905,0.267219,0.000495,0.000109,0.000064
Ok_Asparagus7214,16,3,28,31,10,106,116,7,0.23944,0.252761,0.000179,0.000125,0.000018
level100mobboss,13,2,3,5,4,3,7,8,0.241688,0.248814,0.000048,0.000059,0.000029
Ok_Bodybuilder_2384,52,25,103,128,44,327,371,6,0.358392,0.389045,0.004476,0.000344,0.012106
CommisarJurgen,12,4,2,6,17,12,29,7,0.25589,0.268151,0.000007,0.00007,0.003737
LynnSeattle,33,23,20,43,55,22,77,7,0.297296,0.314439,0.001282,0.000241,0.007844
Ornery_Ad_8349,24,6,4,10,49,27,76,7,0.27741,0.29063,0.000064,0.000162,0.004425
Stop_Maximum,40,11,14,25,36,45,81,7,0.299815,0.316608,0.000204,0.000228,0.007995
SweetExpression2745,28,8,4,12,41,28,69,7,0.241843,0.250012,0.000049,0.000255,0.013227
Opagea,16,4,4,8,31,9,40,8,0.23367,0.24116,0.000018,0.000197,0.002369
RigatoniPasta,24,10,39,49,20,101,121,7,0.319416,0.341273,0.000888,0.000247,0.007003
Saint_Scum,21,12,19,31,35,38,73,7,0.313838,0.334817,0.000302,0.000203,0.013701
Salt-Lingonberry-853,25,14,11,25,41,27,68,7,0.275369,0.289048,0.000256,0.000316,0.011863
Wintores,18,7,6,13,37,22,59,7,0.284897,0.299191,0.00005,0.000197,0.006182
pooter6969,13,14,6,20,33,7,40,7,0.28211,0.295469,0.00079,0.00024,0.00502
spinbutton,19,14,12,26,39,22,61,7,0.279275,0.293431,0.000298,0.000181,0.009102
windershinwishes,20,3,2,5,7,5,12,8,0.240763,0.251186,0.000009,0.000065,0.003009
Ok_Distribution7377,25,9,10,19,26,34,60,7,0.304573,0.32426,0.000111,0.000202,0.00578
Shineyy_8416,18,6,5,11,16,17,33,8,0.272585,0.28513,0.000024,0.000152,0.005609
jman12234,10,7,13,20,12,24,36,7,0.309442,0.329485,0.000161,0.000106,0.00559
OmniBLVK,29,12,21,33,24,51,75,7,0.313447,0.335538,0.000185,0.000222,0.007544
BakaDasai,16,6,5,11,10,10,20,7,0.272143,0.286267,0.000033,0.000117,0.007369
turndownforwomp,11,6,3,9,20,9,29,8,0.223323,0.231419,0.000041,0.00016,0.000176
Opening_Seesaw9816,13,1,10,11,1,31,32,8,0.236897,0.246657,0.00002,0.000048,0.000016
Scenarioing,12,7,4,11,13,10,23,9,0.206126,0.212756,0.000132,0.000201,0.000096
Opposite-Witness1416,21,5,9,14,8,18,26,8,0.256397,0.266103,0.000464,0.000116,0.000073
OrdinaryLeg7199,21,8,15,23,12,30,42,8,0.223676,0.234216,0.000687,0.000233,0.000031
ChampagneDividends,26,7,8,15,49,21,70,7,0.258889,0.271689,0.000066,0.00027,0.001534
PM_ME_YOUR_TATERTITS,10,2,18,20,4,30,34,8,0.270533,0.283572,0.00019,0.000145,0.000013
POUUER,16,11,31,42,31,160,191,7,0.283772,0.303255,0.000551,0.000303,0.001525
Plastic_Kangaroo5720,23,3,3,6,50,28,78,7,0.256848,0.270054,0.000028,0.000241,0.001849
PacinoWig,10,11,60,71,15,258,273,6,0.332526,0.357463,0.001543,0.00016,0.004931
ElReyResident,16,11,8,19,27,10,37,7,0.275369,0.289748,0.000088,0.000164,0.007208
MKing150,21,15,13,28,45,20,65,7,0.278519,0.294492,0.000092,0.000179,0.010687
SocratesWasSmart,10,11,5,16,18,7,25,8,0.269311,0.281944,0.000045,0.000099,0.009415
Pale_Consideration87,16,5,13,18,11,39,50,8,0.266663,0.279415,0.000161,0.000162,0.000181
Pandoratheyawningcat,27,4,9,13,13,22,35,8,0.215318,0.22423,0.000217,0.0003,0.000007
Dismal-Anybody-1951,16,11,11,22,42,19,61,7,0.293234,0.311063,0.000251,0.000176,0.007394
Garfish16,40,10,9,19,90,35,125,7,0.276142,0.290776,0.000302,0.000333,0.006799
Master_Blaster_02,10,5,6,11,20,8,28,7,0.27943,0.296835,0.000064,0.000068,0.007835
Maximum_Error3083,22,9,5,14,42,16,58,8,0.2554,0.267497,0.000087,0.000232,0.008978
Mobile_Trash8946,19,4,3,7,25,14,39,8,0.247866,0.256987,0.000009,0.000155,0.002594
ObjectiveAce,10,4,4,8,24,10,34,7,0.281374,0.296506,0.000016,0.000131,0.005224
Sad_Strawberry_5572,19,12,90,102,17,449,466,6,0.337105,0.365114,0.001404,0.000163,0.00502
TuggenDixon,24,16,8,24,40,19,59,7,0.288987,0.305256,0.000209,0.00027,0.012408
Ventira,10,4,3,7,18,12,30,8,0.224898,0.232908,0.000021,0.000139,0.00574
carsonthecarsinogen,22,9,4,13,42,9,51,7,0.276378,0.290095,0.000139,0.000178,0.005179
hoarduck,26,8,11,19,20,31,51,7,0.298766,0.317857,0.000128,0.000193,0.006597
mushinmind,15,8,4,12,37,18,55,8,0.260932,0.272917,0.00004,0.0002,0.00692
peachfluffed,18,10,10,20,38,23,61,8,0.262125,0.276224,0.000167,0.000211,0.011163
ParakeetLover2024,50,24,74,98,44,240,284,7,0.346811,0.379549,0.003482,0.0004,0.008606
DarkNo7318,17,15,5,20,49,13,62,7,0.272241,0.28492,0.000138,0.00022,0.006848
Fluffy-Mango-6607,21,9,6,15,41,16,57,7,0.269856,0.282956,0.00005,0.000188,0.009981
MaybePrudent3877,11,4,2,6,26,12,38,8,0.227462,0.235777,0.000005,0.000175,0.001597
ferbje,26,4,3,7,57,24,81,8,0.248997,0.258996,0.00004,0.000323,0.001924
whater39,43,12,10,22,95,39,134,7,0.289338,0.307972,0.00061,0.000423,0.011503
Particular-Wish-1761,11,6,35,41,11,56,67,6,0.265055,0.279039,0.001075,0.000183,0.000033
Particular_Flyer,12,4,35,39,6,52,58,6,0.288692,0.303242,0.001598,0.000132,0.000014
Creepy_Push8629,13,5,3,8,35,18,53,9,0.173425,0.176722,0.0003,0.000356,0.000173
HistoricalQuail,12,4,3,7,5,3,8,9,0.198693,0.204479,0.00001,0.000081,0.000094
acegirl1985,11,4,6,10,6,7,13,8,0.217594,0.225688,0.000037,0.000086,0.000125
snper101,10,5,4,9,11,7,18,8,0.24419,0.251703,0.000288,0.000151,0.000241
PerceptionSand,13,9,28,37,12,50,62,7,0.313534,0.33474,0.000325,0.000114,0.006728
Most-Ad4680,11,8,6,14,20,14,34,7,0.282321,0.297519,0.000046,0.000142,0.009498
Perfect-Caramel-3129,13,3,6,9,3,7,10,8,0.243468,0.253808,0.000303,0.000081,0.000349
Petkorazzi,15,4,17,21,10,36,46,7,0.311486,0.330318,0.000173,0.000104,0.002936
PharmPhrenzy,14,4,48,52,6,186,192,7,0.309062,0.33497,0.000248,0.000074,0.002425
Describing_Donkeys,11,12,8,20,19,10,29,7,0.275587,0.294284,0.00006,0.000138,0.012283
FrostyArctic47,15,10,6,16,24,10,34,9,0.225761,0.235998,0.000035,0.000226,0.011167
absolutefunkbucket,21,8,6,14,41,10,51,8,0.249807,0.262826,0.000013,0.000076,0.011921
ides205,23,6,5,11,24,20,44,8,0.245901,0.258911,0.000024,0.000189,0.005371
tlopez14,26,18,17,35,34,23,57,8,0.266208,0.284311,0.000207,0.000231,0.009085
OutSourcingJesus,12,5,1,6,5,1,6,8,0.202567,0.207803,0.000029,0.000085,0.000829
Rombom,36,7,3,10,15,6,21,8,0.215626,0.222087,0.000246,0.000123,0.000872
Pitiful_Mulberry_707,16,6,10,16,7,17,24,7,0.301672,0.321853,0.000182,0.000107,0.003297
PizzaKiller023,25,6,25,31,12,88,100,7,0.314056,0.336008,0.000257,0.000108,0.003592
TrebleTrouble-912,10,3,1,4,4,1,5,8,0.225593,0.233279,0.000001,0.000052,0.000763
PoisonAppleJeep,15,5,8,13,8,14,22,8,0.215502,0.225098,0.000113,0.000261,0.000008
LelandHeron,11,5,3,8,9,5,14,9,0.21228,0.219047,0.000046,0.00013,0.000028
PolarizingRay,14,4,7,11,8,15,23,7,0.294876,0.312774,0.000106,0.000091,0.002621
AevilokE,17,3,2,5,37,18,55,8,0.235322,0.243519,0.000002,0.000236,0.001267
Disastrous-Top2795,11,4,2,6,18,13,31,8,0.233502,0.241803,0.000028,0.000127,0.006555
GamblePuddy,16,7,13,20,42,23,65,7,0.281794,0.296624,0.000225,0.00011,0.011377
Ornithopter1,29,17,15,32,49,28,77,7,0.30089,0.317293,0.00056,0.000273,0.017767
PlaneWar203,12,8,5,13,23,6,29,7,0.290042,0.307111,0.000066,0.000079,0.012803
PresentationLost9811,28,14,25,39,33,68,101,7,0.312841,0.333288,0.00065,0.000235,0.013925
PumpkinBrioche,36,4,3,7,46,7,53,7,0.24093,0.24933,0.000471,0.000156,0.001187
entreacteplaylist,15,6,11,17,14,24,38,6,0.308915,0.326765,0.00006,0.000105,0.004572
kel584,10,5,4,9,9,5,14,7,0.277037,0.290959,0.00001,0.000077,0.004237
lunacysc,18,10,3,13,41,19,60,8,0.267545,0.27944,0.000115,0.000265,0.011692
roskybosky,17,4,7,11,8,7,15,8,0.248083,0.257972,0.000701,0.000151,0.001019
PowerfulComplaint189,10,0,12,12,0,22,22,8,0.230699,0.24039,0,0.000033,0
PowerfulHomework6770,15,6,25,31,8,69,77,7,0.298629,0.315335,0.000162,0.000114,0.000852
AG_GreenZerg,10,6,4,10,22,12,34,7,0.278262,0.295014,0.000055,0.000151,0.005879
ProgrammerHealthy359,14,8,4,12,27,10,37,7,0.253782,0.265624,0.000049,0.000155,0.003203
United_Librarian5491,10,6,6,12,19,10,29,7,0.279482,0.29308,0.00007,0.000137,0.00238
Powerful_Falcon_4006,18,0,15,15,0,33,33,8,0.249614,0.263058,0,0.000033,0
neodiogenes,25,6,4,10,11,4,15,8,0.210475,0.219691,0.000085,0.000078,0.00105
ven_geci,10,4,1,5,8,1,9,8,0.214838,0.222957,0.000012,0.000071,0.00026
Poxus-q,19,8,28,36,19,218,237,7,0.321115,0.345656,0.000549,0.000193,0.004225
Life-Income2986,13,5,5,10,17,12,29,7,0.258564,0.270705,0.00001,0.000112,0.002245
blind-octopus,70,15,13,28,55,44,99,7,0.289319,0.305953,0.000538,0.000369,0.009929
this-aint-Lisp,12,4,2,6,25,13,38,8,0.241457,0.250654,0.000008,0.000145,0.001107
Prestigious-Trust265,11,2,19,21,5,28,33,8,0.249463,0.261489,0.000229,0.0001,0.000032
BigBigBigTree,24,4,5,9,10,12,22,8,0.213421,0.220902,0.000084,0.000186,0.000014
RoyallyOakie,13,4,1,5,5,3,8,9,0.191323,0.197159,0.000004,0.000115,0.000053
PrizeMeans,10,2,64,66,2,107,109,7,0.320751,0.34,0.0014,0.00007,0.000262
Cessna131,12,3,3,6,4,3,7,8,0.233213,0.239308,0.00002,0.000047,0.00041
HamBoneZippy,12,5,2,7,10,6,16,8,0.214299,0.220581,0.000043,0.000143,0.000459
Rolltide43,13,4,6,10,6,15,21,7,0.28513,0.302613,0.000359,0.000113,0.000552
TerrapinTribe,11,5,3,8,14,4,18,8,0.226077,0.232832,0.00003,0.000207,0.0005
WasV3,10,4,3,7,5,5,10,8,0.216958,0.223559,0.000013,0.000076,0.000311
ProbablyNotAThingToo,11,8,18,26,9,25,34,7,0.228876,0.239999,0.00062,0.000213,0.000014
Chance-Idea1090,11,2,2,4,3,2,5,8,0.205976,0.212084,0.000007,0.000062,0.000025
Professional-Scar840,12,2,38,40,3,81,84,6,0.270066,0.285431,0.000266,0.000069,0.000008
ProfessionalMath8873,12,7,14,21,7,26,33,7,0.305148,0.325242,0.000127,0.000088,0.004564
RX3874,10,11,7,18,24,9,33,7,0.303187,0.322919,0.000177,0.000166,0.015215
ProfessorHuge5773,10,4,14,18,8,35,43,8,0.200771,0.210234,0.000173,0.000254,0.000002
thechaoticstorm,11,4,2,6,6,2,8,9,0.176274,0.18096,0.000011,0.000113,0.000021
ProgrammerKey1380,15,4,18,22,7,76,83,7,0.272519,0.286035,0.0004,0.000127,0.000248
Placedapatow,10,5,3,8,16,4,20,8,0.228957,0.236038,0.000083,0.000138,0.000816
alc4pwned,12,6,5,11,21,11,32,7,0.226461,0.233852,0.000109,0.000203,0.000176
bfrancom17,11,3,1,4,20,4,24,8,0.203926,0.208586,0.000002,0.000118,0.00021
Proof_Caregiver_4234,27,13,19,32,30,49,79,7,0.318876,0.338515,0.000552,0.000256,0.006775
Proper-Republic1561,14,9,21,30,13,45,58,7,0.300053,0.318668,0.000176,0.000165,0.006632
Alien_invader44,14,8,7,15,21,11,32,7,0.288233,0.302919,0.000042,0.000155,0.004043
Frooctose,16,4,2,6,26,5,31,8,0.239124,0.248474,0.000005,0.000118,0.001426
PsychLegalMind,21,9,201,210,11,924,935,6,0.33417,0.373581,0.001268,0.000105,0.007692
Budget_Llama_Shoes,23,9,6,15,43,22,65,8,0.2496,0.264097,0.00002,0.000238,0.009949
CerddwrRhyddid,16,11,9,20,23,13,36,7,0.284574,0.30473,0.000202,0.000098,0.015989
Dreadedvegas,11,6,2,8,13,2,15,8,0.245701,0.257155,0.00001,0.000088,0.005023
Emergency_Driver_487,44,6,5,11,91,41,132,8,0.248437,0.26171,0.000022,0.000329,0.005097
FormerOSRS,16,5,4,9,11,7,18,8,0.236058,0.244735,0.000534,0.000179,0.004348
Forte845,58,21,22,43,57,52,109,7,0.314056,0.335104,0.000959,0.000412,0.016667
Gweena,15,4,3,7,41,17,58,8,0.226643,0.237469,0,0.000221,0.003879
Orwells_Roses,23,6,8,14,28,25,53,8,0.257198,0.272204,0.000063,0.000219,0.005649
Reld720,21,9,6,15,26,15,41,7,0.252706,0.268129,0.000013,0.000174,0.012019
SammathNaur1600,12,7,4,11,11,8,19,8,0.240316,0.250662,0.000029,0.000153,0.008164
Sammonov,22,11,11,22,51,23,74,8,0.275957,0.294675,0.000137,0.000208,0.012394
Visco0825,13,10,95,105,12,349,361,7,0.314165,0.344768,0.000661,0.000097,0.01118
baby_budda,11,16,4,20,20,4,24,7,0.258667,0.27303,0.000036,0.000181,0.020732
foulpudding,32,17,5,22,37,23,60,7,0.248505,0.261825,0.000046,0.000308,0.015053
jaywst22,16,5,4,9,35,12,47,7,0.256151,0.271875,0.000006,0.000121,0.007463
popeIeo,19,7,5,12,41,8,49,8,0.240789,0.253618,0.000008,0.000119,0.006806
powerboy20,18,3,1,4,34,11,45,8,0.206051,0.213193,0,0.000181,0.0041
rhombecka,10,7,3,10,14,6,20,8,0.253711,0.267794,0.000003,0.000084,0.012139
thewNYC,11,9,2,11,18,6,24,8,0.245741,0.257196,0.00005,0.000104,0.010696
truthovertribe,23,13,11,24,58,22,80,8,0.254968,0.270799,0.00004,0.000234,0.016983
Psychological_Roof85,11,3,15,18,5,36,41,7,0.310695,0.33106,0.000048,0.000058,0.003013
Pure-Veterinarian979,18,1,17,18,3,30,33,7,0.269247,0.281956,0.000089,0.000077,0.000014
Pure_Chef_8438,11,5,62,67,6,365,371,7,0.287373,0.305448,0.001808,0.000124,0.000025
Born-Bid8892,13,6,4,10,9,5,14,9,0.213723,0.21977,0.000079,0.000235,0.000134
HomeworkMuch2990,10,3,1,4,14,2,16,8,0.18718,0.191403,0.000018,0.000099,0.000096
Inevitable_Bit_9871,10,4,3,7,12,7,19,9,0.202958,0.208381,0.000053,0.000207,0.000132
MyFeetLookLikeHands,10,6,5,11,22,6,28,7,0.259944,0.271081,0.000544,0.000108,0.004601
Ok-Ad-9820,27,4,4,8,53,15,68,8,0.225863,0.233782,0.000137,0.000305,0.000104
ResponsibilityOk8099,13,7,8,15,22,10,32,8,0.226575,0.234217,0.000313,0.00017,0.000184
Shadou_Wolf,10,5,4,9,13,7,20,8,0.240827,0.247668,0.000142,0.000135,0.000193
f0xbunny,16,4,2,6,33,15,48,9,0.214818,0.22058,0.000042,0.000277,0.000156
lionelhutz-,10,2,3,5,19,5,24,7,0.21836,0.224594,0.00003,0.000101,0.000089
wunderduck,11,5,4,9,6,4,10,8,0.210299,0.215906,0.000134,0.000103,0.000174
AntonioVivaldi7,56,14,10,24,120,54,174,7,0.284753,0.299453,0.000256,0.000558,0.008361
Background_Sail9797,15,5,10,15,33,21,54,7,0.261626,0.272587,0.000085,0.000153,0.005814
BailysmmmCreamy,13,5,3,8,20,7,27,8,0.246168,0.256422,0.000014,0.000098,0.006376
BluesPatrol,10,5,5,10,13,8,21,8,0.242543,0.251009,0.000042,0.000076,0.007205
Bore-Geist9391,13,8,7,15,23,12,35,7,0.30081,0.316455,0.000499,0.000194,0.005981
ChemicalRain5513,13,8,9,17,22,10,32,8,0.270566,0.285251,0.000118,0.000125,0.011699
GroundbreakingBag164,10,6,4,10,17,4,21,7,0.267751,0.279271,0.000043,0.000122,0.006627
Infinite_Sea_5425,13,3,2,5,15,7,22,7,0.293139,0.308387,0.000056,0.000116,0.005484
Luchadorgreen,12,5,3,8,28,9,37,8,0.235297,0.243721,0.000024,0.000174,0.007641
ManliestBunny,13,2,1,3,18,3,21,8,0.198214,0.203775,0,0.000094,0.00537
NonbinaryYolo,33,11,7,18,72,25,97,7,0.270954,0.283901,0.000374,0.000246,0.008347
PopTheRedPill,12,5,3,8,17,4,21,7,0.264189,0.275435,0.000061,0.00009,0.007111
Proper_Fun_977,46,12,6,18,67,37,104,7,0.263559,0.274212,0.000155,0.000376,0.006623
Serafim91,16,7,8,15,16,14,30,8,0.255227,0.266491,0.000064,0.000119,0.006024
Sloooooooooww,16,10,13,23,17,23,40,7,0.303817,0.322827,0.000193,0.000166,0.010873
Tetris102,17,4,3,7,36,9,45,8,0.234602,0.241759,0.000006,0.000141,0.005621
Total_Explanation549,20,10,9,19,39,22,61,8,0.258239,0.270657,0.000093,0.000243,0.009992
YodaSimp,11,4,2,6,18,6,24,8,0.244824,0.253652,0.000004,0.000096,0.008412
Zakaru99,10,5,3,8,11,4,15,7,0.249532,0.260154,0.000018,0.00006,0.009124
faultydesign,11,10,3,13,17,3,20,7,0.284164,0.298475,0.000178,0.000068,0.01822
garaile64,38,17,33,50,46,71,117,6,0.322762,0.346037,0.000838,0.000289,0.015124
hunbot19,15,9,8,17,33,16,49,7,0.271165,0.281832,0.000195,0.00018,0.008399
imperfect9119,19,9,7,16,26,12,38,7,0.281217,0.297695,0.000257,0.000166,0.006259
stickemz,13,3,3,6,24,10,34,8,0.230801,0.23949,0.000003,0.000145,0.005411
terragutti,13,9,9,18,27,12,39,7,0.270922,0.284434,0.00035,0.000131,0.008054
username_31,24,7,6,13,54,27,81,7,0.270727,0.283014,0.000089,0.000322,0.007781
RLT2000,32,6,34,40,7,106,113,7,0.291629,0.306608,0.003099,0.000203,0.000128
BonusGlittering3328,14,4,3,7,13,8,21,8,0.236427,0.244079,0.00004,0.000124,0.000136
Kittymemesallday,11,4,3,7,5,3,8,9,0.201459,0.207784,0.000016,0.000091,0.000105
ShipComprehensive543,10,4,3,7,5,4,9,8,0.227382,0.234384,0.00005,0.000056,0.000129
Sufficient_Ad3175,15,5,5,10,40,21,61,8,0.217041,0.22505,0.00005,0.000235,0.00014
remedyman,23,6,6,12,35,21,56,7,0.274485,0.285801,0.000625,0.000209,0.001356
Radiant_Impress9741,14,2,6,8,5,12,17,8,0.207059,0.213817,0.000026,0.000087,0.000002
Hefty-Association-59,13,6,9,15,11,12,23,7,0.265771,0.28416,0.000011,0.000077,0.008403
Ralphy_1997,14,7,28,35,9,51,60,7,0.313773,0.33566,0.000304,0.000118,0.00275
Eclipsed830,10,7,3,10,18,6,24,8,0.247527,0.25757,0.000012,0.000107,0.002029
jweezy2045,18,6,5,11,39,19,58,7,0.292363,0.30905,0.000025,0.000184,0.006545
Rarely99,12,4,8,12,4,12,16,7,0.253215,0.261617,0.000799,0.000125,0.000071
riontach,17,7,4,11,8,4,12,8,0.235714,0.243069,0.000422,0.000168,0.00006
ReadingwithMe,19,9,28,37,12,41,53,7,0.31517,0.33625,0.000307,0.000119,0.004026
LateQuantity8009,15,10,4,14,19,7,26,7,0.249298,0.25844,0.000391,0.000139,0.001693
Suspicious_Town_8680,13,7,12,19,11,19,30,7,0.30085,0.320182,0.000167,0.000095,0.003996
deutschmexican15,16,11,20,31,17,50,67,7,0.316669,0.336324,0.000459,0.000181,0.005565
AnxietyObvious4018,12,11,7,18,22,9,31,8,0.285399,0.299847,0.000084,0.000138,0.009171
OddDisaster8173,19,4,4,8,48,26,74,7,0.265833,0.27808,0.00001,0.000258,0.002889
hallam81,10,16,7,23,19,8,27,8,0.274718,0.292151,0.000102,0.000161,0.013609
RealCar40,11,8,26,34,8,42,50,7,0.269487,0.282517,0.001421,0.000177,0.000046
CountFew6186,30,17,5,22,35,13,48,8,0.246651,0.258033,0.000048,0.000251,0.010485
ReasonableSir2804,35,1,5,6,1,7,8,7,0.229969,0.236947,0.000079,0.000046,0.000016
LolaAucoin,18,6,7,13,35,11,46,7,0.259066,0.269679,0.000454,0.000165,0.000396
RecommendationHot929,55,13,63,76,28,351,379,6,0.331285,0.359741,0.001065,0.000248,0.001465
RichRod91,11,6,4,10,25,9,34,7,0.257593,0.270414,0.000024,0.000123,0.00257
Vexillum211202,14,8,37,45,19,140,159,7,0.31998,0.343742,0.000426,0.000128,0.006315
Wigglebot23,20,3,3,6,21,16,37,7,0.268147,0.280441,0.00001,0.000164,0.001784
clforp,10,4,3,7,20,8,28,8,0.249381,0.259818,0.00001,0.000095,0.001447
JulianPaagman,10,3,2,5,6,4,10,7,0.262429,0.273306,0.00003,0.000051,0.00192
PumpkinSeed776,13,7,3,10,8,3,11,8,0.211182,0.217671,0.00003,0.000082,0.000319
Quiet_Fan_7008,13,11,6,17,29,10,39,8,0.257125,0.267415,0.000202,0.000204,0.003867
BeefWellingtonSpeedo,15,4,4,8,7,6,13,8,0.233888,0.242097,0.000046,0.000123,0.00029
Future_Telephone281,30,7,3,10,65,28,93,7,0.269728,0.280771,0.000402,0.00037,0.001402
benificialart,14,7,3,10,12,6,18,8,0.219311,0.225958,0.000062,0.000111,0.002557
Reibudaps4,10,4,12,16,7,22,29,7,0.307217,0.325593,0.00007,0.000093,0.002803
Genoscythe_,11,14,6,20,20,7,27,7,0.287903,0.305979,0.000232,0.000144,0.005041
RelationshipOne3837,14,2,7,9,7,19,26,8,0.213975,0.220199,0.000053,0.000171,0.000008
beanbubger,18,4,3,7,40,21,61,7,0.251039,0.261933,0.000052,0.000216,0.002131
sereniteenoww,42,10,7,17,88,36,124,7,0.275336,0.289389,0.000037,0.000324,0.010903
Remarkable-Steak3710,31,16,50,66,31,105,136,7,0.312022,0.330762,0.003802,0.00045,0.001683
---why-so-serious---,10,5,3,8,9,5,14,8,0.243155,0.250971,0.000051,0.000102,0.000545
Environmental-Age502,14,12,6,18,20,11,31,8,0.26783,0.2786,0.000735,0.00022,0.001481
StrokyBoi,10,3,2,5,21,11,32,8,0.2533,0.262428,0.000025,0.000111,0.002492
Thistime232,24,11,6,17,18,12,30,8,0.237968,0.246189,0.00034,0.000313,0.000653
megryanreynolds,14,3,4,7,15,9,24,7,0.243809,0.251234,0.00021,0.000138,0.000224
Responsible-Bunch316,54,18,31,49,45,168,213,7,0.310695,0.333211,0.000503,0.000372,0.003899
L3onK1ng,21,8,6,14,39,15,54,8,0.257403,0.270066,0.000019,0.00017,0.003062
Overall-Ratio-1446,29,8,13,21,58,24,82,7,0.275436,0.291783,0.000103,0.000189,0.00243
Robinbod,13,1,4,5,2,6,8,8,0.229491,0.237364,0.000007,0.000055,0.000018
RockWheel480,12,2,7,9,4,12,16,7,0.256819,0.26613,0.000067,0.000099,0.000107
Rubicon_Lily,12,9,20,29,11,38,49,7,0.30101,0.318857,0.000203,0.000126,0.002996
Throwaway7131923,23,8,21,29,11,49,60,7,0.323039,0.346425,0.000561,0.000104,0.008002
knifeyspoony_champ,10,8,6,14,15,12,27,7,0.281952,0.295473,0.000071,0.000143,0.002884
Sad-Tradition8676,20,3,4,7,3,8,11,7,0.209968,0.215252,0.000247,0.000208,0.000001
HamasintheHouse,26,8,6,14,52,21,73,8,0.2873,0.30055,0.000121,0.000236,0.004181
Mr-Steve-O,11,4,1,5,17,1,18,8,0.263697,0.275284,0.000085,0.000058,0.004114
ShoesOfDoom,11,7,3,10,21,6,27,8,0.23813,0.247624,0.000043,0.000122,0.003027
UltimateJDX,10,3,3,6,21,11,32,8,0.221554,0.229183,0.000006,0.000133,0.001392
Saltlakecity126,14,1,36,37,1,46,47,7,0.261293,0.276217,0.000484,0.000143,0
just_mark,14,2,1,3,5,4,9,8,0.195764,0.200166,0.000002,0.000088,0.000037
Samvel_2015,25,8,11,19,29,35,64,7,0.309718,0.327598,0.000885,0.000315,0.003482
revengeappendage,20,10,6,16,33,14,47,8,0.271832,0.28762,0.00005,0.000187,0.004147
Satinel1,12,9,15,24,15,25,40,7,0.305848,0.326756,0.000261,0.000146,0.0053
Scary_Remote,71,1,28,29,1,43,44,7,0.289522,0.305132,0.000301,0.000058,0.000001
smellslikebadussy,14,9,4,13,21,6,27,7,0.265989,0.277255,0.000137,0.000105,0.003727
ScholarPrize1335,12,8,24,32,9,48,57,7,0.295974,0.3128,0.000175,0.00012,0.002024
Secret-Ball7570,18,11,23,34,21,91,112,7,0.302377,0.32106,0.000267,0.000216,0.003746
SeveralAd6447,27,7,24,31,17,53,70,7,0.299023,0.316877,0.000193,0.000154,0.001444
BeginningTooth3864,11,3,2,5,13,11,24,8,0.215934,0.222701,0.000003,0.00014,0.000438
Shadow_dust_180,13,13,85,98,16,402,418,7,0.339073,0.367846,0.001957,0.000171,0.00468
IAmTheNightSoil,13,4,5,9,28,6,34,8,0.245567,0.25521,0.000013,0.000062,0.003879
RennietheAquarian,38,9,10,19,59,27,86,7,0.26456,0.277494,0.00011,0.000225,0.002127
ShandaLear555,19,2,5,7,2,5,7,8,0.200443,0.207798,0.000052,0.00008,0.000001
the_elephant_stan,12,4,3,7,5,4,9,8,0.204377,0.210845,0.000026,0.000186,0.000008
FuggleyBrew,23,6,5,11,49,24,73,8,0.255746,0.268276,0.000019,0.000144,0.004354
PrecisionHat,26,6,6,12,30,30,60,7,0.26214,0.274544,0.000035,0.000247,0.001608
polchiki,10,9,5,14,22,8,30,8,0.245874,0.256074,0.000017,0.000157,0.00204
ShrekOne2024,10,10,32,42,15,72,87,7,0.327856,0.352232,0.000844,0.000156,0.007438
Fluffy_Analysis_8300,11,3,3,6,12,12,24,8,0.263023,0.275683,0.000002,0.000121,0.001524
mikevago,21,10,11,21,41,18,59,7,0.29753,0.316206,0.000121,0.000195,0.006953
Side_of_fry,28,15,45,60,28,319,347,7,0.311036,0.334818,0.000844,0.000307,0.002816
3rdcousin3rdremoved,10,4,2,6,11,8,19,8,0.253939,0.266323,0.000025,0.000096,0.004165
Mundane-Mud2509,14,4,3,7,10,5,15,8,0.242439,0.252291,0.000004,0.000074,0.006129
Signal-Ad3414,10,3,6,9,4,9,13,8,0.237693,0.246266,0.000083,0.000115,0.000022
SignificantMess2546,14,3,20,23,4,34,38,6,0.248083,0.259671,0.000406,0.000104,0.000006
Simple-Camel-20,18,6,39,45,8,75,83,7,0.284807,0.300238,0.001695,0.000173,0.00001
nope-nope-nope-nop,43,11,9,20,43,30,73,8,0.270388,0.286228,0.000242,0.000251,0.004709
abrandis,11,4,1,5,9,2,11,8,0.238657,0.246963,0.000004,0.000061,0.000749
poser765,12,9,7,16,17,10,27,7,0.27594,0.287605,0.000396,0.000153,0.001664
tornado9015,26,5,3,8,54,24,78,8,0.231343,0.238966,0.000058,0.000314,0.000445
Sky_Sumisu,12,6,14,20,15,45,60,7,0.308473,0.328013,0.000155,0.000152,0.003311
SleeplessYellowSun,15,6,14,20,7,20,27,8,0.232173,0.242173,0.000387,0.000197,0.000015
SlideStreet6874,54,10,67,77,22,127,149,7,0.301451,0.322334,0.002237,0.000315,0.000184
Bilbo_Baghands,16,6,5,11,20,17,37,8,0.224386,0.232541,0.000053,0.000353,0.000515
QuerulousPanda,11,7,4,11,9,6,15,8,0.240278,0.248285,0.000065,0.000129,0.000532
dam_sharks_mother,15,6,5,11,10,10,20,8,0.242452,0.25173,0.000174,0.000143,0.001387
nougat98,20,8,8,16,22,25,47,7,0.279637,0.291743,0.00053,0.000266,0.001529
wordwordnumberss,10,4,4,8,9,8,17,8,0.245381,0.254979,0.000071,0.000118,0.000325
SlothSleepingSoundly,27,7,42,49,11,97,108,7,0.303797,0.32169,0.00144,0.000185,0.000351
InevitableRhubarb232,49,2,1,3,13,9,22,9,0.186979,0.19101,0.000004,0.000186,0.000166
ThisNameDoesntCount,23,9,43,52,9,57,66,7,0.281742,0.298902,0.001469,0.000147,0.001362
gudematcha,15,3,4,7,24,5,29,8,0.237655,0.245733,0.000052,0.000109,0.000183
Grumpy_Trucker_85,13,7,4,11,23,11,34,7,0.275822,0.290275,0.000028,0.000143,0.0086
SnooMemesjellies243,14,7,49,56,7,117,124,7,0.32173,0.341343,0.000725,0.000096,0.000996
BlackJackfruitCup,24,2,3,5,22,12,34,8,0.245901,0.254345,0.000006,0.000145,0.000544
bwmat,24,9,6,15,48,16,64,7,0.267751,0.278921,0.000041,0.000171,0.00472
cell689,18,6,4,10,39,17,56,8,0.254524,0.26591,0.000157,0.000189,0.005383
Snoo_47323,26,10,42,52,12,86,98,7,0.324427,0.348972,0.000597,0.000127,0.004185
Snoopdigglet,59,18,27,45,37,82,119,7,0.326673,0.349818,0.001261,0.000304,0.010592
SoCalGiraffe,10,1,18,19,1,44,45,8,0.229061,0.240051,0.000235,0.000061,0
Solarmandude,18,5,35,40,6,70,76,7,0.275973,0.293213,0.000602,0.00013,0.000109
diarrhea_planet,23,5,7,12,18,21,39,8,0.262475,0.272881,0.000192,0.000209,0.000302
Sorry_Necessary_1385,25,3,4,7,7,15,22,8,0.212989,0.21892,0.000474,0.000221,0.000014
Turbulent-Tomato,13,4,5,9,13,12,25,7,0.213925,0.220144,0.000757,0.000221,0.000065
SouthernCheek2393,10,3,29,32,4,49,53,7,0.270082,0.283604,0.000984,0.000142,0.000023
InTheWakeOfStardustx,14,4,4,8,10,8,18,7,0.216585,0.223227,0.000107,0.000179,0.000076
lllollllllllll,11,4,5,9,11,7,18,8,0.23982,0.24837,0.000037,0.000097,0.000129
SpamEatingChikn,71,21,48,69,46,116,162,6,0.325687,0.35096,0.001163,0.000313,0.0097
SpecialDig8881,19,11,13,24,23,32,55,7,0.306905,0.326461,0.000189,0.000183,0.008859
SpyderJack,24,4,36,40,5,102,107,7,0.312539,0.330066,0.000866,0.000115,0.000082
Supersnow845,10,11,5,16,30,6,36,8,0.235603,0.24326,0.00031,0.000269,0.001171
mason3991,24,14,18,32,29,40,69,7,0.324729,0.348044,0.000446,0.000244,0.010928
SugarGlitterkiss,13,4,3,7,28,12,40,7,0.273656,0.284955,0.000028,0.000165,0.004552
iwatchcredits,18,10,20,30,18,53,71,7,0.31583,0.335393,0.000468,0.000132,0.004705
redditratman,16,9,5,14,39,11,50,7,0.254338,0.266331,0.000025,0.000159,0.008457
Still_Yam9108,14,12,16,28,21,48,69,7,0.316868,0.335323,0.000395,0.000192,0.006538
Straight_Budget_2216,17,6,17,23,13,54,67,8,0.258608,0.269047,0.001374,0.000257,0.00013
Ohtherewearethen,13,4,3,7,4,4,8,8,0.213079,0.219901,0.000021,0.00012,0.000026
TemptingPenguin369,18,9,3,12,12,4,16,8,0.239845,0.248638,0.000379,0.000193,0.000139
981_runner,34,7,5,12,63,21,84,8,0.25771,0.269102,0.00018,0.000226,0.007358
MamaDee1959,14,2,2,4,14,4,18,9,0.169176,0.173761,0.000003,0.000113,0.000037
Mayor__Defacto,10,3,2,5,19,4,23,8,0.218708,0.22543,0.000014,0.000177,0.00015
ProfessionalDot8419,17,2,1,3,13,4,17,9,0.179929,0.184091,0,0.000109,0.000038
Tall-Payment-8015,21,7,5,12,36,11,47,8,0.245195,0.253162,0.000635,0.000203,0.000298
peepmet,23,14,33,47,20,62,82,7,0.302276,0.320632,0.000636,0.000214,0.003498
Successful_Guide5845,19,11,19,30,21,38,59,7,0.310376,0.328042,0.000535,0.000181,0.004482
misersoze,10,5,2,7,17,5,22,7,0.267577,0.280428,0.000022,0.000124,0.004202
Sudden-Whole8613,13,2,14,16,5,41,46,8,0.260362,0.270956,0.000136,0.000115,0.000042
Someth1ngOther,28,11,8,19,24,19,43,7,0.287683,0.301239,0.001193,0.000339,0.003455
Sudden_Water1604,10,6,13,19,6,26,32,8,0.253371,0.26385,0.000746,0.000214,0.000026
Sufficient_Twist_688,13,3,14,17,6,95,101,8,0.244414,0.253889,0.000472,0.000118,0.000077
Epsilon_and_Delta,10,4,1,5,10,2,12,9,0.196418,0.200887,0.00001,0.000056,0.000055
GaryOldManBalls,11,2,2,4,24,13,37,8,0.232865,0.239047,0,0.000148,0.000082
Suitable-Captain-640,14,2,6,8,3,31,34,7,0.231686,0.240755,0.000447,0.000119,0
More_Mind6869,20,8,7,15,10,14,24,9,0.220143,0.228805,0.000284,0.00019,0.000196
minahkyu,10,2,2,4,18,9,27,8,0.18812,0.192865,0,0.000313,0.000022
smallerthantears,16,4,2,6,28,11,39,8,0.18812,0.192865,0.000446,0.000361,0.000068
Suspicious_State_318,124,41,64,105,135,201,336,7,0.332452,0.35895,0.003713,0.001219,0.013609
anondaddio,30,4,4,8,11,11,22,7,0.266036,0.279016,0.000053,0.000103,0.003786
Swimming-Bowler-6614,12,4,8,12,8,22,30,8,0.1997,0.207837,0.000441,0.000249,0.000002
Grand_Fun6113,39,11,10,21,76,33,109,7,0.290544,0.306561,0.000124,0.000282,0.006928
Super_Eagle1198,10,5,6,11,10,8,18,7,0.287063,0.302762,0.000029,0.000077,0.004788
cynedyr,10,4,2,6,18,7,25,7,0.244903,0.254656,0.000003,0.000073,0.003655
TAtoolate,65,17,44,61,48,192,240,7,0.270469,0.286441,0.003983,0.000616,0.00018
d3t0x1ct0x1c1ty,10,4,8,12,36,13,49,8,0.244652,0.254446,0.000061,0.000165,0.000078
TackoftheEndless,15,3,6,9,6,13,19,7,0.297081,0.314936,0.000029,0.000062,0.002889
Tausendberg,32,7,12,19,10,26,36,8,0.248587,0.257697,0.000306,0.000282,0.000113
BattlefieldVet666,13,8,10,18,13,16,29,8,0.257974,0.267869,0.000382,0.000251,0.000179
Technical-Amount-278,13,3,12,15,3,33,36,8,0.254696,0.266056,0.000098,0.000068,0.000031
Technical-Mortgage85,29,7,25,32,11,39,50,6,0.311614,0.332505,0.000317,0.000122,0.004142
Kurama1917,11,4,3,7,14,14,28,8,0.237344,0.246074,0.000005,0.000136,0.002829
1-objective-opinion,15,5,4,9,36,18,54,7,0.261098,0.272961,0.00001,0.000145,0.004096
Accomplished_Tour481,25,11,8,19,31,9,40,8,0.256921,0.269749,0.000069,0.000126,0.013085
BealOrNoBeal,12,7,3,10,18,13,31,7,0.239833,0.248048,0.000018,0.000134,0.009032
Fredouille77,12,8,10,18,17,14,31,7,0.265724,0.279069,0.000223,0.000082,0.009592
GodkingAustin,14,6,5,11,24,15,39,7,0.280781,0.297689,0.000055,0.000204,0.008481
Important_Suspect681,10,3,3,6,21,5,26,8,0.24183,0.251786,0.000006,0.000086,0.003488
Riptiidex,12,5,3,8,27,4,31,8,0.241457,0.250976,0.000005,0.000115,0.004046
perpetualjive,17,4,2,6,21,17,38,8,0.241392,0.250691,0.000002,0.000193,0.004279
ThatPatelGuy,15,9,27,36,16,99,115,7,0.316492,0.338423,0.000383,0.000155,0.004381
VisibleLoan7460,11,10,11,21,17,30,47,6,0.310823,0.328428,0.000244,0.000132,0.006182
ecopandalover,10,3,3,6,21,12,33,7,0.256994,0.267943,0.000003,0.000119,0.000788
Due_Masterpiece_3601,10,4,1,5,16,1,17,9,0.231698,0.237774,0.000009,0.000069,0.005647
prosthetic_memory,11,12,7,19,25,7,32,8,0.264714,0.274228,0.000783,0.00015,0.005909
The-zKR0N0S,29,11,38,49,19,160,179,7,0.314601,0.338232,0.000414,0.000217,0.004166
ArtOfBBQ,10,9,5,14,25,11,36,7,0.27702,0.290136,0.000114,0.000135,0.006485
OmniTalentedArtist,27,7,7,14,45,17,62,7,0.290246,0.30753,0.00006,0.000143,0.007023
Waterwoo,26,9,15,24,24,24,48,8,0.259244,0.275451,0.000063,0.000119,0.005032
TheAverage_American,27,8,21,29,25,78,103,7,0.314099,0.333262,0.000394,0.000204,0.003736
Practical-Big7550,11,8,5,13,23,6,29,8,0.249683,0.258701,0.000022,0.000105,0.00352
TheBreakUp2013,22,1,5,6,2,9,11,7,0.23396,0.241168,0.000089,0.000059,0.000004
hastings1033,11,3,1,4,9,2,11,9,0.171859,0.1747,0.000019,0.000174,0.000039
Hemingwavy,11,5,4,9,21,14,35,8,0.264159,0.279476,0.000086,0.00013,0.005763
RedHead-Eng25,10,6,3,9,15,5,20,7,0.27599,0.289517,0.000031,0.000105,0.005497
fps916,14,3,2,5,30,15,45,8,0.262581,0.278055,0.000019,0.00016,0.004243
wingsnut25,11,9,5,14,25,11,36,7,0.266193,0.281287,0.000034,0.000122,0.009486
TheMagnuson,25,4,6,10,16,28,44,8,0.254939,0.26458,0.000589,0.000249,0.000034
Ok-Simple5493,15,1,1,2,3,2,5,9,0.203158,0.207841,0,0.000056,0.000033
aaeme,17,4,3,7,27,18,45,8,0.225897,0.233059,0.000166,0.000222,0.001309
TheMenio,11,1,2,3,2,4,6,9,0.194236,0.198978,0.000004,0.000066,0.000022
Kaisha001,12,6,3,9,14,6,20,7,0.264328,0.277191,0.000015,0.000105,0.007243
Ouitya,11,6,7,13,23,11,34,7,0.268736,0.281655,0.000044,0.000173,0.002676
TheSpaceCoresDad,30,9,21,30,24,47,71,7,0.296653,0.313491,0.000268,0.000315,0.002411
TheStrovik,12,7,39,46,7,85,92,7,0.322303,0.345873,0.000349,0.000089,0.003859
TheUnaturalTree,114,30,260,290,72,1528,1600,6,0.375383,0.423029,0.007802,0.000469,0.006272
BarnabyJones2024,11,9,5,14,26,5,31,8,0.242465,0.252072,0.000058,0.000129,0.00455
Electronic_Fly1592,23,3,1,4,26,22,48,7,0.272946,0.288811,0.000011,0.000044,0.007825
HendriXP88,19,5,5,10,43,18,61,7,0.270647,0.283197,0.000014,0.000181,0.004502
IronAgePrude,12,3,2,5,23,8,31,8,0.222785,0.23036,0.000003,0.000131,0.003698
Joyride0012,12,4,5,9,18,6,24,7,0.269391,0.282707,0.000015,0.000068,0.005259
NathanialRominoDrake,13,9,11,20,38,21,59,8,0.260482,0.273847,0.000066,0.000162,0.004367
WhiteGold_Welder,17,6,4,10,28,11,39,7,0.271604,0.284698,0.000017,0.000122,0.010844
defixiones,40,4,6,10,5,6,11,8,0.27557,0.287837,0.00007,0.000058,0.003784
schartlord,14,8,7,15,29,17,46,8,0.267941,0.281101,0.000065,0.000167,0.005979
schnuffs,12,8,3,11,28,11,39,8,0.255645,0.265704,0.000015,0.000195,0.010669
sergeantSadface,17,7,6,13,32,12,44,7,0.284986,0.30221,0.000056,0.000127,0.005093
ObiWanChronobi,16,9,5,14,25,17,42,7,0.257945,0.27258,0.000039,0.000228,0.005192
SpicyButterBoy,22,6,5,11,16,14,30,8,0.237319,0.249478,0.000011,0.000158,0.002218
gburgwardt,26,7,6,13,20,9,29,8,0.249353,0.261953,0.00003,0.000129,0.005567
The_Naked_Buddhist,12,5,10,15,9,16,25,7,0.314536,0.332683,0.000351,0.000109,0.006911
The_Petrichor_,13,5,9,14,15,22,37,7,0.2847,0.299079,0.000116,0.000227,0.000712
Thin_Match_602,23,3,5,8,21,27,48,7,0.275973,0.288291,0.00001,0.000167,0.001046
Throawayhaibhai,12,10,96,106,12,363,375,6,0.349865,0.380625,0.001927,0.000126,0.005695
AlkatrazzPrime,25,5,4,9,19,18,37,7,0.247568,0.257664,0.000245,0.000237,0.002255
PM_ME_A_PM_PLEASE_PM,17,6,5,11,26,10,36,7,0.254997,0.266917,0.000019,0.000119,0.002425
UNisopod,15,5,5,10,15,8,23,7,0.277819,0.29248,0.000101,0.000087,0.001748
Mkwdr,21,11,6,17,17,11,28,8,0.27211,0.285695,0.000085,0.000182,0.002449
Wd91,13,6,4,10,11,4,15,8,0.239199,0.247755,0.000116,0.000077,0.000909
Throwra3630,64,6,14,20,48,126,174,8,0.215267,0.224954,0.000401,0.000457,0.000006
Amarules,12,2,2,4,14,12,26,9,0.181727,0.187732,0.000002,0.000092,0.000003
That-Establishment24,19,4,3,7,40,20,60,8,0.193721,0.199574,0.000016,0.000306,0.000005
iilinga,20,4,4,8,29,25,54,8,0.203158,0.20972,0.000022,0.000164,0.000023
AgitatorsAnonymous,14,8,9,17,12,11,23,7,0.261505,0.276302,0.000074,0.000104,0.006818
BobQuixote,10,5,4,9,23,11,34,8,0.238532,0.251322,0.000004,0.000105,0.008672
Fracture-Point-,18,7,8,15,16,12,28,8,0.235029,0.247172,0.000008,0.000171,0.006132
InFearn0,10,8,6,14,11,10,21,8,0.240648,0.253923,0.000008,0.000104,0.009448
MisterMysterios,12,7,5,12,11,8,19,8,0.255126,0.268214,0.000044,0.000086,0.009359
Padonogan,11,5,4,9,33,15,48,8,0.238005,0.250114,0.000002,0.000126,0.005228
SafeThrowaway691,11,5,7,12,5,7,12,8,0.250028,0.263064,0.000024,0.00006,0.009548
Ssshizzzzziit,13,6,5,11,10,6,16,8,0.247676,0.260089,0.000016,0.000082,0.006672
Sufficient_Steak_839,11,7,4,11,14,4,18,8,0.233827,0.24526,0.000019,0.000094,0.005455
The-Insolent-Sage,16,9,10,19,25,14,39,8,0.254124,0.267064,0.000044,0.000141,0.006135
_NoPants,23,10,6,16,38,17,55,8,0.246315,0.259363,0.000042,0.000262,0.009774
cptjeff,10,6,4,10,8,5,13,8,0.254295,0.269962,0.000019,0.000071,0.009488
escapefromelba,13,9,5,14,18,7,25,8,0.244586,0.255479,0.000015,0.000146,0.008198
jarchack,15,15,7,22,31,9,40,8,0.253555,0.268798,0.00006,0.000193,0.01268
josh34583,12,9,7,16,29,13,42,8,0.232734,0.243731,0.000039,0.000215,0.00749
kenlubin,14,7,11,18,16,20,36,8,0.262475,0.277435,0.000053,0.000132,0.006186
norealpersoninvolved,13,12,8,20,17,8,25,8,0.240482,0.254773,0.000072,0.000197,0.00928
other_virginia_guy,13,4,2,6,13,14,27,8,0.241212,0.252056,0.000004,0.000115,0.004594
preselectlee,10,4,2,6,17,2,19,8,0.225897,0.237199,0.000006,0.000065,0.004654
shamrock01,10,8,2,10,9,4,13,8,0.23681,0.24744,0.000003,0.000089,0.006766
TimmyTurnersShake,10,0,4,4,0,4,4,8,0.216332,0.222595,0,0.000033,0
Sparrowphone,15,5,4,9,24,15,39,8,0.251262,0.262329,0.000025,0.000215,0.003028
TipeyToh,31,11,51,62,18,95,113,7,0.297315,0.317845,0.001792,0.000307,0.000351
BamaBlcksnek,12,4,6,10,15,8,23,8,0.251709,0.261331,0.000049,0.000135,0.000238
ToasterII,23,11,21,32,23,36,59,6,0.327595,0.348436,0.000586,0.000168,0.008581
TomatilloSmart1372,33,8,15,23,32,45,77,7,0.302619,0.323225,0.0003,0.000301,0.003724
Torachan881993,15,2,14,16,5,20,25,8,0.226961,0.237172,0.000078,0.000084,0.000006
Total_Escape_9778,19,10,47,57,16,114,130,7,0.335357,0.358926,0.001158,0.000164,0.006046
TradeU4Whopper,15,3,9,12,8,19,27,8,0.264745,0.27623,0.000362,0.000206,0.000085
Traditional_Fish_504,20,7,38,45,10,144,154,6,0.321434,0.343608,0.000597,0.00013,0.004129
TravisNotScott,12,3,5,8,6,11,17,7,0.267135,0.279934,0.000009,0.000103,0.000559
Tried6TimesYT,31,13,22,35,29,64,93,7,0.316072,0.338557,0.000355,0.000281,0.005669
TristonK,16,13,109,122,15,378,393,6,0.348519,0.37987,0.001824,0.000186,0.003025
Ok-Pea1916,19,13,3,16,39,6,45,7,0.254096,0.263574,0.000072,0.00018,0.005532
YNABDisciple,20,9,5,14,16,7,23,8,0.284664,0.298569,0.000683,0.000256,0.007303
jedisushi72,10,5,5,10,26,15,41,7,0.292874,0.312375,0.000055,0.000143,0.008472
razamatazzz,43,16,38,54,39,104,143,6,0.334911,0.360271,0.001245,0.000355,0.006399
soozerain,131,68,324,392,147,1551,1698,6,0.39527,0.444554,0.026265,0.001183,0.021909
sxaez,24,5,4,9,50,26,76,7,0.283541,0.298789,0.000035,0.000281,0.005923
Trouble843,15,2,5,7,4,55,59,8,0.207619,0.213146,0.000427,0.000111,0
Egelac,17,3,2,5,29,8,37,9,0.171937,0.17503,0.000026,0.000205,0.000001
True_Campaign_8504,97,3,44,47,5,74,79,7,0.277614,0.294624,0.000393,0.000109,0.000009
Due-Cup1115,11,5,3,8,7,4,11,8,0.222884,0.231436,0.00008,0.000115,0.00009
Unable-Concept-6272,45,6,29,35,19,79,98,7,0.27962,0.295623,0.000454,0.000252,0.000082
UnableToParallelPark,10,8,16,24,13,32,45,7,0.306241,0.325968,0.000213,0.000124,0.005408
Unique-Horror-9244,15,6,10,16,7,13,20,7,0.274985,0.28621,0.00033,0.000131,0.000335
Unusual-Context-5231,20,7,14,21,14,33,47,7,0.309612,0.329424,0.000114,0.000122,0.004709
Unusual_Custard4195,20,3,6,9,3,12,15,8,0.223765,0.234975,0.000052,0.000092,0.000054
GrizznessOnly,11,11,6,17,30,13,43,7,0.257154,0.268154,0.000094,0.00018,0.010449
Zobi101,11,11,38,49,15,110,125,7,0.324683,0.344559,0.000987,0.000168,0.006046
chunkyvomitsoup,27,8,6,14,57,23,80,7,0.266114,0.28049,0.000145,0.000294,0.003986
melph49,22,7,8,15,43,21,64,7,0.290899,0.305631,0.000127,0.000181,0.004357
VacheL99,10,2,26,28,3,42,45,7,0.291704,0.307541,0.000304,0.00008,0.000203
Nick0Taylor0,14,4,5,9,9,12,21,8,0.221771,0.228662,0.00004,0.000221,0.000147
VictorianAuthor,27,7,7,14,19,27,46,7,0.30085,0.318163,0.000072,0.000171,0.004018
Cranyx,14,6,4,10,30,14,44,8,0.267072,0.285403,0.000003,0.000137,0.011391
CreamofTazz,33,9,10,19,43,31,74,7,0.278485,0.297282,0.000061,0.00023,0.00975
FredUpWithIt,13,4,3,7,30,12,42,8,0.263851,0.279882,0.000008,0.000154,0.005703
ZeBigD23,11,13,7,20,15,7,22,8,0.245954,0.257916,0.000145,0.000216,0.008209
VirtualExercise2958,14,6,18,24,11,32,43,7,0.3062,0.326239,0.000163,0.000125,0.004846
jaminfine,22,10,23,33,14,61,75,7,0.312625,0.332936,0.000805,0.000168,0.004462
VirtualJackfruit8765,14,2,17,19,5,38,43,7,0.278262,0.290721,0.000229,0.000101,0.000004
GrilledStuffedDragon,13,2,2,4,7,5,12,8,0.234287,0.241263,0.000057,0.000081,0.00006
AdmiralSaturyn,65,34,24,58,80,51,131,7,0.285489,0.306984,0.000667,0.000566,0.019077
DefaultProphet,10,5,2,7,9,5,14,8,0.210602,0.2184,0.000003,0.000132,0.002511
judge_mercer,16,9,4,13,27,10,37,8,0.240904,0.254528,0.000017,0.000147,0.010397
najumobi,15,8,192,200,8,760,768,6,0.33844,0.376731,0.000921,0.00009,0.006
nyckidd,11,10,4,14,18,6,24,8,0.246021,0.256319,0.000042,0.000142,0.004996
Vivid-Ad3831,19,5,6,11,14,21,35,8,0.268736,0.282218,0.00003,0.000146,0.001141
Warm_Anxiety_7379,15,15,118,133,16,994,1010,6,0.340245,0.37445,0.00322,0.000208,0.001322
Easy_Masterpiece_605,17,8,3,11,35,8,43,8,0.234761,0.243282,0.000053,0.000201,0.002925
Hazeygazey,10,2,3,5,6,4,10,7,0.255789,0.268837,0.000065,0.000064,0.0013
IsNotACleverMan,13,4,5,9,24,13,37,8,0.256877,0.268589,0.000024,0.000114,0.002076
Large-Flamingo-5128,11,4,4,8,25,11,36,8,0.238645,0.248923,0.000007,0.000115,0.001685
TheGhostofJoeGibbs,11,5,3,8,26,11,37,8,0.226246,0.23494,0.000009,0.000185,0.001589
Vredddff,17,6,4,10,38,16,54,8,0.255529,0.267048,0.000024,0.000169,0.009182
dontreallyknoww2341,12,6,20,26,6,39,45,7,0.28919,0.305679,0.000148,0.000076,0.002297
iMac_Hunt,22,8,25,33,27,55,82,7,0.314187,0.331798,0.000273,0.000189,0.003962
michaelcanav,10,5,2,7,23,7,30,7,0.259393,0.272068,0.000037,0.000123,0.002602
outestiers,22,8,8,16,45,18,63,7,0.272094,0.287136,0.000117,0.000166,0.00238
redditClowning4Life,17,7,3,10,16,10,26,8,0.236119,0.245998,0.000027,0.000164,0.002601
3slimesinatrenchcoat,16,13,8,21,42,16,58,7,0.277257,0.291423,0.000137,0.000199,0.010189
needless_booty,14,6,5,11,34,15,49,8,0.264483,0.277274,0.000023,0.00019,0.002905
Watchfella,37,13,29,42,34,162,196,6,0.320705,0.342699,0.000625,0.000262,0.006208
Blood_Casino,10,9,11,20,16,14,30,8,0.270501,0.288621,0.000081,0.000119,0.007595
Marston_vc,12,8,5,13,20,10,30,7,0.263805,0.278948,0.000021,0.000144,0.00568
ThatsARatHat,10,5,5,10,14,8,22,8,0.265288,0.281474,0.000008,0.00014,0.005678
yangstyle,14,8,6,14,20,13,33,8,0.264066,0.280737,0.000089,0.000214,0.00619
WeekendFantastic2941,14,1,7,8,1,17,18,8,0.248164,0.259732,0.00004,0.000053,0.00001
WhereztheBleepnLight,16,5,19,24,10,36,46,7,0.321548,0.342747,0.000152,0.000098,0.005984
Winfred_Chesternut,18,6,24,30,9,78,87,7,0.304143,0.321676,0.000268,0.000113,0.000685
WonderWallaby28,62,39,76,115,75,217,292,6,0.34591,0.375499,0.00445,0.000626,0.012182
Wonderful-Food1274,28,17,37,54,33,284,317,6,0.331673,0.356491,0.001825,0.00029,0.010747
kidcudi115,12,4,3,7,17,13,30,8,0.250678,0.261716,0.000015,0.000111,0.002068
Wonderful-Island7224,34,7,28,35,25,81,106,7,0.279896,0.29522,0.000818,0.000342,0.000158
WonderfulMemory3697,22,9,35,44,16,77,93,7,0.284771,0.304878,0.000303,0.000181,0.00212
Wooden_Guest_6911,14,13,184,197,14,1441,1455,6,0.362494,0.399091,0.004469,0.000162,0.004332
Affectionate-Oil3019,25,3,2,5,49,19,68,7,0.22984,0.236108,0.000001,0.000203,0.002268
Anxious_Light_1808,11,4,2,6,25,10,35,8,0.236292,0.244567,0.000006,0.000116,0.003846
Caraxus,16,10,12,22,38,18,56,7,0.292344,0.308814,0.000163,0.000136,0.006926
Elegant-Ad2748,21,12,17,29,54,30,84,7,0.303695,0.322625,0.000627,0.000238,0.007702
Golden_Femekian,77,19,17,36,168,71,239,8,0.273375,0.286743,0.000825,0.000621,0.004673
Pontifex_Maximus__,13,5,2,7,26,3,29,8,0.233237,0.241368,0.000008,0.000109,0.002616
PunishedDemiurge,10,8,7,15,17,8,25,7,0.271914,0.285626,0.000105,0.000118,0.004912
RandHomman,13,6,5,11,32,16,48,7,0.246745,0.256139,0.00002,0.000173,0.002699
The_FriendliestGiant,12,15,7,22,28,12,40,7,0.282286,0.296822,0.000188,0.00016,0.013
TiaLiaH,12,5,4,9,27,8,35,7,0.261716,0.271314,0.000034,0.000103,0.006971
angellareddit,11,8,9,17,33,13,46,7,0.254939,0.266209,0.000091,0.000132,0.003138
catch-ma-drift,36,12,12,24,76,35,111,7,0.28099,0.296153,0.000215,0.000261,0.00349
demonic_sensation,13,5,12,17,47,15,62,7,0.279413,0.294475,0.000031,0.000077,0.002396
mars1200,16,9,8,17,39,18,57,8,0.275487,0.288711,0.000113,0.000166,0.01106
merciiofpatience,10,4,3,7,11,6,17,8,0.239528,0.249281,0.000004,0.000055,0.002972
silence-calm,51,13,10,23,110,49,159,7,0.273325,0.284926,0.000375,0.00042,0.008895
velvetalocasia,20,3,2,5,40,20,60,9,0.220454,0.227245,0.000002,0.000188,0.002255
Wooden_Nature_8735,32,9,15,24,23,34,57,7,0.30445,0.324737,0.000127,0.000211,0.005213
Worried_Eye_1457,12,2,9,11,2,14,16,8,0.207068,0.214583,0.000067,0.000066,0.000002
Xiphactinus14,14,10,46,56,16,95,111,7,0.320592,0.341921,0.00127,0.000186,0.001332
Saltwater_Thief,13,4,3,7,16,13,29,8,0.244217,0.252677,0.000014,0.000181,0.00355
___Cyanide___,31,13,16,29,34,55,89,7,0.302741,0.322137,0.000237,0.00035,0.004998
YugiohXYZ,15,10,96,106,18,417,435,6,0.345172,0.375546,0.001436,0.00018,0.004372
Funksloyd,10,2,3,5,20,12,32,7,0.260647,0.272785,0.000039,0.000107,0.00166
Rassendyll207,10,3,5,8,21,8,29,7,0.274651,0.287742,0.000003,0.000061,0.002384
ZLCZMartello,15,10,18,28,18,46,64,7,0.312819,0.333006,0.000332,0.00016,0.006347
ZOLforALL,12,6,9,15,9,20,29,7,0.314492,0.33211,0.00016,0.000134,0.003872
ZacherDaCracker2,11,9,15,24,12,21,33,7,0.315962,0.334802,0.000257,0.000132,0.002046
Zealousideal_Bee_639,16,7,16,23,12,27,39,6,0.322257,0.340027,0.0005,0.000124,0.003813
Zeppelinman,49,6,20,26,10,64,74,7,0.27658,0.291109,0.000524,0.000128,0.000795
GreenBeardTheCanuck,12,3,3,6,20,4,24,8,0.231355,0.239406,0.000006,0.000109,0.000271
ZestycloseMall3398,16,3,5,8,6,10,16,8,0.266083,0.277745,0.000011,0.000077,0.000154
_END_OF_MESSAGE_,13,4,13,17,5,33,38,7,0.288784,0.302786,0.000252,0.000096,0.000186
_Serial_Lain_,11,2,11,13,2,17,19,8,0.25241,0.263143,0.000055,0.000055,0.000068
_SilentGhost_10237,31,12,200,212,25,880,905,7,0.329047,0.369477,0.001875,0.000189,0.008013
Affectionate_Top340,13,7,5,12,22,8,30,8,0.251527,0.267,0.00002,0.000079,0.00505
Dmagnum,13,7,3,10,22,5,27,8,0.238846,0.2505,0.000007,0.000107,0.007792
Evil_B2,23,7,5,12,22,19,41,7,0.255905,0.271313,0.000049,0.000157,0.007963
NonsensePlanet,10,8,3,11,14,6,20,9,0.223853,0.230828,0.000029,0.000112,0.008964
Slicelker,18,11,6,17,25,17,42,8,0.244851,0.258031,0.000137,0.000191,0.008547
THExLASTxDON,12,5,3,8,16,6,22,8,0.237394,0.249211,0.000005,0.000096,0.005285
Zestyclose-Cat-1093,26,6,10,16,38,28,66,7,0.282603,0.300869,0.000224,0.000204,0.004079
firewatch959,20,5,8,13,48,24,72,8,0.27547,0.293906,0.00005,0.000178,0.004698
vhu9644,27,3,2,5,27,25,52,7,0.249793,0.260094,0.000025,0.000202,0.004061
xtra819,18,4,7,11,33,15,48,8,0.261173,0.276285,0.000008,0.000076,0.003967
___wint,11,4,19,23,5,33,38,7,0.314711,0.335974,0.000108,0.000067,0.00286
eazy_eesh,20,5,6,11,9,13,22,7,0.286337,0.29973,0.000018,0.000092,0.002686
_pickle_me_this_,23,2,6,8,4,10,14,8,0.242933,0.251883,0.000061,0.000087,0.000199
Mulliganasty,10,4,3,7,15,8,23,8,0.224686,0.232433,0.000049,0.000142,0.000217
a1ham,11,2,8,10,8,32,40,8,0.260512,0.271533,0.000095,0.000128,0.000075
a_dlta,12,0,5,5,0,5,5,8,0.222255,0.229622,0,0.000033,0
abstract_claims,26,11,80,91,18,240,258,6,0.345646,0.371844,0.001831,0.000184,0.004181
ace_probably,37,9,26,35,30,82,112,7,0.32826,0.353796,0.000536,0.000208,0.010526
refboy4,10,7,5,12,18,5,23,7,0.276445,0.291533,0.000094,0.000098,0.010265
mnoodleman,13,5,4,9,19,11,30,8,0.269792,0.282273,0.000014,0.00015,0.002892
adoptedpictures,16,1,23,24,1,43,44,8,0.248287,0.261263,0.000064,0.000042,0.000001
ai_kev0,70,10,12,22,61,73,134,7,0.291516,0.308335,0.000352,0.000576,0.005754
yvesmpeg,10,7,3,10,12,4,16,8,0.239972,0.248064,0.00009,0.000135,0.007534
CelebrationInitial76,16,3,3,6,18,11,29,7,0.255212,0.265413,0.000014,0.000141,0.001042
alexsanderfr,11,7,15,22,10,30,40,7,0.314864,0.336653,0.000161,0.000124,0.003441
allthingsgrowknow,13,6,33,39,10,66,76,6,0.326909,0.348524,0.000268,0.000079,0.005416
xEginch,14,5,8,13,16,14,30,8,0.275185,0.287291,0.000059,0.000135,0.001562
aloo-ka-paratha,42,18,93,111,23,471,494,6,0.353221,0.384452,0.002755,0.000186,0.011965
ArcaneScribbler,10,4,1,5,22,6,28,8,0.207049,0.212113,0.000003,0.000114,0.006597
Icy_Variation3,11,3,2,5,13,6,19,8,0.265055,0.27947,0.000009,0.000064,0.003697
Overlook-237,12,3,3,6,15,9,24,8,0.25471,0.26489,0.000008,0.000112,0.001967
traplord69420666,12,5,2,7,21,7,28,8,0.271181,0.283335,0.000007,0.000108,0.003077
xilefogayole3,16,8,14,22,15,29,44,7,0.306055,0.326905,0.000315,0.000161,0.005578
EntropicSpecies,19,4,2,6,33,9,42,8,0.205211,0.210229,0.000038,0.000199,0.000211
amtcannon,24,4,10,14,6,15,21,8,0.21322,0.221246,0.000109,0.000151,0.00001
ScopeFixer101,11,6,6,12,15,9,24,8,0.234773,0.242907,0.000309,0.000164,0.000115
ananeedshelps,10,3,17,20,4,52,56,7,0.306511,0.326408,0.000116,0.000054,0.003054
pump1ng_,22,5,11,16,13,26,39,7,0.288895,0.304274,0.000078,0.000096,0.002835
anonomycosis,10,1,5,6,1,6,7,8,0.239922,0.247652,0.000015,0.000056,0.000003
asah,13,7,19,26,15,64,79,7,0.310588,0.331694,0.00016,0.000123,0.003962
asklepios7,15,8,12,20,14,32,46,7,0.308305,0.327603,0.000225,0.000147,0.004922
attlerexLSPDFR,13,5,14,19,11,22,33,7,0.309252,0.32953,0.000058,0.000103,0.004032
azqwa,21,7,14,21,9,21,30,7,0.316116,0.334158,0.000203,0.000104,0.003594
b_rokal,10,7,11,18,9,15,24,7,0.300292,0.31643,0.000069,0.000092,0.004413
ballblaster6969,16,3,17,20,3,23,26,8,0.235947,0.246802,0.000459,0.000093,0.00005
believe_the_lie4831,25,6,17,23,12,43,55,7,0.266741,0.27936,0.000279,0.000149,0.000211
TheGlassWolf123455,14,4,2,6,7,3,10,8,0.210377,0.215801,0.000022,0.000093,0.000164
quiblitz,20,6,30,36,11,53,64,7,0.301531,0.318577,0.001902,0.000247,0.001044
beyondhelp7854,24,14,42,56,20,99,119,6,0.328641,0.354052,0.000749,0.000213,0.005141
Junior-Towel-202,27,4,3,7,29,14,43,8,0.245847,0.255267,0.000043,0.000122,0.000422
blueorangan,17,5,18,23,18,46,64,7,0.307739,0.327678,0.000148,0.000107,0.002692
Brilliant_Effort9095,19,4,3,7,29,6,35,7,0.272716,0.284336,0.000007,0.000109,0.006545
Chemical_Big_5118,17,5,2,7,31,9,40,8,0.263912,0.275656,0.000019,0.000147,0.008841
Cubeazoid,22,2,1,3,31,7,38,9,0.210123,0.216135,0,0.000129,0.004209
Molestrios45,25,5,6,11,55,28,83,8,0.258726,0.27064,0.000108,0.000292,0.006559
Relay_Slide,18,4,4,8,33,16,49,8,0.266052,0.279007,0.000012,0.000148,0.005101
UbiquitousPanacea,11,6,9,15,30,12,42,7,0.291629,0.306498,0.00021,0.000161,0.005348
Yetanotherdeafguy,13,9,5,14,25,11,36,8,0.245567,0.256122,0.000085,0.000157,0.005962
Zorlai,10,4,2,6,20,9,29,7,0.283719,0.299478,0.000078,0.000115,0.008663
adnaj26,10,5,3,8,17,9,26,8,0.268847,0.281838,0.000015,0.000099,0.008276
mh985,15,6,6,12,26,11,37,7,0.268608,0.281888,0.000048,0.000126,0.006174
solarnoobUSA,10,4,2,6,18,8,26,8,0.263774,0.275486,0.000006,0.000135,0.007858
TheRealestBiz,14,4,3,7,7,4,11,8,0.233502,0.240589,0.000072,0.000117,0.000137
bri_breazy,14,4,9,13,4,12,16,7,0.263544,0.274444,0.00037,0.000097,0.00023
bumblethistle,15,0,7,7,0,11,11,8,0.238346,0.246357,0,0.000033,0
buncha_bees,21,2,2,4,3,5,8,9,0.198502,0.20279,0.000219,0.00019,0.000004
According_Test4787,14,1,1,2,4,2,6,10,0.165631,0.168112,0,0.000163,0
manicthinking,14,1,3,4,1,3,4,8,0.247623,0.255928,0.000438,0.000066,0
burner_macburnerson,55,0,5,5,0,5,5,8,0.22733,0.23675,0,0.000033,0
c_mad788,19,12,24,36,29,79,108,6,0.329622,0.351862,0.000728,0.000233,0.009917
vortexmak,17,3,32,35,4,77,81,7,0.292043,0.306871,0.000275,0.000088,0.000203
wizrslizr,37,5,2,7,22,19,41,9,0.190743,0.194266,0.000042,0.00034,0.00018
Alone_Step_6304,30,15,12,27,69,34,103,7,0.303512,0.319447,0.000467,0.000257,0.014067
BrandonLart,14,5,5,10,25,10,35,8,0.28308,0.301125,0.000083,0.000107,0.007082
Glittering_Hunt6896,10,8,4,12,26,8,34,7,0.274518,0.288761,0.000047,0.000161,0.003228
Puzzleheaded_Gas1829,11,5,1,6,15,11,26,8,0.22927,0.237526,0.000005,0.00016,0.003521
TheFuns,10,6,3,9,13,3,16,7,0.273987,0.287453,0.00008,0.00006,0.006473
chezdor,10,2,7,9,5,19,24,8,0.238268,0.248376,0.000059,0.000101,0.000101
MobiusCube,14,5,4,9,15,12,27,7,0.249848,0.26022,0.00026,0.000195,0.000885
cipetab,15,10,15,25,15,34,49,7,0.30976,0.32949,0.000263,0.000147,0.005015
colepercy120,77,39,118,157,52,337,389,6,0.362872,0.400213,0.007395,0.000477,0.017423
rigormorty,10,7,4,11,10,5,15,8,0.233045,0.244567,0.000013,0.000111,0.00511
coolcat245678900,13,3,5,8,11,24,35,8,0.232519,0.239814,0.000046,0.000168,0.000049
crazyredneck21798,11,4,12,16,4,21,25,7,0.250706,0.259495,0.000483,0.00013,0.000064
dealsorheals,18,7,14,21,12,25,37,7,0.311186,0.328864,0.000197,0.000134,0.003293
IcyRecommendation781,18,4,4,8,46,19,65,7,0.28641,0.298711,0.000034,0.000295,0.002188
delilah1906,17,6,18,24,9,49,58,8,0.264328,0.275278,0.002482,0.000186,0.000244
randolorian612,24,4,4,8,37,11,48,8,0.239427,0.247226,0.000421,0.000335,0.000077
demongoku,16,3,20,23,9,84,93,7,0.319709,0.341851,0.000147,0.000096,0.002589
FinalSealBearerr,31,10,8,18,56,13,69,7,0.271003,0.28575,0.000093,0.000173,0.01043
dreamingatdusk,12,10,20,30,11,56,67,7,0.239947,0.2511,0.001136,0.00022,0.000013
CaramelRottenApple,11,2,3,5,4,4,8,8,0.205537,0.211612,0.000135,0.000044,0.000998
Feeling-Object9383,15,3,2,5,16,2,18,9,0.191834,0.198057,0.000011,0.000125,0.000021
Roadside_Prophet,10,11,5,16,14,6,20,8,0.252946,0.265875,0.000032,0.000127,0.009475
boldandbratsche,24,3,5,8,8,11,19,8,0.242154,0.254157,0.00001,0.000116,0.001664
el_farmerino,10,3,4,7,14,9,23,7,0.282603,0.298471,0.000001,0.000086,0.002977
postdiluvium,15,6,2,8,10,3,13,8,0.23152,0.241205,0.000059,0.000157,0.002558
JustinRandoh,21,4,4,8,45,23,68,7,0.286591,0.302614,0.000038,0.000193,0.006048
TailorAppropriate999,19,4,4,8,35,12,47,8,0.232519,0.239849,0.000018,0.000176,0.001631
johnapuna,28,7,5,12,52,19,71,8,0.270647,0.283306,0.000113,0.000262,0.005404
ozzscur,10,4,8,12,29,14,43,7,0.277802,0.290665,0.00004,0.0001,0.001741
secret__scientist,35,12,21,33,32,78,110,6,0.325056,0.344469,0.001034,0.000263,0.007527
dusty_trendhawk,22,1,15,16,1,19,20,8,0.2588,0.270161,0.000217,0.00007,0
emanonn159,19,26,176,202,33,700,733,6,0.370349,0.408964,0.007839,0.000332,0.006426
AleroRatking,11,4,3,7,13,11,24,7,0.247095,0.257077,0.000005,0.000133,0.003521
CrimsonBolt33,12,7,5,12,28,9,37,8,0.271165,0.284451,0.000036,0.000118,0.007552
Ottomatik80,16,4,3,7,28,9,37,8,0.262825,0.27474,0.000009,0.000106,0.004469
fart439,13,1,8,9,1,47,48,8,0.251151,0.261071,0.00013,0.000047,0.000117
ArielTheKidd,16,2,2,4,2,2,4,8,0.228668,0.236686,0.000005,0.000049,0.000118
Symbiotic_flux,13,2,1,3,15,1,16,7,0.247189,0.256825,0.000008,0.000056,0.000717
follower_of_yohma,14,9,60,69,14,268,282,7,0.320569,0.34617,0.000633,0.00014,0.004165
forcedfan,20,9,27,36,15,78,93,7,0.269744,0.284104,0.000788,0.000219,0.000135
funnyIlaugh,11,4,16,20,8,25,33,7,0.318854,0.33853,0.000045,0.000067,0.005423
TechPriestCaudecus,13,3,2,5,26,10,36,8,0.229119,0.238071,0.000001,0.000128,0.00147
bk1285,12,4,1,5,13,7,20,8,0.258682,0.271108,0.000025,0.000101,0.002415
loyalsolider95,17,14,63,77,18,200,218,7,0.333702,0.360313,0.001678,0.000184,0.006495
overts,10,5,4,9,15,7,22,8,0.235554,0.244162,0.000026,0.000121,0.001337
Osr0,26,14,13,27,33,29,62,7,0.28363,0.298236,0.000301,0.000248,0.004035
gaslighting_isntreal,10,1,18,19,1,108,109,7,0.261203,0.273231,0.000106,0.000064,0.000009
Life-Crab-2098,23,4,3,7,55,16,71,8,0.216305,0.223833,0.000032,0.000232,0.000094
gbags-98,19,4,11,15,8,24,32,7,0.301431,0.320522,0.000113,0.000093,0.003229
getswole2020,11,2,18,20,2,20,22,7,0.263605,0.275978,0.000119,0.000059,0.000035
gmastertr21,19,3,6,9,7,32,39,8,0.231876,0.240136,0.000059,0.000107,0.000155
fatloui,10,3,5,8,6,7,13,8,0.241766,0.249785,0.000057,0.000087,0.000058
goingforNGA,12,7,14,21,9,37,46,6,0.318719,0.336196,0.000167,0.000095,0.00401
grandquiano,13,4,16,20,4,26,30,8,0.256484,0.26803,0.0011,0.000158,0.000133
WabbitCZEN,11,4,1,5,5,1,6,9,0.204138,0.209452,0.00001,0.00008,0.000031
hamburgersocks,16,6,11,17,14,24,38,7,0.299795,0.319089,0.000207,0.000165,0.00321
haunted_champagne,15,10,18,28,13,28,41,7,0.307656,0.328271,0.000163,0.000126,0.005063
herpaderp_maplesyrup,23,13,20,33,31,52,83,7,0.313534,0.334383,0.000194,0.000253,0.00807
huadpe,22,14,28,42,20,91,111,6,0.325056,0.346614,0.000869,0.000218,0.00651
hundredandoneeyes,30,8,9,17,33,48,81,7,0.302336,0.320395,0.00009,0.000253,0.004023
idster,12,3,6,9,6,11,17,7,0.259601,0.271734,0.000267,0.000107,0.000437
ifitisntconnor,20,19,81,100,25,146,171,7,0.345067,0.373587,0.001877,0.000223,0.006144
ihaten_blank_er,13,6,13,19,12,24,36,7,0.303166,0.320173,0.000145,0.000128,0.002855
Ion_Unbound,12,6,6,12,15,12,27,8,0.242063,0.254271,0.000014,0.000116,0.004562
imsecretlyafox,45,7,10,17,29,40,69,8,0.259037,0.269211,0.000636,0.000426,0.000394
ivycomb,17,1,10,11,2,35,37,8,0.241276,0.251317,0.000012,0.000053,0.000005
jackietea123,14,8,30,38,9,58,67,7,0.320048,0.340429,0.000322,0.000121,0.002933
jo__ba,15,3,6,9,14,23,37,7,0.299596,0.318158,0.00002,0.00011,0.003582
jrandall1017,64,13,25,38,67,121,188,8,0.286845,0.309245,0.000304,0.000546,0.00967
juicyjeffersonjones,10,5,17,22,10,55,65,7,0.310184,0.329363,0.000092,0.000089,0.003913
kevdautie,12,5,5,10,29,15,44,8,0.277461,0.290568,0.000014,0.000174,0.001352
just57572,35,9,17,26,21,46,67,7,0.29928,0.316949,0.000143,0.000201,0.002406
kasebrotchen,22,2,4,6,14,18,32,8,0.235016,0.243554,0.000024,0.000162,0.000115
lavenderrskies,10,7,20,27,8,33,41,7,0.318249,0.339124,0.000552,0.000106,0.003325
lawliet_loml,12,3,3,6,8,30,38,9,0.199894,0.205243,0.000019,0.000238,0.000007
leewilliam236,13,6,18,24,12,36,48,7,0.309993,0.32917,0.000177,0.000136,0.003649
Vix_Satis,25,5,4,9,15,13,28,7,0.220819,0.227889,0.000802,0.000286,0.000217
luckyguessmate,15,0,5,5,0,5,5,8,0.242363,0.250823,0,0.000033,0
maliknetwork,19,16,38,54,28,111,139,7,0.322509,0.346725,0.000763,0.000245,0.006414
Competitive_Let_9644,20,3,3,6,31,17,48,7,0.277495,0.292562,0.000011,0.000167,0.002763
markekt,11,1,2,3,1,4,5,7,0.208883,0.213734,0.00001,0.000062,0.000001
Archaeologist15,10,6,3,9,24,9,33,8,0.233321,0.241287,0.000006,0.000163,0.007433
sarges_12gauge,11,3,2,5,12,8,20,8,0.257388,0.267452,0.000026,0.000122,0.003647
matheus71998,19,7,10,17,11,21,32,7,0.310014,0.327907,0.000117,0.000121,0.005364
microdweb,31,10,27,37,21,89,110,7,0.299339,0.318809,0.000328,0.00022,0.001522
MissIncredulous,12,8,8,16,21,15,36,7,0.289745,0.303513,0.000203,0.000195,0.003582
Suspicious_Tank_61,22,6,4,10,48,20,68,8,0.269455,0.282582,0.000017,0.000177,0.003946
misty_mustard,13,5,13,18,15,31,46,7,0.304021,0.323057,0.000084,0.000111,0.002862
miyomaku,14,6,13,19,8,23,31,7,0.290209,0.3068,0.000066,0.000111,0.000831
momentforlife92,13,32,151,183,35,490,525,6,0.366899,0.402267,0.006672,0.000353,0.009127
trustnobody01,17,27,166,193,40,764,804,6,0.357967,0.39229,0.00563,0.000367,0.006183
mvigs,14,4,13,17,14,37,51,7,0.27055,0.287047,0.000071,0.000132,0.002812
Comfortable_Fill9081,15,4,4,8,27,10,37,8,0.239579,0.250422,0.000008,0.000085,0.004385
Prestigious_Load1699,23,8,8,16,21,19,40,8,0.246181,0.260905,0.000009,0.000178,0.00612
Prior_Coyote_4376,15,11,8,19,19,11,30,8,0.247838,0.262205,0.00004,0.000194,0.007788
UncleMeat11,15,8,9,17,15,19,34,8,0.268624,0.286662,0.000159,0.000154,0.007526
beardsac,10,7,4,11,24,5,29,8,0.233972,0.246071,0.000016,0.000144,0.004501
nerpa_floppybara,16,13,44,57,15,72,87,6,0.336304,0.361158,0.001501,0.000152,0.006804
neves783,10,8,15,23,12,23,35,6,0.294684,0.310955,0.000172,0.000178,0.001636
nexxwav,32,7,105,112,21,297,318,7,0.311657,0.343357,0.000524,0.000135,0.007193
DarthJarJarJar,14,6,4,10,19,15,34,8,0.234117,0.245795,0.000016,0.00017,0.003542
Hosj_Karp,18,9,5,14,27,17,44,8,0.236452,0.245642,0.000083,0.000389,0.003748
KyleDutcher,13,3,3,6,18,15,33,7,0.242881,0.254706,0.000007,0.000072,0.002175
TheyGaveMeThisTrain,16,9,7,16,18,10,28,7,0.265864,0.281552,0.000162,0.000152,0.003705
oceanadakmak,23,5,9,14,12,21,33,7,0.296052,0.312391,0.000052,0.000126,0.002758
odious_as_fuck,16,7,8,15,17,29,46,7,0.297686,0.316296,0.000091,0.000196,0.003759
jrgkgb,28,4,2,6,48,19,67,8,0.232937,0.240542,0.000009,0.000265,0.001808
trentluv,17,7,4,11,18,17,35,7,0.25969,0.271604,0.000022,0.000167,0.002171
omega4444,16,1,2,3,1,3,4,8,0.236218,0.243604,0.000005,0.000042,0.000057
phileconomicus,22,6,16,22,11,28,39,7,0.30589,0.326364,0.000168,0.000118,0.004429
vbob99,11,3,3,6,18,4,22,7,0.247568,0.25769,0.000004,0.000079,0.000847
plcanonica,12,3,27,30,3,68,71,7,0.286827,0.302677,0.00027,0.000067,0.000069
mechadragon469,18,10,4,14,11,4,15,8,0.211596,0.217786,0.000195,0.000197,0.000967
ptothedubs,15,7,30,37,7,40,47,7,0.264359,0.278237,0.001167,0.000133,0.000025
random_indian_boi,41,16,85,101,22,259,281,6,0.346439,0.376455,0.00227,0.000209,0.009095
Zrakoplovvliegtuig,11,4,4,8,10,6,16,7,0.295241,0.31216,0.000019,0.000047,0.007343
poco,12,5,4,9,26,5,31,8,0.265553,0.277125,0.000073,0.000121,0.002589
rapaciousdrinker,16,1,2,3,1,3,4,8,0.216688,0.223462,0.000001,0.000036,0.000078
rdh_mobile,12,10,17,27,12,24,36,7,0.311893,0.333597,0.000117,0.000119,0.0069
reactionary_for_life,11,4,11,15,5,27,32,7,0.31373,0.331082,0.000128,0.000078,0.00289
roracle1982,63,10,11,21,32,47,79,7,0.251388,0.261146,0.000495,0.000468,0.000311
roses4angeI,23,8,9,17,22,33,55,7,0.300471,0.319048,0.000061,0.000234,0.004214
rosesgrowinmygarden,40,12,26,38,25,75,100,7,0.307614,0.327185,0.000632,0.000212,0.004476
nss68,13,2,2,4,22,13,35,8,0.236959,0.245643,0.000003,0.000154,0.000438
sammybabyyy23,11,1,3,4,1,3,4,9,0.184872,0.190571,0.000001,0.000046,0
satanicpastorswife,14,3,5,8,8,15,23,7,0.297393,0.315656,0.00001,0.000075,0.003355
savior_of_the_poor,13,4,14,18,5,25,30,7,0.283169,0.296674,0.000351,0.000097,0.000412
PeepSkate,11,3,2,5,20,11,31,8,0.218139,0.224869,0.000004,0.000146,0.001426
Seeker_Of_Toiletries,13,3,3,6,14,12,26,7,0.278793,0.292951,0.000006,0.000133,0.002576
ow_bpx,11,3,2,5,17,4,21,8,0.237444,0.248392,0.000005,0.000081,0.002187
sehalynn,42,7,24,31,27,68,95,7,0.30339,0.323091,0.000189,0.000207,0.00311
sheldon4ever,13,1,17,18,1,25,26,7,0.234615,0.245554,0.000054,0.000062,0.000011
shery97,13,5,11,16,9,19,28,7,0.30123,0.319696,0.000067,0.000106,0.003234
shitflicker31,39,11,21,32,32,53,85,7,0.296517,0.314811,0.000267,0.000295,0.003748
shutterpawsnomnom,13,6,18,24,6,24,30,8,0.246369,0.257502,0.000736,0.000114,0.000163
keenan123,10,4,4,8,14,13,27,8,0.260347,0.273684,0.000034,0.000108,0.002174
slowopop,24,3,5,8,17,28,45,7,0.277716,0.29007,0.000049,0.000236,0.001191
CantaloupeLazy792,17,4,4,8,33,11,44,8,0.248764,0.258755,0.000016,0.000137,0.004897
Feisty_Camera_7774,15,8,9,17,33,13,46,7,0.27719,0.288971,0.000158,0.00013,0.007068
saveonly1,20,6,6,12,43,19,62,7,0.264498,0.275735,0.000057,0.000207,0.006974
sstiel,16,2,2,4,5,6,11,8,0.215913,0.222825,0.000029,0.000214,0.000083
strawberry2801,34,8,79,87,11,398,409,7,0.314165,0.336044,0.003893,0.000172,0.000479
Aletheia-Nyx,10,3,2,5,6,3,9,9,0.191057,0.195156,0.00007,0.000124,0.000253
AwkwardChuckle,12,3,4,7,24,9,33,8,0.219684,0.225893,0.000045,0.000144,0.000263
DriftinFool,15,5,4,9,13,11,24,7,0.283843,0.296711,0.000543,0.000132,0.002106
Jaded_Cheesecake_993,14,3,3,6,19,5,24,8,0.232543,0.240395,0.00028,0.000091,0.000333
MonkeManWPG,56,7,10,17,96,15,111,7,0.244269,0.253571,0.000483,0.000252,0.000346
dah_wowow,11,3,3,6,22,6,28,8,0.198214,0.202956,0.000007,0.000118,0.000252
koleke415,10,4,3,7,24,11,35,8,0.197825,0.202697,0.000014,0.000219,0.00026
sukepemoripijutk,13,2,7,9,2,8,10,9,0.209773,0.217957,0.000066,0.000066,0.000009
taycanprincess,12,2,16,18,4,22,26,7,0.226688,0.236993,0.00029,0.000098,0.000002
the-alamo,10,1,11,12,1,12,13,7,0.286247,0.299912,0.00006,0.000047,0.000003
Gauntlet_of_Might,11,3,3,6,12,9,21,8,0.231307,0.241892,0.000007,0.000126,0.001713
theredqueentheory,10,1,3,4,1,9,10,7,0.21702,0.222456,0.000058,0.000062,0
thesumofallvice,107,34,117,151,60,392,452,6,0.349164,0.381953,0.004936,0.000436,0.008793
CanoodlingCockatoo,18,5,5,10,8,10,18,7,0.264205,0.27643,0.000272,0.000142,0.001728
thomasmaster912,11,2,8,10,9,16,25,7,0.291179,0.307587,0.000009,0.000091,0.001304
tinfoil_cake,11,3,14,17,3,18,21,8,0.254367,0.265867,0.000212,0.000093,0.000172
tonylstewart,13,6,13,19,8,23,31,7,0.285345,0.301276,0.000066,0.000099,0.001722
tounge-fingers,10,4,13,17,4,16,20,8,0.253996,0.264957,0.000414,0.000102,0.000031
trumppardons,15,3,7,10,4,16,20,8,0.241264,0.249666,0.000101,0.000085,0.000053
MakeItMoreFuckinLame,13,8,8,16,28,16,44,8,0.260467,0.274738,0.000236,0.000159,0.005194
Spiderlander,13,10,7,17,28,10,38,7,0.265818,0.278571,0.000062,0.000154,0.003564
dachuggs,10,3,3,6,23,10,33,8,0.235053,0.243752,0.000005,0.000096,0.002344
tudum42,20,12,20,32,20,63,83,6,0.325499,0.347671,0.000424,0.000198,0.007687
turtdurt,11,4,17,21,5,35,40,8,0.252833,0.263143,0.00075,0.000141,0.000053
fleeter17,28,3,2,5,46,26,72,8,0.235738,0.243673,0.000018,0.000319,0.0013
wannabeAIdev,14,8,38,46,11,88,99,7,0.3235,0.347058,0.000341,0.000121,0.003914
yamdreaming,22,5,14,19,10,65,75,8,0.233249,0.243164,0.000273,0.000213,0.000016
yazurd2,16,2,8,10,3,9,12,8,0.215595,0.224361,0.000027,0.000067,0.000003
youngsurpriseperson,86,23,53,76,64,228,292,7,0.333015,0.358049,0.003333,0.000571,0.009059
splojjy,19,2,4,6,7,8,15,8,0.241895,0.249937,0.000009,0.000091,0.000219
-raeyne-,15,3,3,6,9,7,16,8,0.241045,0.248618,0.000103,0.000181,0.000056
dragonsofliberty,12,3,2,5,4,3,7,9,0.234907,0.240827,0.000042,0.000093,0.000222
4N_Immigrant,16,4,4,8,8,6,14,8,0.227805,0.234389,0.000025,0.000167,0.000151
Bread-Stick1,12,2,3,5,2,3,5,8,0.215975,0.221856,0.000242,0.000145,0.000003
TheCowboyIsAnIndian,12,4,5,9,5,6,11,8,0.250984,0.26019,0.000411,0.000151,0.000236
ucotcvyvov,13,4,2,6,4,2,6,8,0.225705,0.233736,0.000314,0.000119,0.000448
AVeryBadMon,14,3,3,6,13,11,24,8,0.231971,0.241757,0.000007,0.00014,0.000747
Ac1De9Cy0Sif6S,11,2,3,5,4,6,10,8,0.239579,0.250454,0.000007,0.000076,0.000474
sadgloop,10,3,3,6,4,5,9,8,0.232054,0.238928,0.000102,0.00008,0.000047
Wrong-Half-6628,11,4,2,6,8,7,15,8,0.234846,0.240999,0.000015,0.000125,0.00031
Heeeeyyouguuuuys,19,8,8,16,23,20,43,7,0.276428,0.287419,0.000108,0.000222,0.001427
CaptainoftheVessel,11,6,6,12,9,9,18,8,0.249573,0.261124,0.000024,0.000103,0.002669
Enough_Fudge3167,11,6,2,8,9,4,13,8,0.233009,0.2407,0.000009,0.000123,0.00103
i-have-a-kuato,27,11,3,14,28,16,44,8,0.230989,0.239972,0.000044,0.000283,0.001535
Rupeshknn,13,6,7,13,9,13,22,7,0.271979,0.2859,0.000063,0.00013,0.001163
Agitated_Elephant469,11,4,4,8,12,11,23,8,0.251793,0.263846,0.000021,0.000142,0.001222
Past_Scholar3723,13,3,5,8,11,12,23,8,0.254681,0.265317,0.000044,0.000143,0.000212
JediMasterSifo-Dias,13,4,4,8,4,4,8,9,0.193547,0.200468,0.000105,0.000118,0.000004
KittyQueen63,37,5,4,9,10,8,18,8,0.242024,0.250466,0.000065,0.000183,0.000564
teflondung,17,4,4,8,8,7,15,9,0.227428,0.23679,0.000062,0.000165,0.000295
SeductiveSunday,25,5,6,11,18,19,37,8,0.266553,0.279913,0.000015,0.000187,0.001114
TLunchFTW,14,4,3,7,15,11,26,8,0.226904,0.234881,0.000022,0.000156,0.000338
BJPark,12,7,3,10,13,7,20,8,0.250623,0.262755,0.000115,0.000201,0.002681
NigroqueSimillima,11,3,3,6,11,10,21,8,0.253158,0.265274,0.000002,0.000099,0.001421
No_Passion_9819,45,2,4,6,44,45,89,8,0.253257,0.264972,0.000002,0.000283,0.001254
BadHabitOmni,14,4,4,8,15,17,32,8,0.262186,0.278677,0.000006,0.000115,0.004434
BajaBlastFromThePast,11,3,5,8,4,7,11,7,0.248178,0.255606,0.000022,0.000088,0.000148
lavandermary,15,5,1,6,9,3,12,9,0.182813,0.186024,0.000166,0.00018,0.001782
Basic-Definition8870,11,3,6,9,8,12,20,8,0.270243,0.283164,0.000042,0.000097,0.000995
BayesConspirator356,12,5,5,10,10,9,19,8,0.254911,0.265939,0.00002,0.000136,0.000749
Benjamin_Starscape,13,3,2,5,7,4,11,8,0.214991,0.221669,0.000022,0.000122,0.000061
JustThisIsIt,10,3,4,7,8,10,18,8,0.238632,0.249161,0.000025,0.000105,0.000194
unkorrupted,14,9,9,18,14,14,28,7,0.271035,0.290929,0.000077,0.000161,0.006615
ian9921,43,3,5,8,4,7,11,8,0.21127,0.217581,0.000052,0.000082,0.000032
Clementine_90,33,5,7,12,10,16,26,8,0.219929,0.226958,0.000373,0.000255,0.000005
TinyNiceWolf,12,4,2,6,10,5,15,9,0.180611,0.184398,0.000019,0.000169,0.00001
StopStealingMyShit,13,4,4,8,14,13,27,7,0.25296,0.268474,0.000006,0.000121,0.004396
Ok-Position8731,11,4,2,6,6,4,10,8,0.237718,0.245264,0.000178,0.000118,0.000133
Gullible_Career1469,18,6,2,8,11,5,16,8,0.232018,0.239415,0.000018,0.000188,0.001241
Material-Web-9640,12,3,7,10,10,16,26,7,0.269375,0.280598,0.000046,0.000123,0.000549
Professional_Fix4593,11,4,3,7,12,12,24,8,0.247284,0.257772,0.000043,0.000141,0.000423
BurtMSnakehole,16,2,3,5,3,5,8,9,0.194344,0.199781,0.000009,0.000106,0.000023
Dependent-Canary-514,13,3,2,5,6,3,9,9,0.196044,0.201014,0.000025,0.000115,0.00004
mikefick21,16,2,7,9,2,7,9,8,0.237918,0.247946,0.000532,0.000062,0.000037
Calm-Purchase-8044,14,3,2,5,6,4,10,8,0.253527,0.263561,0.000006,0.000075,0.001304
Ill-Cantaloupe-6947,11,8,4,12,18,9,27,8,0.195502,0.201341,0.000063,0.000367,0.000029
Pristine_Job_7677,10,3,4,7,5,6,11,8,0.185927,0.1903,0.00003,0.000122,0.000006
CatnissEvergreed,31,1,1,2,4,4,8,1,1,1,0,0.000245,0
KnotBeanie,12,4,2,6,10,8,18,8,0.23265,0.239627,0.0002,0.000213,0.000159
Choano,10,3,2,5,3,2,5,9,0.184684,0.189252,0.000006,0.000113,0.000045
Fattydog,12,4,2,6,4,2,6,10,0.168822,0.171976,0.000093,0.000122,0.000047
rktscience1971,21,5,4,9,7,7,14,8,0.21837,0.224864,0.000046,0.000179,0.000056
Classic_Bet1942,10,1,1,2,3,4,7,8,0.224508,0.231211,0,0.00006,0.000078
Publius82,12,4,5,9,10,13,23,8,0.267135,0.284242,0.00002,0.000109,0.005031
Statman12,12,4,4,8,11,11,22,8,0.26152,0.277172,0.000044,0.000121,0.003438
Correct_Cupcake_5493,22,5,2,7,7,5,12,8,0.237481,0.245668,0.000052,0.00011,0.000522
ZZ9ZA,28,4,5,9,8,9,17,8,0.211754,0.218709,0.000052,0.000161,0.000014
seasev,12,4,4,8,9,8,17,8,0.229828,0.238323,0.000104,0.000147,0.000169
Your_As_Stupid_As_Me,15,3,2,5,3,2,5,9,0.19612,0.200521,0.000008,0.000096,0.000016
Intelligent-Sound-85,12,5,3,8,9,7,16,8,0.248887,0.2619,0.000008,0.000096,0.003747
uvula_chandelier,12,5,11,16,10,21,31,7,0.261792,0.276952,0.000023,0.000113,0.002879
TrickyTrailMix,16,6,6,12,13,14,27,8,0.254925,0.267046,0.000032,0.000141,0.00109
DazzlingLanguage5774,33,1,3,4,1,3,4,8,0.238143,0.247478,0.000038,0.000038,0.000433
Top-Cupcake4775,17,4,3,7,6,5,11,8,0.231864,0.240316,0.000084,0.000113,0.000366
Outrageous_Cod_8961,11,3,2,5,10,7,17,8,0.229096,0.236679,0.000011,0.000097,0.00261
Far_Physics3200,10,2,6,8,2,8,10,8,0.243076,0.252417,0.000362,0.000094,0.000015
DjScenester,14,2,2,4,5,5,10,8,0.176246,0.179717,0,0.000114,0.000008
Far_Information_9613,15,3,3,6,10,11,21,8,0.212859,0.218611,0.000227,0.000214,0.000063
Doununda,17,4,3,7,7,4,11,8,0.239528,0.246918,0.000462,0.000161,0.000245
Mirved,13,3,2,5,11,10,21,9,0.195646,0.199481,0.000018,0.000247,0.000009
pm_me_your_passw0d,13,4,4,8,15,13,28,8,0.253116,0.266105,0.000015,0.00014,0.001464
Repeatitpete,12,7,4,11,10,5,15,8,0.226416,0.236114,0.00001,0.000106,0.001985
Express-Translator24,10,3,2,5,3,2,5,8,0.193514,0.198532,0.00008,0.000082,0.000078
constructioncranes,11,4,3,7,10,5,15,8,0.22704,0.234481,0.000343,0.000166,0.000169
Hughmanatea,14,4,2,6,10,8,18,8,0.219226,0.226272,0.000153,0.000169,0.000185
FinnsAwake2187,19,2,2,4,2,2,4,9,0.1696,0.17247,0.000438,0.000118,0.00002
Temporary_Cicada031,10,2,1,3,4,2,6,1,1,1,0.000219,0.000403,0
Fit_Cut_4238,10,5,8,13,6,8,14,7,0.251025,0.264907,0.000015,0.00013,0.001026
GodMan7777,33,2,2,4,5,6,11,9,0.198789,0.203786,0,0.000152,0.000026
lamstradamus,10,3,3,6,7,7,14,9,0.208144,0.213744,0.000031,0.000158,0.000036
easthighwildcatfan1,19,3,3,6,3,4,7,8,0.238758,0.246502,0.000026,0.000083,0.000147
Hexdrix,39,6,7,13,23,29,52,7,0.243508,0.251798,0.000397,0.000389,0.000123
Jeklah,13,1,1,2,2,3,5,1,1,1,0,0.000375,0
Ok-Session2581,14,1,3,4,1,3,4,7,0.259215,0.270911,0.00001,0.00005,0.000048
MangoPug15,17,1,2,3,2,3,5,9,0.199956,0.20563,0,0.00005,0.000003
shivux,14,2,3,5,3,3,6,8,0.228253,0.235627,0.00004,0.000072,0.000104
Waterworld1880,12,2,4,6,8,9,17,7,0.270211,0.2829,0.000007,0.000096,0.000398
Natural-Potential-80,10,2,3,5,2,4,6,8,0.207429,0.212944,0.000072,0.000091,0.000006
itravella,10,2,2,4,2,2,4,9,0.20345,0.209749,0.000007,0.00007,0.000003
SignificantLock1037,10,2,4,6,5,7,12,8,0.236255,0.244339,0.000027,0.000118,0.000023
WheelyWheelyTired,11,3,3,6,12,12,24,8,0.226507,0.237397,0.000002,0.000132,0.000933
Ok-Significance2978,22,1,3,4,4,6,10,8,0.204018,0.209737,0.000007,0.000103,0.000014
TheRealTurinTurambar,12,4,2,6,5,5,10,8,0.215257,0.221503,0.000047,0.000145,0.000021
munche,16,3,4,7,8,11,19,8,0.244362,0.254119,0.000064,0.000163,0.00046
TheButtDog,16,2,3,5,6,9,15,8,0.25793,0.269108,0.000346,0.000127,0.0005
lemickeynorings,14,3,4,7,8,7,15,8,0.232173,0.243672,0.000009,0.000175,0.000386
onthelongrun,13,0,5,5,0,6,6,8,0.249148,0.257638,0,0.000033,0
